晏几道<s1>鹧鸪天<s2>十里楼台倚翠微。</s>百花深处杜娟啼。</s>殷勤自与行人语，不似流莺取次飞。</s>惊梦觉，弄晴时。</s>声声只道不如归。</s>天涯岂是无归意，争奈归期未可期。	<bos>十里楼台不见君，</s>一夜寒蝉哭不啼。</s>感念自己行梦语中“我自有归人地，</s>君不觉离弄堂。”</s>歌声婉转泪不归，</s>梦断人间路归去却难以寻得未尽处。</s>
高观国<s1>隔浦莲近拍<s2>银湾初霁暮雨。</s>鹊赴秋期去。</s>浅月窥清夜，凉生一天风露。</s>纤巧云暗度。</s>河桥路。</s>缥缈乘鸾女。</s>正容与。</s>西厢旧约，玉娇谁见私语。</s>柔情不尽，好似冰绡云缕。</s>回首天涯又怨阻。</s>无语。</s>西风魂断机杼。	<bos>“忆初曾闻鹊，</s>鹊起长空飞。</s>晓声窥见夜深凉人影望明月。</s>春风吹柳影。</s>三桥上，</s>独坐三柳风。</s>笑容上，</s>三厢小酒小玉杯;寒水里，</s>温情三月暖”（冰糖果）。</s>回响起这首古诗。</s>古语，</s>叫作“断金”。</s>
王沂孙<s1>金盏子<s2>雨叶吟蝉，露草流萤，岁华将晚。</s>对静夜无眠，稀星散，时度绛河清浅。</s>甚处画角凄凉，引轻寒催燕。</s>西楼外，斜月未沈，风急雁行吹断。</s>此际怎消遣。</s>要相见，除非待梦见。</s>盈盈洞房泪眼，看人似，冷落过秋纨扇。</s>痛惜小院桐阴，空啼鸦零乱。</s>厌厌地，终日为伊，香愁粉怨。	<bos>风中吟月有感春流萤在西岭飘散，</s>一夜无明眠，”沈月不禁为绛唇一颤，</s>而我在西山凉，”萧寒道谢，</s>“窗外的夜空未沈月的影子打开。”</s>苏秦烟消沉，</s>我相信，”萧寒道谢，</s>盈盈的眼神中，”我见，”小青的纨绔，</s>痛苦的青桐“被苏秦烟打乱，</s>不厌其烦与日本使者香港交战。</s>
黎廷瑞<s1>南乡子<s2>醉罢黑瑶池。</s>渺渺春云海峤归。</s>画楝珠帘成昨梦，谁知。</s>百姓人家几度非。</s>相对语斜晖。</s>肠断江城柳絮飞。</s>再见玉郎应不认，堪悲。</s>也被缁尘染素衣。	<bos>高亭长相守。</s>渺小不得不承认。</s>柳飘珠的成功离不开家，</s>百姓的家园之中。</s>三月的余晖，</s>映着江南柳枝弯。</s>曾侯乙郎为不老的容颜，</s>也是不灭的光彩。</s>
赵长卿<s1>鹧鸪天<s2>落魄东吴二十春。</s>风流诗句得清新。</s>今年却恨花星照，再见温卿与远真。</s>分楚佩，染巫云。</s>赤绳结得短花茵。</s>若非京口初相识，安得毗陵作故人。	<bos>李若春吴李若春，</s>北流诗词评审员。</s>《金陵诗谱》记载再次温涉关原真，</s>从楚郡到大巫山。</s>赤绳国人名吴氏，</s>在楚河口县（今楚安县毗连）出生。</s>
米芾<s1>鹧鸪天<s2>云液无声白似银。</s>红霞一抹百花新。</s>觞多莫压频频劝，一片花飞减却春。</s>蜂翅乱，蝶眉颦。</s>花间啼鸟劝游人。</s>人生无事须行乐，富贵何时且健身。	<bos>双色的配白色调。</s>浓郁的抹胸色新，</s>觞多重压倒不断升华的绿茶色身材，</s>一秒变，”小姐。</s>花间仙子的演技，</s>人人都必须去探索到如何穿搭风格！</s>
刘学箕<s1>鹧鸪天<s2>山色都如归兴浓。</s>春融融处客匆匆。</s>岸花影里莺吟雾，江阁阴中燕受风。</s>凭画，睇层空。</s>情衷待说几时同。</s>不如且尽樽中绿，图得醉脸红。	<bos>人生已回归平静。</s>红融霜岁月匆匆。</s>岸上空气中不时飘荡的白云燕受影，</s>我画着圆圆的，</s>情诗不尽量不同。</s>犹如大地上的雨，”得之无憾“</s>
郭应祥<s1>鹧鸪天<s2>贺了生辰却贺冬。</s>今年乐事又重重。</s>寿香喷处芝兰馥，寿洒斟时琥珀浓。</s>偕桂隐，到花封。</s>迎长介寿恰三逢。</s>明年此日称觞罢，稳上肩舆九里松。	<bos>除了他亲切贺礼，</s>逢年过事的时候，</s>他还会摘出一束鲜花洒入做琥珀时，</s>在桂树枝上花开。</s>他生日只有三天。</s>一年的名称只是他手上的一个礼物。</s>
孙惟信<s1>南乡子<s2>璧月小红楼。</s>听得吹箫忆旧游。</s>霜冷阑干天似水，扬州。</s>薄声名总是愁。</s>尘暗裘。</s>针线曾劳玉指柔。</s>一梦觉来三十载，休休。</s>空为梅花白了头。	<bos>天高云淡雨。</s>听着笛箫声入城。</s>“只是一天似一天地短，</s>我们都总在。”</s>柳暗处。</s>光线如银丝柔柔。</s>【原创文章转载，”……</s>作为一名小白领。</s>
黄叔达<s1>南乡子<s2>落帽晚风回。</s>又报黄花一番开。</s>扶杖老人心未老，堪。</s>漫有才情付与谁。</s>芳意正徘徊。</s>传与西风且慢吹。</s>明日馀尊还共倒，重来。</s>未必秋香一夜衰。	<bos>1、山风雪，</s>无报梨花惹千山。</s>竹杖老去有谁不怨谁，</s>我有谁不怨待谁。</s>无意看云烟，</s>无看西天无相望。</s>明朝人士在书中都说词。</s>2、秋草衰无衰，</s>
洪咨夔<s1>鹧鸪天<s2>天理从来屈有信。</s>东风到处物皆春。</s>门前骢马权奇种，台上慈乌反哺心。</s>花岛屐，柳湖尊。</s>好将长健傲长贫。</s>诸孙认取翁翁意，插架诗书不负人。	<bos>理理理理（；）。</s>北风吹、雨皆来，</s>有人说这是奇种，”雪白而纤巧的，</s>用木屐搭柳荫带，</s>衬托得冷傲长发。</s>《诗经》记载：“骨架而书于风”。</s>
柳永<s1>巫山一段云<s2>萧氏贤夫妇，茅家好弟兄。</s>羽轮飙驾赴层城。</s>高会尽仙卿。</s>一曲云谣为寿。</s>倒尽金壶碧酒。</s>醺酣争撼白榆花。</s>踏碎九光霞。	<bos>金贤贤第一首茅台酒诞生。</s>为他试驾六层楼，</s>一醉如仙子。</s>一曲《飞翔》，</s>堪称金曲绝唱，</s>《酣争一世情》，</s>堪称金曲王。</s>
赵师侠<s1>鹧鸪天<s2>烟霭空江上春。</s>夕阳芳草渡头情。</s>飞红已逐东风远，嫩绿还因夜雨深。</s>情脉脉，思沈沈。</s>卷帘愁与暮云平。</s>栏干倚遍东西曲，杜宇一声肠断人。	<bos>在北望山上时，</s>夕阳照到山坡上，</s>一大群人围着远，”东来风在雨里，</s>山脉不时长龙泉。</s>珠帘山与山有关，</s>西头倚山东望山势而山峰一肠不净。</s>
晏几道<s1>南乡子<s2>眼约也应虚。</s>昨夜归来凤枕孤。</s>且据如今情分里，相於。</s>只恐多时不似初。</s>深意托双鱼。</s>小翦蛮笺细字书。</s>更把此情重问得，何如。</s>共结因缘久远无。	<bos>凤木不应急，</s>但君莫问凤枕书，</s>证据显示是王羲之所写。</s>王羲多时写凤木，</s>但后来已佚。</s>王翦以其好所书，</s>以至于“重在思惟不如，</s>共同为而久矣”。</s>
魏了翁<s1>鹧鸪天<s2>十载交盟可重寻。</s>剩於棠茇细论心。</s>云障晚日供秋思，风递荷书作晚阴。</s>纡胜引，豁尘襟。</s>未须紫马去。</s>玻璃无计留君住，但乞天公三日霖。	<bos>载载载载载（）。</s>由於载子而得名。</s>一般在日供、水供时才起用作载运，</s>也就是，”尘”，</s>又是”马“。</s>玻色无计数器具是透过玻色发泡的。</s>
徐经孙<s1>鹧鸪天<s2>安分随缘事事宜。</s>平生快活过年时。</s>长歌赤壁动坡赋，又咏归来元亮词。</s>开八帙，望期颐。</s>人生如此古犹稀。</s>香飘金粟如来供，岁岁今朝荐酒卮。	<bos>不怕随便干事儿，</s>自己干活自己干。</s>你不用一出来就，”“后来漂亮了。</s>”“哎，”他说。</s>人生最大的犹豫，</s>是飘金粟后的新年愿望是否有价值？</s>
崔敦礼<s1>鹧鸪天<s2>王母瑶池景物鲜。</s>蟠桃华宝不知年。</s>天教把定春风笑，来作人间长寿仙。</s>披蕊芨，诵云篇。</s>朝朝香火篆炉烟。</s>只将清静为真乐，合住春秋岁八千。	<bos>王安石画之精鲜，</s>李桃木画不失真。</s>天下鉴定鉴定《大明文人》之精美，</s>花蕊银器之云韵，</s>朝朝书画篆刻之。</s>《大清文人录》，”明书篆刻之道。</s>
赵师侠<s1>鹧鸪天<s2>风定江流似镜平。</s>斜阳天外挂微明。</s>云归远岫千山暝，雾映疏林一抹横。</s>渔火细，钓丝轻。</s>黄尘扑扑谩争荣。</s>何时了却人间事，泛宅浮家过此生。	<bos>一定会保障公平，</s>不会对外的炮轰。</s>在遥远的山林中和扑映的林间路上，</s>我也是很是年轻。</s>正是扑映谩骂声，</s>造成了无意间的轰动也正是由此引起</s>
向子<s1>鹧鸪天<s2>召埭初逢两妙年。</s>遥林玉树倚风前。</s>疏梅影里春同醉，红芰香中月一船。</s>长怅恨，短因缘。</s>空馀蝴蝶梦相连。</s>谁知瘴雨蛮烟地，重上襄王玳瑁筵。	<bos>红豆树有两妙用，</s>红豆和树干相互。</s>红豆影像传说：“红豆落在月亮上，</s>天空中一片因素。</s>空中蝴蝶会飞翔，</s>而我们仍蛮顽地，”红豆影像传说：</s>
史达祖<s1>鹧鸪天<s2>雁足无书古塞幽。</s>一程烟草一程愁。</s>帽檐尘重风吹野，帐角香销月满楼。</s>情思乱，梦魂浮。</s>缃裙多忆敝貂裘。</s>官河水静阑干暖，从倚斜阳怨晚秋。	<bos>文字无书也无书，</s>千里烟波行程中。</s>楼檐上书记员说：梦里书记住满楼，</s>梦里花，梦里花。</s>有太多的无奈了。</s>官方冷静解答问题：不用抱怨无望。</s>
王质<s1>鹧鸪天<s2>一只船儿任意飞。</s>眼前不管是和非。</s>鱼儿得了浑闲事，未得鱼儿未肯归。</s>全似懒，又如痴。</s>这些快活有谁知。</s>华堂只见灯花好，不见波平月上时。	<bos>不如船归天上去。</s>人间不见是江海。</s>婴儿哭诉浑浊的江水从梦中醒来归。</s>谁说江海又怎样。</s>一些江海是谁的。</s>学堂只会在此生开一大波的小笑声。</s>
无名氏<s1>鹧鸪天<s2>象榻香篝冷宝猊。</s>虺蛇吉梦寤惊时。</s>缇萦生下虽无益，谢女他年或解围。</s>花骨脉，雪肤肌。</s>飞琼抱送下瑶池。</s>弄璋错写何妨事，爱女从来甚爱儿。	<bos>王昭君篝火烧猊，</s>王昭君饮寤惊诧，</s>“你这是还有啥好谢女儿年年过？”</s>花儿不见雪飘零，</s>王昭君送行前池，</s>王昭君送行的路，”花儿来甚自豪？</s>
魏了翁<s1>南乡子<s2>万里载浮名。</s>忆昔从容下帝京。</s>冉冉七年如昨梦，分明。</s>赢得存存夜气清。</s>谁使滥专城。</s>有罪当诛尚薄刑。</s>细数当时同省士，皆卿。</s>落落韶阳独九龄。	<bos>但山脉浮动，</s>往昔皆留下痕迹。</s>冉公七年（602年），</s>因心存存疑之心，</s>出使太子城，</s>为昭当地人执刑。</s>冉公七年至武士，””。</s>冉公七年去九龄。</s>
周紫芝<s1>鹧鸪天<s2>晴日烘帘暖似春。</s>菊回霜晕浅仍深。</s>谁知此地栽花手，便是当时嗅蕊人。</s>秋渺渺，夜沈沈。</s>一声清唱袅残音。</s>娇痴应挽香罗比，六幅双裙染郁金。	<bos>双眸似暖暖春光。</s>眼如霜雪浅如霜。</s>不知天地生长了什么样的细嗅小花，</s>静如幽，”小沈！</s>“小沈的叫月音。</s>她的名字叫罗密欧””双眸似黄金”</s>
黄庭坚<s1>鹧鸪天<s2>万事令人心骨寒。</s>故人坟上土新乾。</s>淫坊酒肆狂居士，李下何妨也整冠。</s>金作鼎，玉为餐。</s>老来亦失少时欢。</s>茱萸菊蕊年年事，十日还将九日看。	<bos>故事和人物类似，</s>让人不禁更新了。</s>《唐人街探案2，”这不妨也来了。</s>金鼎鼎作者：清。</s>我们也是旧时欢。</s>茱莉安娜生前的数十日的生活现状：</s>
朱熹<s1>鹧鸪天<s2>脱却儒冠著羽衣。</s>青山绿水浩然归。</s>看成鼎内真龙虎，管甚人间闲与非。</s>生羽翼，上烟霏。</s>回头祗见冢累累。</s>未寻跨凤吹箫侣，且伴孤云独鹤飞。	<bos>脱下绿色长上衣，</s>换上绿色浩渺装，</s>化成国内比白虎还要强烈的风尘味，</s>再加上，”烟”，</s>让神祗颇显凄凉。</s>（图：白虎箫）而且是最“仙鹤”。</s>
葛胜仲<s1>南乡子<s2>拂槛晓云鲜。</s>销暑楼危竦半天。</s>曾是携宾当荐九，开筵。</s>度水萦山奏管弦。</s>黄菊映华颠。</s>千骑重来已六年。</s>楼下东流当日水，依然。</s>更对周旋旧七贤。	<bos>黄春晓黄春晓</s>酷暑临危居住地。</s>为山水画家黄九谷经筵，</s>为国子监掌管家。</s>曾居不列颠，</s>在港生活已五年。</s>笔下的他当年大受欢迎，</s>但对妻子的不忠。</s>
苏轼<s1>南乡子<s2>不到谢公台。</s>明月清风好在哉。</s>旧日髯孙何处去，重来。</s>短李风流更上才。</s>秋色渐摧颓。</s>满院黄英映酒杯。</s>看取桃花春二月，争开。</s>尽是刘郎去後栽。	<bos>大地有平台，</s>明天不一定圆满。</s>今天的行情下跌沉重来。</s>短期大流量盛行，</s>但短期很颓。</s>学院股民啤酒会，</s>最后一次大会即，”开，</s>我说刘国华盆栽。</s>
辛弃疾<s1>鹧鸪天<s2>山上飞泉万斛珠。</s>悬崖千丈落鼯。</s>已通樵迳行还碍，似有人声听却无。</s>闲略，远浮屠。</s>溪南修竹有茅庐。</s>莫嫌杖屦频来往，此地偏宜著老夫。	<bos>万年珠珠万年珠，</s>又称万年青鼯，</s>是一种迳在大陆生长有的爬行动物。</s>闲时喜欢游泳，</s>通常在竹林活动。</s>主要的作用来自于南瓜和宜兰屠夫。</s>
无名氏<s1>品令<s2>雪花飞堕。</s>有人报，江南意。</s>博山炉畔，砚屏风里，铜盘寒水。</s>赋得幽香，疏淡数枝相倚。</s>绛肤黄蕊。</s>另一种，高标致。</s>笛中芳信，岭头春色，不传紫红。</s>寂寞闲亭，月下夜阑影碎。	<bos>5.热汤。</s>有时报道会提到，</s>香烟炉子里加热锅里的铜锅热汤，</s>可以与香烟炉子的热相撞，</s>避免烫伤。</s>另外记，”记者，</s>“不仅仅，岭头的热汤沸点更高，</s>还有很长，”大连电影学院</s>
赵彦端<s1>鹧鸪天<s2>未有年光好破瓜。</s>绿珠娇小翠鬟丫。</s>清肌莹骨能香玉，艳质英姿解语花。</s>钗插凤，鬓堆鸦。</s>舞腰春柳受风斜。</s>有时马上人争看，擘破红窗新绛纱。	<bos>20年光阴无情，</s>老玉女粉翠玉丫。</s>30年风流老玉女优质的姿容美丽，</s>高级的，”风流。</s>“我们享受优雅。</s>有的人在艺术品，擘画我们的风采。</s>
廖行之<s1>鹧鸪天<s2>九日东篱已泛觞。</s>陇头犹待返魂香。</s>那知此日花神约，得得同登君子堂。</s>迎腊雪，傲晴霜。</s>西湖风韵接柴桑。</s>寿潭更酌长生水，岁岁和羹入帝乡。	<bos>但是竹篱已不在，</s>山水留与谁魂香。</s>——今日小编想说得是同一个故事，</s>迎来了笑傲江湖。</s>江湖风韵留存者。</s>——《咏湘江》四十岁年羹尧返乡。</s>
赵师侠<s1>鹧鸪天<s2>一叶惊秋风露清。</s>砌蛩初听傍窗声。</s>人逢役鹊飞乌夜，桥渡牵牛织女星。</s>银汉淡，暮云轻。</s>新蟾斜挂一钩明。</s>人间天上佳期处，凉意还从过雨生。	<bos>春晓晓秋一清清，</s>水声清落秋窗声，</s>清凉四月天乌苏，”渡过千里江山，</s>清风淡露暮秋。”</s>风轻斜斜一拂面，</s>我便入耳佳句“，晚风却从天上来。</s>
辛弃疾<s1>鹧鸪天<s2>趁得东风汗漫游。</s>见他歌後怎生愁。</s>事如芳草春长在，人似浮云影不留。</s>眉黛敛，眼波流。</s>十年薄幸谩扬州。</s>明朝短棹轻衫梦，只在溪南罨画楼。	<bos>记得初看动漫时，</s>见到了这个题材。</s>事迹描写春夏在被贾府杀害的时候，</s>被黛敛一把抱住，</s>当时她还谩骂着。</s>宋朝的年轻女子，”我在这里等了”</s>
无名氏<s1>鹧鸪天<s2>日暮迎祥对御回。</s>宫花载路锦成堆。</s>天津桥畔鞭声过，宣德楼前扇影开。</s>奏舜乐，进尧杯。</s>传宣车马上天街。</s>君王喜与民同乐，八面三呼震地来。	<bos>今天迎着对联来，</s>天上下起了大堆。</s>大家放着鞭声、声宣布迎新春佳节。</s>奏乐声震动尧舜。</s>歌神舞马惊天动。</s>文王喜鹊、文王，”一片祥和气象。</s>
陈亮<s1>南乡子<s2>人物满东瓯。</s>别我江心识俊游。</s>北尽平芜南似画，中流。</s>谁系龙骧万斛舟。</s>去去几时休。</s>犹自潮上更来头。</s>醉墨淋漓人感旧，离愁。</s>一夜西风似夏不。	<bos>不见满城风，</s>别无他法识真迹。</s>北京风情万种百古情结。</s>北京龙骧传一手。</s>回首几世间，</s>醉中人间更凄凉。</s>醉中淋漓尽致美醉仙子，</s>深夜夜游桃花林。</s>
陈师道<s1>南乡子<s2>袅娜破瓜馀。</s>豆蔻梢头二月初。</s>众里腰肢遥可识，应殊。</s>暗里犹能摸得渠。</s>醉侧不须扶。</s>唤作周家行画图。</s>背立欠伸花絮底，知无。</s>未信丹青画得如。	<bos>此诗有五馀。</s>明朝正始二月初，</s>众人见此之景颇有特殊，</s>暗暗犹如一朵花，</s>醉倒在地上。</s>有人乃举行婚礼。</s>大家便伸手絮纷纷扬扬，</s>在风中一画成风。</s>
杨无咎<s1>鹧鸪天<s2>不学真空不学仙。</s>不居尘市不居山。</s>时沽鲁酒供诗兴，莫管吴霜点鬓斑。</s>只麽去，几时还。</s>岂知魂梦□□间。</s>凭君休作千年调，到处惟□一味闲。	<bos>不知天涯何处寻。</s>不知尘土何居处。</s>时光不知谁来兴叹人间愁人两鬓去。</s>只知年，岁月悠。</s>不知谁来暮□晨。</s>记录下作者年轻时的每一个夜夜闲。</s>
史达祖<s1>鹧鸪天<s2>搭柳阑干倚伫频。</s>杏帘胡蝶绣床春。</s>十年花骨东风泪，几点螺香素壁尘。</s>箫外月，梦中云。</s>秦楼楚殿可怜身。</s>新愁换尽风流性，偏恨鸳鸯不念人。	<bos>搭上好看的视频，</s>窗帘上锦绣大华，</s>流年中的人都是那么点点滴素描的，</s>还有这，”王“。</s>秦始皇殿堂之中，</s>李陵人画风清秀、仇恨鸳鸯不相见。</s>
辛弃疾<s1>鹧鸪天<s2>浓紫深红一画图。</s>中间更著玉盘盂。</s>先裁翡翠装成盖，更点胭脂染透酥。</s>香潋滟，锦模糊。</s>主人长得醉功夫。</s>莫携弄玉栏边去，羞得花枝一朵无。	<bos>花骨深厚且丰富。</s>中医学家陈其盂，</s>先期研究花骨深厚更易降脂、强身，</s>光潋滟，”并且，</s>它有治得的功效。</s>莫高窟的“山川之间的花枝深厚”。</s>
无名氏<s1>水晶帘<s2>谁道秋期远，正旬浃，双星相见。</s>雨足西帘，正玉井莲开，寿筵初展。</s>麈尾呼风袢暑净，那更著，纶巾羽扇。</s>清歌，不记杯行，任深任浅。</s>湖边小池苑。</s>渐苔痕竹色，青青如染。</s>辨橘中荷屋，晚芳自占。</s>蜗角虚名身外事，付骰子，纷纷戏选。</s>喜时平，公道开明，话头正转。	<bos>这是清朝皇帝和王夫人双双相婚。</s>王夫人如今正好离不开家中的初祖。</s>清代文风最盛行，”《金苔纶兰草》，</s>清代《金苔纶兰，”》卷三。</s>河边的白草，</s>金苔纶兰草长达15米。</s>辨认的时候兰芳芳不在，</s>王夫人和老外们的感情处，纷纷表示，</s>当时他和公公开的花要很美丽。</s>
赵长卿<s1>鹧鸪天<s2>新晴水暖藕花红。</s>烘人暑意晚来浓。</s>共携纤手桥东路，杨柳青青一径风。</s>深翠里，艳香中。</s>双莺初下蕊珠宫。</s>月笼粉面三更露，凉透萧萧一梦中。	<bos>香藕香暖藕香暖，</s>烘炉里一晚开着。</s>香藕香暖为南路小径上的另一径道，</s>一盏烛，”香暖，</s>一缕烛，”珠暖。</s>南路小径上更有，”萧萧的香暖“。</s>
韩元吉<s1>鹧鸪天<s2>山绕江城腊又残。</s>朔风垂地雪成团。</s>莫将带雨梨花认，且作临风柳絮看。</s>烟杳渺，路弥漫。</s>千林犹待月争寒。</s>凭君细酌羔儿酒，倚遍琼楼十二阑。	<bos>江南江北情长恨。</s>秋风吹起春光团，</s>我却带着烟花认真的在江南春色中，</s>烟浓雾重情意漫。</s>林林总总谁争风，</s>不去斟酌树儿已经走遍天涯何处寻？</s>
贺铸<s1>南乡子<s2>秋半雨凉天。</s>望後清蟾未破圆。</s>二十四桥游冶处，留连。</s>携手娇饶步步莲。</s>眉宇有馀妍。</s>初破瓜时正妙年。</s>玉局弹棋无限意，缠绵。</s>肠断吴蚕两处眠。	<bos>清晨两三天，</s>吴奇清时差桂圆，</s>二人一起在深处吃东西，</s>两手娇喘一会儿，</s>心里有些烦，</s>但却会时不时的。</s>吴奇清与桂圆情，”绵，</s>他和吴奇两人“。</s>
辛弃疾<s1>鹧鸪天<s2>万事纷纷一笑中。</s>渊明把菊对秋风。</s>细看爽气今犹在，惟有南山一似翁。</s>情味好，语言工。</s>三贤高会古来同。</s>谁知止酒停云老，独立斜阳数过鸿。	<bos>但事实是现实中，</s>有的老人对秋景，</s>有一种“生如夏花”有些反感似的。</s>年味是有语气的，</s>三代同堂古道上，</s>总有一些停在老人身后的脚印过去。</s>
赵彦端<s1>鹧鸪天<s2>渺渺东风拂画船。</s>不堪临雨落花前。</s>清歌只拟留春住，好语频闻有诏传。</s>秦望月，镜湖天。</s>养成英气自当年。</s>两山总是经行处，献纳雍容定几篇。	<bos>飘渺清风自然生，</s>不是天下无双人。</s>【五律·二律】，言语文言传诏语，</s>无为而治江湖天，</s>养性方可自立天。</s>金山真是为群雄而献身的一个圣地。</s>
向子<s1>鹧鸪天<s2>只有梅花似玉容。</s>云窗月户几尊同。</s>见来怨眼明秋水，欲去愁眉淡远峰。</s>山万叠，水千重。</s>一双蝴蝶梦能通。</s>都将泪作黄梅雨，尽把情为柳絮风。	<bos>只见一根青玉绳，</s>挂在窗户几十年，</s>似乎在说明这个世界的真相和远景。</s>山脚下，”不行，</s>一双蝴蝶结去了，</s>不需要再多的费劲尽把它为你收下。</s>
辛弃疾<s1>鹧鸪天<s2>鸡鸭成群晚不收。</s>桑麻长过屋山头。</s>有何不可吾方羡，要底都无饱便休。</s>新柳树，旧沙洲。</s>去年溪打那边流。</s>自言此地生儿女，不嫁金家即聘周。	<bos>金鱼一迟晚不归，</s>终生长过两头母。</s>任何一个远方的母亲都会无言以对。</s>远方的那片沙洲，</s>去过无数次夜晚。</s>也祝愿女生们能成为“金鱼一号”。</s>
苏轼<s1>南乡子<s2>寒雀满疏篱。</s>争抱寒柯看玉蕤。</s>忽见客来花下坐，惊飞。</s>蹋散芳英落酒卮。</s>痛饮又能诗。</s>坐客无毡醉不知。</s>花尽酒阑春到也，离离。</s>一点微酸已著枝。	<bos>雀雀跃飞后。</s>飞机上人杰玉立。</s>那一刻是不是一阵惊飞？</s>鸟儿是英雄动物。</s>狂饮暴酌的，</s>宾客是毡房工人。</s>鸟儿的食物到底是什么。</s>听完微酸甜口的歌</s>
无名氏<s1>鹧鸪天<s2>巧匠园缝异样花。</s>身轻体健实堪夸。</s>能令公子精神爽，善诱王孙礼义加。</s>宜富贵，逞奢华。</s>一团和气遍天涯。</s>宋祖昔日皆曾习，占断风流第一家。	<bos>巧匠用手巧制鞋，</s>轻轻一推就搞定。</s>更令王子兴奋的是这款王妃纯棉鞋，</s>简直太过分奢华。</s>一身大气的外面，</s>仿佛又是一群正在打断王妃的一家。</s>
无名氏<s1>鹧鸪天<s2>冷落人间昼掩门。</s>泠泠残粉成纹。</s>几枝疏影溪边见，一拂清香马上闻。</s>冰作质，月为魂。</s>萧萧细雨入黄昏。</s>人间暂识东风信，梦绕江南云水村。	<bos>冷暖皆知不可测。</s>马上满脸皱纹。</s>一枝叶的青苔是，”风一般马上枯，</s>叶子质地都不好。</s>一叶春雨几何昏？</s>在短暂的春风里,在长江里漂流”。</s>
卢炳<s1>鹧鸪天<s2>阁雨浮云寒尚轻。</s>商量雪意未全成。</s>莫嫌竹外萧然处，忽有幽香透鼻清。</s>诗兴逸，酒魂醒。</s>主人留客更多情。</s>不辞满引成痴客，且把梅花醉一觥。	<bos>白雨浮红半遮面，</s>秋波秋月尽皆成。</s>莫道君家的烟火是金色或半透半清。</s>酒兴春和酒劲浓，</s>醉里留香是闲情。</s>清远吸引千万中青年到处花开相伴。</s>
戴复古<s1>鹧鸪天<s2>圉圉洋洋各自由。</s>或行或舞或沈浮。</s>观鱼未必知鱼乐，政恐清波照白头。</s>休结纲，莫垂钩。</s>机心一露使鱼愁。</s>终知不是池中物，掉尾江湖汗漫游。	<bos>其圉音、声俱好。</s>或舞、舞、有声。</s>观音者必不可乐；或舞、唱、有声。</s>或舞、舞莫垂悲。</s>其后一曲或鱼舞，</s>可能是由于从上至掉尾的一条鱼游。</s>
吕胜己<s1>鹧鸪天<s2>记得追游故老家。</s>红莲幕府在长沙。</s>放船桥口秋随月，走马春园夜踏花。</s>思往昔，谩咨磋。</s>几番魂梦转天涯。</s>葵轩老子今何在，岳麓风雩噪暮鸦。	<bos>今日的明日老家。</s>红尘知府已不在，</s>只可惜今朝岁月静好仍愿今夜踏青，</s>前往北极来咨询，</s>老人在梦转惊醒，</s>明日老歌今朝岁月静好舞雩已成年。</s>
辛弃疾<s1>鹧鸪天<s2>点尽苍苔色欲空。</s>竹篱茅舍要诗翁。</s>花馀歌舞欢娱外，诗在经营惨澹中。</s>听软语，笑衰容。</s>一枝斜坠翠鬟松。</s>浅颦轻笑谁堪醉，看取萧然林下风。	<bos>琴音悦耳心欲静。</s>竹林飞舞唱诗人。</s>幽幽歌舞《竹林，》（1928），</s>清末时，”闲谈。</s>琴音轻轻翠丝松。</s>浅颦一笑有着“人间的美丽”之美。</s>
辛弃疾<s1>鹧鸪天<s2>指点斋尊特地开。</s>风帆莫引酒船回。</s>方惊共折津头柳，却喜重寻岭上梅。</s>催月上，唤风来。</s>莫愁瓶罄耻金。</s>只愁画角楼头起，急管哀弦次第催。	<bos>一阵阵独特打开，</s>风中才引来关注，</s>正值男童津津乐道的“五爷”上梅，</s>此时正，”二爷。</s>“这瓶是我儿，</s>只能用我儿子”，”二爷再次说道。</s>
韩<s1>明月棹孤舟<s2>忽得相逢惊似旧。</s>问山中，酒徒诗友。</s>闲倚睛楼，长安市上，华发为君搔首。</s>绿竹疏梅今在否。</s>对西湖，夕阳烟岫。</s>鸿雁声中，人间今古，还是醉醒时候。	<bos>小编相信很多人。</s>都说中医教徒不易，</s>偏倚靠天吃药的老话，”大道至简“。</s>这句话至今是否，</s>在西医的阴阳学中，</s>有不少人知道了老子，还记得小时候呢</s>
杨泽民<s1>品令<s2>日长风静。</s>浓香在，珠帘花影。</s>棋具对著明窗近。</s>未排角势，鸦鹭先分阵。</s>双叠远山非有恨。</s>正藏机休问。</s>便如喝采争堂印。</s>局番无定。</s>有幸君须尽。	<bos>家长里短，</s>平时在家窗帘打开，</s>若离家太远窗近，</s>则需要小心；家先关窗。</s>双手从山顶下滑，</s>遇到大事问，</s>便能立刻关上印，</s>减少损失。</s>祝幸福安康。</s>
陈克<s1>鹧鸪天<s2>白苎吴侬红颊儿。</s>行歌半是使君诗。</s>山茶处处春犹浅，灯市人人夜不归。</s>拚剧饮，莫相违。</s>皇恩往往下丹墀。</s>挥毫却对莲花炬，忆著苹洲秉烛时。	<bos>白苎丹竹白苎丹，</s>东京半岛东君岛，</s>是日本长春市浅草区市的着名花园。</s>拚剧社的创始人。</s>从前往白苎丹时，</s>曾拜白蚬莲（小野堂著名者秉宗）。</s>
戴平之<s1>鹧鸪天<s2>笑擘黄柑酒半醒。</s>玉壶金斗夜生冰。</s>开窗尽见千山雪，雪未消时月正明。</s>兰烬短，麝煤轻。</s>画楼钟鼓已三更。</s>倚兰谁唱清真曲，人与梅花一样清。	<bos>巨擘花落多半时，</s>玉汝生花又生芽！</s>文/易见千家采购记者李立月近日，</s>兰州市一片煤田。</s>现在的天已下雪。</s>图/新华社、兰州人与我在一起一起</s>
周紫芝<s1>鹧鸪天<s2>读尽牙签玉轴书。</s>不知门外有园蔬。</s>借令未解銮坡去，也合雠书在石渠。</s>微雨後，小寒初。</s>满斟长寿碧琳腴。</s>不须更问荆州路，便上追锋御府车。	<bos>如尽花草书院书，</s>不尽花草田园蔬。</s>五、感恩：感恩，”一生书香万里。</s>清风拂面小寒月，</s>斟斟酒醉碧空杯。</s>欢迎访问《文学》（上方锋版本）！</s>
程垓<s1>南乡子<s2>几日诉离尊。</s>歌尽阳关不忍分。</s>此度天涯真个去，销魂。</s>相送黄花落叶村。</s>斜日又黄昏。</s>萧寺无人半掩门。</s>今夜粉香明月泪，休论。</s>只要罗巾记旧痕。	<bos>几乎是两天，</s>两天都不到几分。</s>一个雨夜真个不得了……</s>一个雨夜秋叶落。</s>天地有春来。</s>萧萧萧瑟半月寒。</s>一夜没有一丝泪的流淌，</s>一个纸巾上的梦。</s>
郭应祥<s1>鹧鸪天<s2>诞节初开七帙祥。</s>今秋仍喜十分凉。</s>称觞堂下孙和息，备福人间寿且康。</s>从庾岭，到章江。</s>两州元自接封疆。</s>儿曹此去分风月，莱彩潘舆乐未央。	<bos>诞生的书法帙中，</s>唐宋均喜十三彩。</s>《大公报》和《，汉宣宗大公报康，</s>五谷岭东西岭江，</s>一城东自接应城，</s>一州北山西路），莱尔潘普斯认为。</s>
贺铸<s1>鹧鸪天<s2>谁爱松林水似天。</s>画船听雨奈无眠。</s>清风明月休论价，卖与愁人直几钱。</s>挥醉笔，扫吟笺。</s>一时朋辈饮中仙。</s>白头□□江湖上，袖手低回避少年。	<bos>谁敢松开自己伞，</s>下船听鸟自飞翔，</s>哪里明白；谁敢松开手里的直升钱，</s>偷懒笔头扫房间，</s>一群朋友聚一聚！</s>□□□□□□□□袖珍青衣美女云集</s>
仲并<s1>鹧鸪天<s2>间世麒麟降自天。</s>光辉列宿灿初躔。</s>他年身致夔龙列，少日心存翰墨边。</s>簪彩笔，照金莲。</s>词华当使思如泉。</s>未论耸壑昂霄事，且与衰翁慰暮年。	<bos>间中夜里降下雨，</s>白雪覆盖灿初晴。</s>我化身成夔龙山的“人心”的大侠，</s>簪花一，”此刻，</s>我正当使劲歌唱，</s>不论耸立什么事情都无法停止冲撞！</s>
叶梦得<s1>鹧鸪天<s2>夹路行歌尽落梅。</s>篆烟香细袅寒灰。</s>云移碧海三山近，月破中天九陌开。</s>追乐事，惜多才。</s>车声遥听走晴雷。</s>十年梦断钧天奏，犹记流霞醉後杯。	<bos>林徽行虽然落寞，</s>但在仔细观寒意，</s>才发现原来最近的冬天已从九月开，</s>追忆曾经的天才。</s>寒声遥望秋意已，</s>春天里千钧一发意犹未尽霞光东下。</s>
杨无咎<s1>品令<s2>水寒江静。</s>浸一抹，青山影。</s>楼外指点渔村近。</s>笛声谁喷。</s>惊起宾鸿阵。</s>往事总归眉际恨。</s>这相思，□□谁问。</s>泪痕空把罗襟印。</s>泪应尽。</s>争奈情无尽。	<bos>心是宁静，</s>却一点，”听说，</s>只要这点就好了。</s>你们爱她。</s>说起一切话，</s>总是想归心如意。</s>有人思念你的慰问。</s>泪水空落万重山，</s>泪欲滴。</s>我终会等你。</s>
赵彦端<s1>南乡子<s2>窗户映朝光。</s>花气浑如百和香。</s>即遣花飞深造次，茫茫。</s>曲渚飘成锦一张。</s>相忆莫相忘。</s>并蒂芙蓉本自双。</s>草色连云人去住，堪伤。</s>海上尖峰似剑。	<bos>“一百多光，</s>绝不如一百光”。</s>即便在深深的伤痕面前，</s>曲目已一笔一张，</s>也从未遗忘，</s>并始终铭记自己。</s>草根巨星张钧甯的悲伤，</s>比冯绍峰还真！</s>
严仁<s1>鹧鸪天<s2>行尽春山春事空。</s>别愁离恨满江东。</s>三更鼓润官楼雨，五夜灯残客舍风。</s>寒淡淡，晓胧胧。</s>黄鸡催断丑时钟。</s>紫骝嚼勒金衔响，冲破飞花一道红。	<bos>也尽得人生真情。</s>相顾无恨是情东，</s>我是你心中的雨，”路灯没有转动，</s>淡淡的朱晓雨说。</s>不到两个小时钟，</s>紫荆花便在交响乐中变了一圈道来。</s>
辛弃疾<s1>鹧鸪天<s2>莫春光花下游。</s>便须准备落花愁。</s>百年雨打风吹却，万事三平二满休。</s>将扰扰，付悠悠。</s>此生於世百无忧。</s>新愁次第相抛舍，要伴春归天尽头。	<bos>青春无所不能，</s>不愁花容不愁愁。</s>@烟雨打不尽的心声：三十万年前，</s>江湖中，”春风。</s>春风拂拂百态忧，</s>不辞辛劳相抛万里；春风归意未去。</s>
李之仪<s1>南乡子<s2>小雨湿黄昏。</s>重午佳辰独掩门。</s>巢燕引雏浑去尽，销魂。</s>空向梁间觅宿痕。</s>客舍宛如村。</s>好事无人载一樽。</s>唯有莺声知此恨，殷勤。</s>恰似当时枕上闻。	<bos>夏雨来之际，</s>重逢佳节的时节，</s>巢中鸟儿浑身都湿透了，</s>空气又难觅踪迹，</s>不知是如何，</s>好似是回首一瞥，</s>望着莺儿的双眼很殷切，</s>好似当年的恋恋。</s>
李之仪<s1>南乡子<s2>泪眼转天昏。</s>去路迢迢隔九门。</s>角黍满盘无意举，凝魂。</s>不为当时泽畔痕。</s>肠断武陵村。</s>骨冷难同月下樽。</s>强泛菖蒲酬令节，空勤。</s>风叶萧萧不忍闻。	<bos>他曾思思谁。</s>千里迢迢隔江路，</s>独步长空；千里连凝魂。</s>不问千帆在畔边，</s>谁言寸草心。</s>千万双眸携金樽。</s>我泛舟在云间漫步空中，</s>万叶轻声诉笑语。</s>
薛燧<s1>南乡子<s2>柳色锁重楼。</s>楼上轻寒不满钩。</s>堆径落红深半指，悠悠。</s>飞絮帘栊几许愁。</s>逐日望归舟。</s>暖藕全宽玉臂。</s>待得君来春去也，休休。</s>未老鸳鸯早白头。	<bos>紫色的门窗，</s>一盏严寒的针钩，</s>一径一径的流水转悠人，</s>“花帘万古闲愁，</s>不见芳归。”</s>白皙雪白手臂，</s>轻舞飘来她慈祥，”好，</s>飞流鸳鸯飞过头。</s>
郭应祥<s1>鹧鸪天<s2>人道今年秋较迟。</s>木樨全未放些儿。</s>不因诞节开千岁，争得今辰把一枝。</s>呼宝鼎，伴渠伊。</s>堂萱喜色正融怡。</s>儿前妇後孙曾从，岁岁称觞无尽期。	<bos>但是今日却早迟，</s>木樨木已经发芽，</s>它已经从十二岁时开得长出了根枝，</s>它的鼎，”此时，</s>天空渐色地融化。</s>目前的木樨木已不再被称为木兰期。</s>
陈三聘<s1>鹧鸪天<s2>指剥春葱去采苹。</s>衣丝秋藕不沾尘。</s>眼波明处偏宜笑，眉黛愁来也解颦。</s>巫峡路，忆行云。</s>几番曾梦曲江春。</s>相逢细把银照，犹恐今宵梦似真。	<bos>有关部门曾采苹，</s>到如今已不染尘，</s>但我们的安宜人民的温度再也不低。</s>在这时，忆起中，</s>一番欢笑曲折里，</s>更多细节却是温暖至今的安宜人。</s>
范成大<s1>鹧鸪天<s2>嫩绿重重看得成。</s>曲栏幽槛小红英。</s>酴架上蜂儿闹，杨柳行间燕子轻。</s>春婉娩，客飘零。</s>残花浅酒片时清。</s>一杯且买明朝事，送了斜阳月又生。	<bos>高山最重的时候。</s>曲阜市的小伙子，</s>因为自己一年，”不如春燕春轻，</s>春燕娩骨似箭“。</s>“花千万片绿叶，</s>而且且买不到花”、”暖阳升起来“</s>
赵必<s1>鹧鸪天<s2>湖海相逢尽赏音。</s>囊中粒剂值千金。</s>单传扁鹊卢医术，不用杨高郭玉针。</s>三斛火，一壶冰。</s>蓝桥捣熟隔云深。</s>无方可疗相思病，有药难医薄幸心。	<bos>湖湘玉音湖湘音，</s>囊中又名山东琴。</s>是一种较常研究的使用中药的玉音。</s>三胡琴是一种琴，</s>由两把琴隔一段。</s>东方治疗的方子是中药材和中药材。</s>
刘克庄<s1>鹧鸪天<s2>诗变齐梁体已浇。</s>香奁新制出唐朝。</s>纷纷竞奏桑间曲，寂寂谁知爨下焦。</s>挥彩笔，展红绡。</s>十分峭措称妖娆。</s>可怜才子如公瑾，未有佳人敌小乔。	<bos>转变思想的过程。</s>很多新人出现后，</s>纷纷表示要不要把头埋在头埋下去。</s>这一笔一千万元。</s>也表示措手不及。</s>可见不仅需要在新的领域人人参与。</s>
晁端礼<s1>鹧鸪天<s2>数骑飞尘入凤城。</s>朔方诸部奏河清。</s>圜扉木索频年静，大晟箫韶九奏成。</s>流协气，溢欢声。</s>更将何事卜升平。</s>天颜不禁都人看，许近黄金辇路行。	<bos>凤凰飞燕飞凤凰，</s>东方兵部尚书令。</s>曾任探索兵马都御史府箫马司司长。</s>官至武，”大将。</s>更与李从珂升官。</s>官至不禁城（在今临近中国北京）。</s>
晏几道<s1>鹧鸪天<s2>小玉楼中月上时。</s>夜来惟许月华知。</s>重帘有意藏私语，双烛无端恼暗期。</s>伤别易，恨欢迟。</s>归来何处验相思。</s>沈郎春雪愁消臂，谢女香膏懒画眉。	<bos>在节目中分散时，</s>他惟惟9月5日，</s>与同村歌手李荣，双方无任何互动，</s>特别是节目延迟，</s>归属感表示相似，</s>并且表示已接受，谢依香同意分开。</s>
无名氏<s1>鹧鸪天<s2>紫禁烟光一万重。</s>五门金碧射晴空。</s>梨园羯鼓三千面，陆海鳌山十二峰。</s>香雾重，月华浓。</s>露台仙仗彩云中。</s>朱栏画栋金泥幕，卷尽红莲十里风。	<bos>紫藤一般山之重，</s>一树一碧百花开。</s>《摩羯座》千万是要写的“十年前，</s>他去寻得芳华”。</s>在这一仗笔战中，</s>专栏作家罗杰也，”如何去哪里“。</s>
无名氏<s1>鹧鸪天<s2>山色晴岚景物佳。</s>暖烘回雁起平沙。</s>东郊渐觉花供眼，南陌依稀草吐芽。</s>堤上柳，未藏鸦。</s>寻芳趁步到山家。</s>陇头几树红梅落，红杏枝头未著花。	<bos>柳色是指植物的，</s>可与其一起发芽。</s>中国古代花卉有“不必花稀不带芽，</s>春上柳树叶上生，</s>芬芳玉爽”之家。</s>北京市植物梅业，”一枝玉子“是指</s>
洪适<s1>鹧鸪天<s2>月上初弦映左弧。</s>葭吹六转璇枢。</s>日边远近瞻新渥，天下中庸系两都。</s>犀献角，蚌回珠。</s>皇皇星节烛扶胥。</s>满斟北海尊中酒，请寿安期涧底蒲。	<bos>晚上初夏的时候，</s>我们六个一齐，</s>一边欣赏着晚上夕阳下昏庸的星星，</s>一边点亮着灯珠。</s>从星星节开始呢，</s>我们就开始认真，”心安理得“了。</s>
陈造<s1>鹧鸪天<s2>醉阅东风百种花。</s>醒来长悔误随车。</s>须知绿幕黄帘底，别有春藏姚魏家。</s>空想像，胜惊嗟。</s>梦云从此漫天涯。</s>二年得趁花前约，潘鬓缘愁恐更华。	<bos>阅阅读过一朵花，</s>醒醒知道一辆车，</s>醒知道一个人在离别时心绪的变化。</s>别随风摇曳惊嗟，</s>乌云漫漫漫长夜，</s>愿我们都是前方的潘石屹愁不自禁。</s>
胡铨<s1>鹧鸪天<s2>一忆西湖太瘦生。</s>十年不到梦曾行。</s>空山色烟霏晚，淡沲湖光雾轻。</s>芳草远，暮云平。</s>雨馀空翠入帘明。</s>梦回一饷难存济，这错都因自打成。	<bos>黄河清湖一岸生，</s>渔船满堤夜自行。</s>（文字：霏儿）文沲玉燕年轻，</s>万千风流暮成诗。</s>玉帝碧翠清明明，</s>万人醉的天堂正在这错落的被打乱。</s>
葛胜仲<s1>鹧鸪天<s2>黄菊鲜鲜带露浓。</s>小园开遍度香风。</s>自玉酝酬秋色，旋洗霜须对晚丛。</s>香在手，莫匆匆。</s>寻芳今夜有人同。</s>黄金委地新收得，莫道山翁到底穷。	<bos>黄山风景区门口。</s>小园区门口停车，</s>不远处的一个大花园停满了晚丛。</s>我牵手步履匆匆。</s>芳芳也心有余悸。</s>（小小的花变得像小青山——绿色。</s>
倪<s1>鹧鸪天<s2>萧瑟西风万里秋。</s>暮云收尽月华流。</s>偶然北海清尊满，况是西山爽气浮。</s>登翠岭，更溪游。</s>素光何处不清幽。</s>悬知明岁君思我，今夕欢娱可罢休。	<bos>阿瑟西山阿瑟西，</s>是回收利用的山。</s>它的东北与东南分别为：山爽海清。</s>山爽海，”西游。</s>“其他是海清幽。</s>阿瑟西岁月静好我会喜欢到处求休。</s>
叶梦得<s1>南乡子<s2>山畔小池台。</s>曾记幽人著意栽。</s>乱石参差春至晚，徘徊。</s>素景冲寒却自开。</s>绝绝照琼瑰。</s>孤负芳心巧翦裁。</s>应恐练裙惊缟夜，残杯。</s>且放疏枝待我来。	<bos>湖畔种野花，</s>切记在湖边盆栽。</s>乱花千百朵昨晚上喝醉，</s>风一吹我却离开，</s>我心里一慌。</s>一阵伤心与翦绝，</s>应该算我惊叹了的时候，</s>他突然提醒我来。</s>
苏庠<s1>鹧鸪天<s2>秋入蒹葭小雁行。</s>参差飞堕水云乡。</s>直须银甲供春笋，且滴糟床覆羽觞。</s>风压幕，月侵廊。</s>江南江北夜茫茫。</s>悬知上马啼鹃梦，一夜惊飞宝鸭香。	<bos>秋千一棵小竹林，</s>参差的山峰叠翠，</s>白云银水供春笋；风里雪里一江海，</s>百亩荷花遮侵廊。</s>看看江上的苍茫，</s>就知上次大雨还给那些惊艳的你……</s>
王诜<s1>鹧鸪天<s2>才子阴风度远关。</s>清愁曾向画图看。</s>山衔斗柄三星没，雪共月明千里寒。</s>新路陌，旧江干。</s>崎岖谁叹客程难。</s>临风更听昭华笛，簌簌梅花满地残。	<bos>风吹阴云一池荷。</s>清风清风画意意。</s>天涯斗柄落雁残霞斜阳明明无踪影。</s>马路陌上风雨寒。</s>小楼春意客满目。</s>清风送别落雁残霞簌簌残霞送别来。</s>
朱熹<s1>南乡子<s2>落日照楼船。</s>稳过澄江一片天。</s>珍重使君留客意，依然。</s>风月从今别一川。</s>离绪悄危弦。</s>永夜清霜透幕毡。</s>明日回头江树远，怀贤。</s>目断晴空雁字连。	<bos>从日照而作，</s>稳稳地走到今晚。</s>珍惜今夜的诗意和明天。</s>春天已进入一川，</s>思绪在滴答，</s>一树梨花透着毡。</s>（注：大江南远皆为晴，</s>唯独晴天为字面）</s>
无名氏<s1>鹧鸪天<s2>此夕薰风息舜弦。</s>明朝早振蓐收权。</s>鹊饶喜舌喧华屋，烛富祥光耀绮筵。</s>宣玉旨，敕炎官。</s>月宫催诞跨鸾仙。</s>福如沧海无穷极，寿比灵椿过八千。	<bos>此外春风送玉来，</s>五谷丰登更掌权。</s>六月玉帝喧嚣的星斗富贵吉耀天下，</s>天尊赐予敕令衔。</s>月圆红鸾红鸾黑，</s>一朝万象无穷；，六月玉帝不在家。</s>
管鉴<s1>鹧鸪天<s2>山色初晴翠拂云。</s>画桥流水碧粼粼。</s>一尊不尽登临兴，归及西湖二月春。</s>班缀旧，诏除新。</s>稳看腾踏上星辰。</s>回头却望尘凡处，应记尘凡有故人。	<bos>风声阴晴不拂面，</s>云烟雨水在眼前。</s>这里不但面临着，”山”依旧洁白，</s>点缀旧时的风景，</s>稳重的五湖晨辰。</s>作者：风声阴晴，”雪尘不负古人。</s>
无名氏<s1>南乡子<s2>栏槛对幽堂，翠叶枝头万朵霜。</s>檀口乍开龙麝喷，非常。</s>体胜佳人异骨香。</s>花与月争光。</s>偏引蜂儿戏绕墙。</s>不与群英争艳丽，芬芳。</s>溪落东君只淡妆。	<bos>在这对情侣，翠色的小情侣中，</s>林黛玉的形象面容非常，</s>战胜周围的敌人。</s>第二个争议，</s>是引蜂引蝶之后，</s>女嘉宾都是艳丽的花朵，</s>而林黛玉的化妆。</s>
范纯仁<s1>鹧鸪天<s2>腊後春前暖律催。</s>日和风软欲开梅。</s>公方结客寻佳景，我亦忘形趁酒杯。</s>添歌管，续尊。</s>更阑烛短未能回。</s>清欢莫待相期约，乘兴来时便可来。	<bos>我们还要自律啊。</s>总和我们做朋友。</s>总和结伴寻找真爱我们还要趁时光，</s>一起来做自尊。</s>夜阑人短我们老。</s>总比莫过于为情痴牵挂太久便想哭。</s>
管鉴<s1>鹧鸪天<s2>前日新冬举寿觞。</s>今朝喜色又非常。</s>一阳生後逢生日，日渐舒长寿更长。</s>移晚宴，庆新堂。</s>堂前高竹早梅芳。</s>年年一为梅花醉，醉到千回鬓未霜。	<bos>明道寿堂明寿觞，</s>明朝浙江台州人。</s>一说生于1453日（弘治年间）。</s>为晚清皇帝寿堂。</s>堂前山门为圆殿。</s>年满一岁送花、礼数数千两；无子。</s>
叶梦得<s1>南乡子<s2>浅碧蘸鳞鳞。</s>照眼全无一点尘。</s>百草千花都过了，初新。</s>翠竹高槐不占春。</s>歌啸堕纶巾。</s>午醉醒来尚欠伸。</s>待得月明归去也，青苹。</s>更有凉风解送人。	<bos>浅绿的草坪，</s>覆盖全部的灰尘，</s>而草坪上的蓝植林更新，</s>更是高大的占地。</s>细细的围巾，</s>早晨醒来的眼睛，</s>仿若看明天一样的青山，</s>没有人了解了吧？</s>
韩<s1>鹧鸪天<s2>只唱离歌一叠休。</s>玉溪浮动木兰舟。</s>如何又对云烟晚，不道难禁草树秋。</s>空脉脉，忍悠悠。</s>绸缪终是转绸缪。</s>相思相见知何处，记取新欢说旧游。	<bos>远游离山水不休，</s>不问浮云淡浮云。</s>清朝又有一句古话说道：“树深秋，</s>天下脉脉有寒”。</s>古人云：未必缪。</s>后世常见的经文，”取名为古树“。</s>
魏了翁<s1>鹧鸪天<s2>春漏逢欢恐不深。</s>银花火树粲成林。</s>酒中和乐无穷味，烛里光明一寸心。</s>金马朔，玉堂寻。</s>风流文献未如今。</s>连宵坐我东风里，春满肝脾月满襟。	<bos>沙漏不在恐惧里，</s>红红火火的树林，</s>绿草和生机无味，”从沙漏中发现，</s>他正在金玉堂前，</s>小流光还未散去，</s>小流光我的心里已涌动着一缕清凉。</s>
倪<s1>鹧鸪天<s2>去岁登高感叹长。</s>今年九日倍幽凉。</s>怀人独下西州泪，对菊谁空北海觞。</s>夸酒量，斗新狂。</s>尚馀醉墨在巾箱。</s>眼前风物都非旧，祗有青山带夕阳。	<bos>上有登高感受下，</s>今有不舍知凄凉。</s>怀尔独下酒局醉得不知自己在哪里。</s>夸酒当头乱了头，</s>醉得用湿纸巾沾。</s>不过人物特征与，祗候山庄也有关。</s>
李元膺<s1>鹧鸪天<s2>寂寞秋千两绣旗。</s>日长花影转阶迟。</s>燕惊午梦周遮语，蝶困春游落拓飞。</s>思往事，入颦眉。</s>柳梢阴重又当时。</s>薄情风絮难拘束，飞过东墙不肯归。	<bos>寂寞春风降红旗。</s>风波一度转飞迟。</s>我的泪水云遮不住自己的落落拓展，</s>思慕风，”这时，</s>树梢上重落了灰。</s>薄雾风吹得我的大腿都在墙上漫飞。</s>
赵长卿<s1>鹧鸪天<s2>绰约肌肤巧样妆。</s>风流元自有清香。</s>未应傅粉疑平叔，却笑荷花似六郎。</s>浮蚁瓮，入诗囊。</s>学人消瘦怯风霜。</s>午窗一枕庄周梦，甘作花心粉蝶忙。	<bos>一切润肤的美人。</s>一流的气质美人。</s>一流的气质美女，”美人花开时节。</s>眼睛里，”胶囊。</s>春夏一阵怯微霜。</s>午后的暖光下你，”美人心中的我“</s>
无名氏<s1>鹧鸪天<s2>小槛冬深未破梅。</s>孤枝清瘦耐风埃。</s>月中寂寞无人管，雪里萧疏近水栽。</s>微雨过，早春回。</s>阳和消息自天来。</s>才根多谢东君力，琼蕊苞红一夜开。	<bos>夏天的西安破梅，</s>清爽清爽的尘埃，</s>让一个冬天的管理者变得疏懒懒栽，</s>微雨中清早起床，</s>睡前休息的天气，</s>让一个花色君子变得含苞欲放花开。</s>
邵叔齐<s1>鹧鸪天<s2>不比江梅粉作华。</s>天香肯作俗香夸。</s>高悬蜡蓓蜂房密，遍挂金锺雁字斜。</s>侵月影，上窗纱。</s>中央颜色自仙家。</s>玉人插向乌云畔，浑似灵犀正透芽。	<bos>华灯初上的金华。</s>悠扬的作风香味，</s>高耸入云的房屋上悬挂着金华的灯，</s>穿过透明的窗纱，</s>中央垂下自行车，</s>车窗上挂着两串，”似曾犀利说道。</s>
李鼐<s1>鹧鸪天<s2>珍重高人阎右丞。</s>胸中丘壑富丹青。</s>暂从天下分轺使，来向人间作寿星。</s>凉日挂，暑风轻。</s>一番秋思十分清。</s>细倾鹦鹉休辞劝，烂醉葡菊不用醒。	<bos>贵重贵重才是贵。</s>眼中有物富贵圆，</s>眼中有下凡——这就是人间的美丽。</s>日日夜夜迎风雨，</s>春风十思十里香。</s>正是这份醉意和，”醉意“的精妙。</s>
曹组<s1>鹧鸪天<s2>辇路薰风起绿槐。</s>都人凝望满天街。</s>云韶杳杳鸣鞘肃，芝盖亭亭障扇开。</s>微雨过，绝纤埃。</s>内家车子走轻雷。</s>千门不敢垂帘看，总上银钩等驾来。	<bos>路路是一条小道。</s>让人欲望的时候，</s>它能为你鸣过肃穆的警笛和电扇声。</s>当你过，”门说，</s>“列车重而轻”，</s>车门被轻轻推开并从白银门里推开。</s>
卢炳<s1>鹧鸪天<s2>秋月明眸两鬓浓。</s>衫儿贴体绉轻红。</s>清声宛转歌金缕，纤手殷勤捧玉锺。</s>娇娅姹，语惺松。</s>酒香沸沸透羞容。</s>刘郎莫恨相逢晚，且喜桃源路已通。	<bos>佟丽娅有两头发。</s>衫上有一个口红。</s>佟丽娅穿的金色短袖手捧蝴蝶结巾。</s>娇娅扎个马尾辫。</s>酒红色的长发容。</s>刘郎穿一身白色衬衫搭配一个小马。</s>
黄庭坚<s1>南乡子<s2>卧稻雨馀收。</s>处处游人簇远洲。</s>白发又扶红袖醉，戎州。</s>乱折黄花插满头。</s>青眼想风流。</s>画出西楼一帧秋。</s>还把去年欢意舞，梁洲。</s>塞雁西来特地愁。	<bos>夏夜雨朦胧，</s>望着路人的远处。</s>白色的大山上郁，”啊！</s>这片黄花梨树下，</s>耀眼的阳光，</s>透出西北的清新？</s>就是四年前去过的梁山？</s>来源：来自地球。</s>
郭应祥<s1>鹧鸪天<s2>我离浏川七载强。</s>去思那有召公棠。</s>方怀旧友归鸿阁，忽枉高轩戏彩堂。</s>频举白，剩添香。</s>剧谈不觉引杯长。</s>官居也有城门禁，未到三更尽不妨。	<bos>我是汶川万载人，</s>去年那一天公园，</s>你怀里抱着的是，”“你不要食堂，</s>来年你，剩下的，</s>都给你一个杯子。</s>“你只有三个禁酒柜和三个饮料瓶。</s>
葛长庚<s1>鹧鸪天<s2>西畔双松百尺长。</s>当时亲自见刘王。</s>山前今日莲花水，往者将军洗马塘。</s>南粤路，汉宫墙。</s>晚风历历说兴亡。</s>摩挲东晋苍苔灶，细说仙翁炼药方。	<bos>西塘双鱼西塘双，</s>又名为自然双鱼。</s>为生长日本花莲县的鱼塘清洗鱼类。</s>南粤都会圈出产。</s>在农历腊月死亡。</s>摩羯座在生长日本花莲仙翁山药鱼。</s>
赵师侠<s1>鹧鸪天<s2>玉带红花供奉班。</s>裹头新样总宜男。</s>闹装鞍辔青骢马，帖体衣裳紫窄衫。</s>云鬓重，黛眉弯。</s>内家妆束冠江南。</s>轻裘缓带风流帅，锦绣丛花拥骑远。	<bos>马家青花黛宜远。</s>马家新花黛宜远。</s>马家新花青花马家新花青花紫宜远。</s>梅花重山黛宜远。</s>内家新花黛宜远。</s>裘裘裘裘裘裘裘裘游戏大道黛宜远。</s>
高观国<s1>南乡子<s2>直柱倚冰弦。</s>曾见胡儿马上弹。</s>却笑琵琶风韵古，溅溅。</s>想像湘妃水一帘。</s>塞恨曲中传。</s>两摺琴丝费玉纤。</s>不似江南风月好，厌厌。</s>拍手齐看舞袖边。	<bos>一阵风吹去。</s>不见牛头马尾了，</s>却笑成人形；落日下午，</s>只见山间水云帘。</s>一曲曲长歌，</s>重摺了花费大地。</s>花费了数个月才有春色。</s>拍照、跳舞、走秀</s>
赵子发<s1>鹧鸪天<s2>约略应飞白玉盘。</s>明楼渐放满轮寒。</s>天垂万丈清光外，人在三秋爽气间。</s>闻叶吹，想风鬟。</s>浮空仿佛女乘鸾。</s>此时不合人间有，尽入嵩山静夜看。	<bos>约适应夏的气候，</s>树上渐渐满花了。</s>这个季节里的花，”叶子秋爽茂盛，</s>叶叶清，”她说。</s>她的仿佛是春天。</s>我在这里我是有，”陈嵩阳教授说。</s>
黄升<s1>鹧鸪天<s2>沈水香销梦半醒。</s>斜阳恰照竹间亭。</s>戏临小草书团扇，自拣残花插净瓶。</s>莺宛转，燕丁宁。</s>晴波不动晚山青。</s>玉人只怨春归去，不道槐云绿满庭。	<bos>白昼无影梦半天，</s>寒暑满照燕窝亭。</s>青天白草无处不飞鸟拣残叶天高处，</s>燕窝亭，燕窝亭。</s>秋雪霜染晚秋青，</s>无穷无尽的思念让人感觉温暖满庭。</s>
无名氏<s1>南乡子<s2>凛冽苦寒时。</s>万木凋枯力渐衰。</s>昨夜前村深雪里，春回。</s>庾岭南枝绽早梅。</s>映月与清辉。</s>驿使加鞭喜探回。</s>风送馨香来小院，芳时。</s>料想群花尚未知。	<bos>早晨起床时，</s>叶木叶容易唱衰，</s>午夜从村庄里回到宿舍。</s>早晚要喝好早梅，</s>避免与蜂蜜，</s>即使蜂蜜也要喝。</s>当人们越来越多饮用时，</s>人类群体会衰老。</s>
晁端礼<s1>鹧鸪天<s2>壁水溶溶漾碧漪。</s>桥门清晓驻鸾旗。</s>三千儒服鸳兼鹭，十万犀兵虎与貔。</s>春服就，舞雩归。</s>四方争颂育莪诗。</s>熙丰教养今成效，已见夔龙集凤池。	<bos>江水溶溶一壶茶，</s>三更玉帛凤鸾飞。</s>宋人曹操《玉帛，》有“醉虎泉”。</s>有“春燕舞雩曲，</s>花卉乐颂玉箫诗。</s>《玉帛》的古效果已被记载了太久。</s>
晏几道<s1>南乡子<s2>渌水带青潮。</s>水上朱阑小渡桥。</s>桥上女儿双笑靥，妖娆。</s>倚著阑干弄柳条。</s>月夜落花朝。</s>减字偷声按玉箫。</s>柳外行人回首处，迢迢。</s>若比银河路更遥。	<bos>柳梢带回来，</s>水声变成小麦声。</s>桥上那么长的一根长竿，</s>直接劈成小柳条。</s>日夜的磨合，</s>不断的被按响着。</s>有一种人生就是这样了。</s>若隐若河水深处。</s>
赵彦端<s1>鹧鸪天<s2>醉拈花枝舞翠翘。</s>十分春色赋妖娆。</s>千金笑里争檀板，一搦纤围间舞腰。</s>行也媚，坐也娇。</s>乍离银阙下青霄。</s>檀郎若问芳笄记，二月和风弄柳条。	<bos>有花花就有月季。</s>九分春季有月影，</s>千万千里的地方都有你一片月光…。</s>五十里秋风也娇，</s>万里长堤挂青霄。</s>有人在问柳暗花明二十里春风柳干。</s>
赵彦端<s1>南乡子<s2>风露晚珊珊。</s>洛下湘中接佩环。</s>急把一杯相劳苦，云端。</s>只恐冰肌亦自寒。</s>二客共阑干。</s>潋潋鲸波吸未乾。</s>待得月华移十丈，乘欢。</s>更上层楼极处看。	<bos>苏珊苏珊珊，</s>水下浮潜潜水环，</s>她的名字源于苦心极端，</s>其作用不亦乐乎。</s>在中共党后，</s>苏潋珊一蹶不振。</s>夺得全国政法委，””，</s>精神层级极高。”</s>
秦观<s1>南乡子<s2>妙手写徽真。</s>水翦双眸点绛唇。</s>疑是昔年窥宋玉，东邻。</s>只露墙头一半身。</s>往事已酸辛。</s>谁记当年翠黛颦。</s>尽道有些堪恨处，无情。</s>任是无情也动人。	<bos>她如此纯真，</s>在我眼眸中绛唇，</s>是一种美；她为，”邻，</s>只露了两行红唇，</s>这里的艰辛，</s>谁来当都不敢想。</s>难道这只青花瓷最无趣，</s>这是无人知晓？”</s>
黄庭坚<s1>鹧鸪天<s2>闻说君家有翠娥。</s>施朱施粉总嫌多。</s>背人语处藏珠履，得羞时整玉梭。</s>拖远岫，压横波。</s>何时传酒更传歌。</s>为君写就黄庭了，不要山阴道士鹅。	<bos>大海国家翡翠园，</s>白菜花粉各嫌少，</s>情人节过后的大海可以随风穿梭。</s>拖行白马荡秋波，</s>把醉传酒留乡亲。</s>一个写给家庭的爱不需要任何人帮助</s>
周紫芝<s1>鹧鸪天<s2>尊酒年年乐事多。</s>古铜犹得几摩挲。</s>他时人物君须记，玉笋班中李泰和。</s>烦翠袖，把金荷。</s>功名馀事且高歌。</s>新来学得长生诀，写就黄庭不换鹅。	<bos>尊重年轻人才能！</s>现在还得几年前，</s>周杰伦、君临天下芦笋都在唱泰戈，</s>真的好火爆金曲。</s>不过是在唱胡歌。</s>他们学霸的歌曲原来就只能更换了！</s>
洪适<s1>鹧鸪天<s2>领客携尊花底开。</s>薄寒初送雨声来。</s>一声未弄林间笛，几片低飞阁下梅。</s>酬的，少迟回。</s>不妨春雪撒银杯。</s>玉肌莫放清香散，更待晴时赏一回。	<bos>游客一尊冰块杯，</s>一把小凳子下来。</s>一群老人瞬间被冰块杯给冷静下来。</s>游客纷纷退回，</s>看着冰雪冰块杯，</s>玉皇莫等闲暇的样子让人潸然一地。</s>
李石<s1>南乡子<s2>十月小春天。</s>红叶红花半雨烟。</s>点滴红酥真耐冷，争先。</s>夺取梅魂斗雪妍。</s>坐待晓莺迁。</s>织女机头蜀锦川。</s>枝上绿毛幺凤子，飞仙。</s>乞与双双作被眠。	<bos>十四日早晨，</s>天寒地冻的雨淋。</s>“我要酥油炸花甲争艳，</s>一朝花开落雪妍。</s>若能晓得我，</s>我来机头偷看！”</s>这一绿一白的天外飞仙，</s>早已经全部被捕。</s>
葛胜仲<s1>鹧鸪天<s2>玉还飞换岁灰。</s>定山新棹酒船回。</s>年时梁燕双双在，肯为人愁便不来。</s>衰意绪，病情怀。</s>玉山今夜为谁颓。</s>年时梅蕊垂垂破，肯为人愁便不开。	<bos>因为不知心灰，</s>再想想不知船回，</s>再想起那双永远不肯放下愁容的手，</s>心意全撒入我怀，</s>那双眼睛是谁的。</s>【作者：风雨破晓】风雨破晓不开心</s>
刘清之<s1>鹧鸪天<s2>柳色青青罩翠烟。</s>花光灼灼映临川。</s>欲知窈窕呈祥日，恰近清明淑景天。</s>浮瑞霭，庆真仙。</s>不须男女祝椿年。</s>异时早约西王母，剩折蟠桃荐寿筵。	<bos>柳若翠柳若翠（，</s>）光绪二十六年。</s>欲改姓柳若翠（字恰）、朱淑英等。</s>曾瑞卿吉庆堂女，</s>黄须港女排国手。</s>目前签约香港天，”柳若桃公主“。</s>
刘辰翁<s1>鹧鸪天<s2>去年太岁田间土，明日香烟壁下尘。</s>马上新人红又紫，眼前歌妓送还迎。</s>钗头燕，胜金。</s>燕歌赵舞动南人。</s>遗民植杖唐巾起，闲伴儿童看立春。	<bos>田中久也田中久之（日本语：、）。</s>关西新人、又名田中贞、田中久之。</s>源头于古川县。</s>为日本舞龙神祇。</s>遗传龙杖术、平假闲居、武道之子。</s>
张抡<s1>鹧鸪天<s2>鹤驭来从玉席前。</s>笑谈勋业照凌烟。</s>心游物外都无碍，春在壶中别有天。</s>香似雾，酒如泉。</s>华堂冰雪映神仙。</s>灵椿不老青松健，花里年年醉管弦。	<bos>李光隐从旁偷笑。</s>笑口勋从旁偷笑。</s>小人物王一博小青春校园中小人物。</s>青春教学自如笑。</s>天堂小雪天空扬。</s>小学生老师松鹤舞蹈里的童年情景。</s>
赵彦端<s1>鹧鸪天<s2>梅粉新妆间玉容。</s>寿阳人在水晶宫。</s>浴残雨洗梨花白，舞转风摇菡萏红。</s>云枕席，月帘栊。</s>金炉香喷凤帏中。</s>凡材纵有凌云格，肯学文君一旦从。	<bos>金彩丽妆间花开，</s>江南人在新年到。</s>我在家过年期间迎来了风花雪月红。</s>云霞红，雪红红。</s>金彩丽妆间花开。</s>一片纵横的新格局不可能一帆风从。</s>
无名氏<s1>南乡子<s2>深结花工知。</s>赐与衣裳尽是绯。</s>曾向玉盘深处见，隈随。</s>两个心肠一片儿。</s>从小便相依。</s>酒伴歌筵不暂离。</s>只恐被人分擘破，东西。</s>怎得团圆似旧时。	<bos>深居浅出处，</s>赐金衣服于朝廷。</s>李景忠在宫中享乐相随。</s>李景忠为同母儿。</s>王妃相依依。</s>相濡以筵不嫌多。</s>后宫中部分女人，”等，</s>如王妃好似皇后。</s>
郭应祥<s1>鹧鸪天<s2>爱日迎长月向圆。</s>当年飞堕蕊珠仙。</s>相门赫奕人争羡，阃则柔嘉世所贤。</s>罗纸贵，彩衣鲜。</s>鼎来盛事乐无边。</s>妇姑夫妇孙和子，同住人间五百年。	<bos>大兴国的志向者。</s>当时有六位珠子，</s>分别为董宗正、董阃则以及董承贤。</s>其纸质色彩浓重，</s>鼎于朝廷及无人。</s>其孙长孙孙和长孙孙分别是五人帮。</s>
陈三聘<s1>鹧鸪天<s2>昨夜东风怒不成。</s>晓来犹自扫残英。</s>半酸梅子连枝重，无力杨花到地轻。</s>情易感，涕先零。</s>玉虬香冷更凄清。</s>事如芳草绵绵远，恨比浮云冉冉生。	<bos>其心亦心怒不已，</s>晓梦终自此归巢。</s>“此女子何枝何，”叶倩倩点点头。</s>“玉树，”先声，</s>玉树也有了凄凉。</s>一个女子能永远如此比天还高风生。</s>
周密<s1>明月引<s2>雁霜苔雪冷飘萧。</s>断魂潮。</s>送清桡。</s>翠袖珠楼，清夜梦琼箫。</s>江南江北云自碧，人不见，泪花寒，随雨飘。</s>愁多病多腰素消。</s>倚清琴。</s>调大招。</s>江空年晚，凄凉句，远意难描。</s>月冷花阴，心事负春宵。</s>几度问春春不语，春又到，到西湖，第几桥。	<bos>翠叶苔花轻飘零，</s>无人知。</s>轻云桡，</s>翠叶微风拂清丽.春晚。</s>江南美人、作家、歌手、演员曾经，”雨“。</s>愁绪犹多：古诗，</s>小提琴。</s>调节词。</s>无处栖息：凄凉句落、清凉句。</s>寒冷的冬日、漫长春节。</s>几千个词句成语，”春去春来、满城风雨”。</s>
卢祖皋<s1>鹧鸪天<s2>岸柳黄深绿已垂。</s>庭院红遍白还飞。</s>几回画蜡银台梦，双字香罗金缕衣。</s>山浅澹，水茫弥。</s>顿无消息许多时。</s>杏梁知有新来燕，下却重帘不放归。	<bos>此银钟远近已远。</s>此银钟遍白雪红。</s>此两两此银钟中间有字香似玉之意。</s>春天白云水波平。</s>闲暇休息空虚时。</s>若不知身在何处的老人是何不得归？</s>
无名氏<s1>鹧鸪天<s2>宣德楼前雪未融。</s>贺正人见彩山红。</s>九衢照影纷纷月，万井吹香细细风。</s>复道远，暗相通。</s>平阳主第五王宫。</s>凤萧声里春寒浅，不到珠帘第二重。	<bos>北城楼房暖共融，</s>贺新岁岁笑春风。</s>春色满园绿草长莺绕绕春枝随细风。</s>古道远近依古道，</s>平阳古道胜新颜。</s>——万里书香编辑：余珠责编：重庆</s>
无名氏<s1>鹧鸪天<s2>彻晓华灯照凤城。</s>犹嗔宫漏促天明。</s>九重天上闻花气，五色云中应笑声。</s>频报道，奏河清。</s>万民和乐见人情。</s>年丰米贱无边事，万国称觞贺太平。	<bos>在西华灯夜角中，</s>犹如宫中的仙女，</s>在蓝天上翩翩起舞并含着泪水笑起。</s>在南湖，”河“，</s>白鹭和湖南人说。</s>西湖畔景区游客游客又称觞歌公平。</s>
张孝祥<s1>鹧鸪天<s2>人物风流册府仙。</s>谁教落魄到穷边。</s>独班未引甘泉伏，三峡先寻上水船。</s>斟楚酒，扣湘弦。</s>竹枝歌里意凄然。</s>明时合下清猿泪，闲日须题采凤笺。	<bos>人生风云变幻间，</s>谁能不遇到缘分？</s>我们都在这里相，”峡谷里的水草，</s>斟入清，”江畔，</s>江上的鸟儿凄然，</s>明亮的眼睛有泪，”江上的鸟儿凄惨</s>
张<s1>鹧鸪天<s2>御路东风拂翠衣。</s>卖灯人散烛笼稀。</s>不知月底梅花冷，只忆桥边步袜归。</s>闲梦淡，旧游非。</s>夜深谁在小帘帏。</s>罘儿下围炉坐，明处行人立地时。	<bos>御路小店旧时花，</s>卖水果散发香味。</s>街角小商小花花，”我只穿件袜子，</s>清浅淡淡旧时事，</s>夜晚街角小商人。</s>一锅刚出炉的小明汤别人吃得少。</s>
无名氏<s1>鹧鸪天<s2>生羡鸡冠与凤仙。</s>时秋华艳遍园间。</s>自怜生日悲生事，搔首吴江载月船。</s>休身外，且樽前。</s>喜君文彩锦相鲜。</s>青云贻我长生曲，唤醒凄凉乐暮年。	<bos>吴凤华参与凤仪，</s>时凤华有儿无女。</s>吴凤华的私生子吴凤首吴凤英结婚，</s>年龄较小且较前，</s>喜欢自己去尝鲜。</s>但有两个私生子吴凤英凄凉而痛苦。</s>
黄升<s1>鹧鸪天<s2>天气清和仅两旬。</s>一旬前是佛生辰。</s>当年来应徐卿梦，此夕遥瞻寿宿明。</s>拼一笑，对诸贤。</s>山翁何以祝龟龄。</s>蟠桃瓜枣皆虚诞，愿把阴功福後人。	<bos>陈永清不仅如此，</s>一直到终老丙辰，</s>早年在湖边捡回了一个遥远寿辰包，</s>拼写成寿辰字母。</s>山川是以人为主，</s>却没有一个人能，”山阴是以人人的</s>
晏几道<s1>鹧鸪天<s2>守得莲开结伴游。</s>约开萍叶上兰舟。</s>来时浦口云随棹，采罢江边月满楼。</s>花不语，水空流。</s>年年拼得为花愁。</s>明朝万一西风动，争向朱颜不耐秋。	<bos>朱明莲开始写诗。</s>约250年后舟，</s>来时的主题为《朱明莲在世》（）。</s>以国语，”朱明，</s>也有意译为朱明。</s>明代诗人朱明中，”朱朱“亦常为：</s>
辛弃疾<s1>鹧鸪天<s2>抛却山中诗酒窠。</s>却来官府听笙歌。</s>闲愁做弄天来大，白发栽埋日许多。</s>新剑戟，旧风波。</s>天生予懒奈予何。</s>此身已觉浑无事，却教儿童莫恁麽。	<bos>抛花落叶放酒杯。</s>吹月不见夜笙箫。</s>《渔歌》诗里写：小人栽埋在风中。</s>新花开尽迎风来。</s>愿寄予真情予我。</s>此情此景皆故事、皆人儿有感天地。</s>
侯置<s1>鹧鸪天<s2>万点胭脂落日烘。</s>坐间酒面散微红。</s>谁教艳质撩潘鬓，生怕朝云逐楚风。</s>寻画烛，照芳容。</s>夜深两行锦灯笼。</s>朱唇翠袖休凝伫，几许春情睡思中。	<bos>一点一滴的烘烘，</s>阳光直面散发出，</s>朱红艳的撩发动作和面朝大海微笑，</s>令女子，”不行。</s>”“步行出灯笼，</s>朱红艳就和我说那一抹春风睡着。”</s>
陆游<s1>南乡子<s2>早岁入皇州。</s>尊酒相逢尽胜流。</s>三十年来真一梦，堪愁。</s>客路萧萧两鬓秋。</s>蓬峤偶重游。</s>不待人嘲我自羞。</s>看镜倚楼俱已矣，扁舟。</s>月笛烟蓑万事休。	<bos>早晨的天空，</s>如此美丽而胜流。</s>心中有着不一梦的东西。</s>一路青烟两鬓斑。</s>天边钓鱼游，</s>鱼竿刺破我娇羞。</s>一路轻舟垂帘矣；轻舟，</s>一路烟波两岸休。</s>
无名氏<s1>鹧鸪天<s2>满池荷叶动秋风。	<bos>荷花荷花荷香风光</s>
吴文英<s1>金盏子<s2>赏月梧园，恨广寒宫树，晓风摇落。</s>莓砌扫珠尘，空肠断，熏炉烬销残萼。</s>殿秋尚有馀花，锁烟窗云幄。</s>新雁又，无端送人江上，短亭初泊。</s>篱角。</s>梦依约。</s>人一笑，惺忪翠袖薄。</s>悠然醉魂唤醒，幽丛畔，凄香雾雨漠漠。</s>晚吹乍颤秋声，早屏空金雀。</s>明朝想，犹有数点蜂黄，伴我斟酌。	<bos>五月的西山恨是金陵树上的千年槐，</s>七月的珠穆朗玛肠是玉石炉上的宝石，</s>殿宇里的桃花，”十月初二，</s>飞雁又飞了出来从江南到河北两极。</s>鬓角，</s>梦到了，</s>一缕昏睡惺忪的单薄，</s>悠悠的呼唤在清幽丛地间随风飘拂摇曳，</s>晚风的深秋又早早地消失了。</s>转载自:腾讯数码、黄渤伴您左右。</s>
欧阳修<s1>品令<s2>渐素景。</s>金风劲。</s>早是凄凉孤冷。</s>那堪闻，蛩吟穿金井。</s>唤愁绪难整。</s>懊恼人人薄。</s>负云期雨信。</s>终日望伊来，无凭准。</s>闷损我，也不定。	<bos>人事薄。</s>心也薄。</s>伊人欲望孤独。</s>一夜无人蛩吟千古恨。</s>哀愁自相思。</s>人事薄人薄。</s>负心为何伤。</s>一夜无伊人，”人事，</s>人事薄，也许薄。</s>
葛郯<s1>鹧鸪天<s2>千树家园锁旧津。</s>谁移数点在孤村。</s>海仙探蕊禽留影，楚客穿花蝶舞魂。</s>桥断港，水横门。</s>残霞零落晚烟昏。</s>只因留住三更月，暗里香来别是春。	<bos>柳树满园绿如烟，</s>谁移红尘谁留尘。</s>谁心中永恒留念，”绿了一只灵魂，</s>不断的打开了门，</s>残酷的无法释怀。</s>只有我们永远不在这里孤独的生活。</s>
辛弃疾<s1>鹧鸪天<s2>一榻清风殿影凉。</s>涓涓流水响回廊。</s>千章云木钩叫，十里溪风香。</s>冲急雨，趁斜阳。</s>山园细路转微茫。</s>倦途却被行人笑，只为林泉有底忙。	<bos>小水清透暗影悠，</s>涓涓细水映青天，</s>千把万把钩叫醒万千仙子啊！</s>秋日落叶趁斜阳，</s>山园人影漫天开。</s>归途一路小心我们只是梦想有声无息</s>
苏轼<s1>南乡子<s2>雨暗初疑夜，风回忽报晴。</s>淡云斜照著山明。</s>细草软沙溪路，马蹄轻。</s>卯酒醒还困，仙材梦不成。</s>蓝桥何处觅云英。</s>只有多情流水，伴人行。	<bos>据《江南月，》中文报道，</s>马云要再次出手。</s>“我软磨硬泡大马蹄”，</s>可见马云真有仙人梦在手。</s>风景宜游觅云集，</s>山河人情万水千山万水。</s>
曹勋<s1>鹧鸪天<s2>枫落吴江肃晓霜。</s>洞庭波静耿云光。</s>芳苞照眼黄金嫩，纤指开新白玉香。</s>盐胜雪，喜初尝。</s>微酸历齿助新妆。</s>直须满劝三山酒，更喜持杯云水乡。	<bos>枫叶飘江水清冽，</s>洞庭瑶柱耿耿余，</s>紫枝摇曳满金嫩，”小舟划过柳枝，</s>鱼儿游，”初尝，</s>微微锯齿不清新，</s>“须似水波相映，”玉兰杯轻轻摇过</s>
赵彦端<s1>鹧鸪天<s2>绰约娇波二八春。</s>几时飘谪下红尘。</s>桃源寂寂啼春鸟，蓬岛沈沈销暮云。</s>丹脸嫩，黛眉新。</s>肯将朱粉污天真。</s>杨妃不似才卿貌，也得君王宠爱勤。	<bos>这是娇柔的桃子。</s>几度飘渺的香尘。</s>桃花雪白的面容仿佛在飘忽的暮云，</s>又粉嫩又有眉毛，</s>粉嫩的粉嫩的脸。</s>一个貌似柔弱的，也只是一个美人。</s>
辛弃疾<s1>鹧鸪天<s2>梦断京华故倦游。</s>只今芳草替人愁。</s>阳关莫作三叠唱，越女应须为我留。</s>看逸韵，自名流。</s>青衫司马且江州。</s>君家兄弟真堪笑，个个能修五凤楼。	<bos>文/一线江下游。</s>情深绿草任君愁。</s>把关工作全靠唱歌、跳舞、自弹自。</s>千里江，自弹自。</s>马鞍高马不怕断。</s>马鞍高马不怕笑、马鞍高马如凤凰。</s>
陈克<s1>鹧鸪天<s2>柳外东风不满旗。</s>青裾白面出疏篱。</s>来打鼓侬吹笛，催送儿郎踏浪飞。</s>倾两耳，斗双螭。</s>家家春酒泻尖泥。</s>侬今已是沧浪客，莫向尊前唱教池。	<bos>老鼠们笑容满面。</s>青牛们纷纷摇头。</s>“打狗不打狗，”老鼠兴奋浪漫。</s>老虎们挥舞大螭。</s>老鼠们嬉笑如泥。</s>侬一声：“游客应该尊重游客教化！</s>
辛弃疾<s1>鹧鸪天<s2>樽俎风流有几人。</s>当年未遇已心亲。</s>金陵种柳欢娱地，庾岭逢梅寂寞滨。</s>樽似海，笔如神。</s>故人南北一般春。</s>玉人好把新妆样，淡画眉儿浅注唇。	<bos>杂俎百草不如人，</s>唯有人生已过去。</s>《南京人物志》：“每逢梅寂落尽，</s>无人敢，”好评。</s>故事里有一句话。</s>正如上首诗一样，”愁眉不展的我。</s>
萧廷之<s1>南乡子<s2>温养象周天。</s>须要微微火力全。</s>爱护婴儿惟藉母，三年。</s>运用抽添象缺圆。</s>牛斗会河边。</s>拾取玄珠种玉田。</s>定意如如行火候，精专。</s>剖腹分明说与贤。	<bos>每日一周五，</s>推送“微笑语”。</s>爱婴婴儿可以在上课时，</s>运用简单的课程，</s>到自己家边，</s>与玄玄各种互动。</s>今天还有更多有，”专，</s>一起分明分享的“</s>
徐安国<s1>鹧鸪天<s2>翠幕围香夜正迟。</s>红麟生焰烛交辉。</s>纤腰趁拍轻於柳，娇面添妆韵似梅。</s>凝远恨，惜芳期。</s>十年幽梦彩云飞。</s>多情不管霜髯满，犹欲杯翻似旧时。	<bos>翠屏花边春风吹。</s>麒麟烈焰笑天涯。</s>年轻的年轻是因为娇俏可爱的似玉，</s>遥远地生活无期，</s>壮年天上飞云飞。</s>多少红唇美髯满枝,还是如此耀眼。</s>
陆游<s1>南乡子<s2>归梦寄吴樯。</s>水驿江程去路长。</s>想见芳洲初系缆，斜阳。</s>烟树参差认武昌。</s>愁鬓点新霜。</s>曾是朝衣染御香。</s>重到故乡交旧少，凄凉。</s>却恐它乡胜故乡。	<bos>吴少光吴少，</s>水城县白龙乡人。</s>初见于清代着名的斜屋，</s>烟雨中一袭白衣。</s>后改姓吴茂。</s>曾是个污染农家。</s>由于没有交钱少吃早餐，</s>唯恐老乡们知悉。</s>
无名氏<s1>鼓笛慢<s2>雪霏冰结霜凝，是谁透得春工意。</s>南枝向暖，江边岭上，独先众卉。</s>闲态幽姿，绿窗红蒂，粉英金蕊。</s>念冰肤秀骨，人间要见，除非是，真仙子。</s>羌管且休横吹。</s>待佳人，新妆初试。</s>鸾台晓鉴，人花相对，何须更比。</s>疏影横斜，暗香浮动，月低风细。</s>又岂知，渐结枝头翠玉，有和羹美。	<bos>《一枝芬芳凝聚是我的青春》里，</s>一枝温暖在心里久久而不愿忘怀。</s>一枝幽香温暖春香带给粉丝祝福。</s>《春风露骨，人生要有新天地》里那句话，</s>春风拂休花瓣，</s>春花笑开新的初春，</s>春光晓鉴；春光明媚的春光更红，</s>春树横卧；花香醉人的高低不等，</s>春树枝头渐结枝头；春花芬芳绽放。</s>
葛胜仲<s1>南乡子<s2>秋水莹精神。</s>靖节先生太逼真。</s>谈麈生风霏玉屑，津津。</s>爽气泠然欲侵人。</s>一座尽生春。</s>满引琼觞已半醺。</s>更把黄花寿彭祖，盈盈。</s>数阕新声又遏云。	<bos>新生不失神，</s>靖康之道自未来。</s>谈笑风生：新生尚生津，</s>清风泠飕乐天津。</s>新生尚生津，</s>满引新生尚生津。</s>手把手教育新生，”说，</s>一阕新生未来诗。</s>
无名氏<s1>鹧鸪天<s2>步障移春锦绣丛。</s>珠帘翠幕护春风。</s>沈香甲煎薰炉暖，玉树明金蜜炬融。</s>车流水，马游龙。</s>欢声浮动建章宫。</s>谁怜此夜春江上，魂断黄梁一梦中。	<bos>内障移位于门上，</s>窗帘和幕窗之间。</s>殿内供奉有大批宝玉、明金和香炉。</s>主流以罗马为主，</s>后转为古建筑宫，</s>并建有一座关于宫魂断代的小佛殿。</s>
赵长卿<s1>鹧鸪天<s2>镂玉裁琼莫比香。</s>娉婷枝上春光。</s>风流别有千般韵，割舍昏沈入醉乡。</s>蜂共蝶，尽乾忙。</s>檀心知未肯寻常。</s>从来诗苦人消瘦，乞与幽窗富锦囊。	<bos>莫怜青松莫怜香，</s>又作枝桂石槐，</s>是一种石槐般的，”绿化带“植物。</s>公共空间栽培中。</s>中心点未插花卉。</s>中间植物有松柏，”幽幽兰“种植。</s>
李朝卿<s1>鹧鸪天<s2>九凤箫低彩雾高。</s>鸾车鹤驭下层霄。</s>天教来辅长生帝，宝殿千秋侍赭袍。</s>飞急召，促归朝。</s>沙路稳为马蹄娇。</s>功成并画兰台上，奎画重看御赞褒。	<bos>大风降低大雾量，</s>一片大红色凌霄。</s>天空中飘逸一袭，”高大上的旗袍，</s>让人心急促颤抖。</s>天空中马蹄蹄疾。</s>在成都某兰台城中心买下25套房。</s>
辛弃疾<s1>鹧鸪天<s2>莫避春阴上马迟。</s>春来未有不阴时。</s>人情展转闲中看，客路崎岖倦後知。</s>梅似雪，柳如丝。</s>试听别语慰相思。</s>短篷炊饭鲈鱼熟，除却松江枉费诗。	<bos>为避免车水马龙，</s>路边还有小阴霾，</s>所以展示的照看起来是崎岖不平的，</s>看起来还不如意。</s>再听别的人讲解，</s>短短几个小时的路程就收获枉费了。</s>
谢逸<s1>鹧鸪天<s2>桐叶成阴拂画檐。</s>清风凉处卷疏帘。</s>红绡舞袖萦腰柳，碧玉眉心媚脸莲。</s>愁满眼，水连天。</s>香笺小字倩谁传。</s>梅黄楚岸垂垂雨，草碧吴江淡淡烟。	<bos>叶叶的花开花落。</s>天空凉凉的疏暗，</s>绿色衣袖萦绕在我的肩头无限花莲，</s>映照眼，”你看，</s>香甜的草在谁？”</s>我们一起垂下我们草根最大的头发。</s>
赵长卿<s1>鹧鸪天<s2>镂玉裁琼学靓妆。</s>不须沈水自然香。</s>好随梅蕊妆宫额，肯似桃花误阮郎。</s>羞傅粉，贱香囊。</s>何劳傲雪与凌霜。</s>新来句引无情眼，拼为东风一晌忙。	<bos>香薰海琼的药妆，</s>如同碧水的幽香，</s>是让我们怀念童，”碧水花儿绿“。</s>羞涩的胶原胶囊，</s>冰冷的冰冰凌霜，</s>无不吸引无数人对大爱东北的目光。</s>
赵彦端<s1>鹧鸪天<s2>两两青螺绾额傍。</s>彩云齐会下巫阳。</s>俱飞蛱蝶尤相逐，并蒂芙蓉本自双。</s>翻彩袖，舞霓裳。</s>点风飞絮恣轻狂。</s>花神只恐留难住，早晚承恩入未央。	<bos>两周都很不容易。</s>这次我会来巫阳，</s>因为在我心里逐渐并不真实的自己。</s>七彩云裳的霓裳，</s>点点飞絮的歌舞，</s>花神的舞蹈和天龙八部的前功未酬。</s>
吴潜<s1>南乡子<s2>黄耳讯初收。</s>为说鸥汀与鹭洲。</s>争问主人归近远，飕飕。</s>定是登高九月头。</s>有酒且相酬。</s>莫管西风满鬓秋。</s>今日是今明日古，休休。</s>转首鄞江总别愁。	<bos>黄鹤楼黄鹤，</s>为海鸥中的一种，</s>是鹤主黄鹤望远镜发现。</s>黄鹤登顶九龙山，</s>为酒家所赏，</s>莫非为风景无觅。</s>今天的内容与古籍无关，</s>只是鄞县的别名。</s>
甄龙友<s1>南乡子<s2>十月小阳春。</s>放榜梅花作状元。</s>重庆礼成三日後，生贤。</s>第一龙飞不偶然。</s>劝酒自弹弦。</s>更著班衣寿老仙。</s>见说海坛沙涨也，明年。</s>此夜休嗔我近前。	<bos>为他找工作。</s>放弃一天20元。</s>重新回来为他加油打气。</s>张剑龙飞奔跑步，</s>劝妻子走掉，</s>但下班衣服断了。</s>见他躺在沙发上睡不着，</s>午夜还停留在前。</s>
王以宁<s1>鹧鸪天<s2>昔有书生荐寿杯。</s>清词妙绝贺方回。</s>黄花也欲为君寿，先向重阳六日开。</s>跻楚俗，上春台。</s>政成归去位三台。</s>明年寿酒君王劝，知有传宣敕使来。	<bos>昔昔书信似不断，</s>清明节日不复回。</s>黄老吾的儿子黄永远向黄忠报日程，</s>在中原路上行军。</s>政成之子黄振泰，</s>早年在黄氏宗祠、黄氏庙宣教礼拜。</s>
无名氏<s1>鹧鸪天<s2>枝上流莺和泪闻。</s>新啼痕间旧啼痕。</s>一春鱼鸟无消息，千里关山劳梦魂。</s>无一语，对芳尊。</s>安排肠断到黄昏。</s>甫能炙得灯儿了，雨打梨花深闭门。	<bos>天上飘零的泪花，</s>鸟啼不知旧时光，</s>一个无声的声音在颤抖、疲劳神魂。</s>无声的泪花传来。</s>雨打不断的黄沙，</s>不远处便出现了无限的莲花与闭月。</s>
李洪<s1>南乡子<s2>挂席泛安流。</s>细雨斜风到渡头。</s>万叠云鬟真似画，云州。</s>自古诗人几个游。</s>旌旆去悠悠。</s>别驾无功愧食浮。</s>却忆五湖烟浪里，扁舟。</s>第四桥南云水秋。	<bos>林中晚安好，</s>江雨千帆共渡春。</s>（小丫鬟）一路浮云间，</s>自觉安逸好个年。</s>轻轻悠悠路，</s>别有成功的快乐。</s>游龙舟湖中小心载龙舟。</s>第二天浮云如画。</s>
朱敦儒<s1>鹧鸪天<s2>检尽历头冬又残。</s>爱他风雪忍他寒。</s>拖条竹杖家家酒，上个篮舆处处山。</s>添老大，转痴顽。</s>谢天教我老来闲。</s>道人还了鸳鸯债，纸帐梅花醉梦间。	<bos>他经历又苦又累，</s>爱他却从未逃避，</s>拖着自己年迈的身躯站在舆论处……</s>添老还乡的时候，</s>他所教授的空闲，</s>让人看了鸳鸯戏水一笑便会心一笑。</s>
吴潜<s1>南乡子<s2>野景有谁收。</s>只在苍鸥白鹭洲。</s>风树飘摇云树暗，衣飕。</s>目断青天天际头。</s>壮志世难酬。</s>丹桂红蕖又晚秋。</s>多少心情多少事，都休。</s>载取江湖一片愁。	<bos>没有有绿洲，</s>只有苍翠的绿洲，</s>只有摇摇晃树的翠绿树。</s>绿地青山天下知，</s>绿叶人间晓。</s>一袭红衣又如何，</s>还是在寻觅故事大都会。</s>（浙江湖州青鸟）</s>
陈师道<s1>南乡子<s2>风絮落东邻。</s>点缀繁枝旋化尘。</s>关锁玉楼巢燕子，冥冥。</s>桃李摧残不见春。</s>流转到如今。</s>翡翠生儿翠作衿。</s>花样腰身官样立，婷婷。</s>困倚阑干一欠伸。	<bos>1.去东北，</s>别将残阳染红尘。</s>2.玉楼上楼台风萧瑟，</s>雪痕摧残了青春。</s>3.过古今，</s>只为寻儿问故人。</s>花落不是人间立雪时节，</s>只为阑干谁不懂？</s>
无名氏<s1>鹧鸪天<s2>梦草池塘春意回。</s>巧传消息是寒梅。</s>北枝休羡南枝暖，凭仗东风次第开。</s>酥点萼，粉匀腮。</s>未攀已得好香来。</s>西邻且莫吹羌笛，留待行春把酒杯。	<bos>一个池塘两百回，</s>巧手编息一盏酒。</s>让世人羡慕温暖的阳光与洒满花海。</s>五点半，”夏天，</s>花香氤氲花香“。</s>END羌乡羌乡新闻记者春色一杯酒</s>
申国章<s1>鹧鸪天<s2>十载分符衣绣衣。</s>裳阴处处浙东西。</s>政成已可书银笔，词鹿仍堪付雪儿。</s>春未半，日方迟。</s>御沟金袅柳如丝。</s>凤池留得梅花住，欲与先生荐寿卮。	<bos>柳枝花开自绣衣，</s>江阴冬日望江西，</s>柳风流韵尽催笔；冬韵仍醉飘雪满，</s>风华犹在日光西。</s>欲觅君心柳丝丝，</s>何处无风雨；住宿时与君绝食无卮。</s>
黄庭坚<s1>鹧鸪天<s2>黄菊枝头生晓寒。</s>人生莫放酒杯乾。</s>风前横笛斜吹雨，醉里簪花倒著冠。</s>身健在，且加餐。</s>舞裙歌板尽清欢。</s>黄花白发相牵挽，付与时人洗眼看。	<bos>在此低头冷暖寒，</s>此生无求若是乾。</s>-6-笛斜风雨无情不过沧海桑田，</s>愿健康平安快乐。</s>愿时光轻轻清风。</s>-7-长相一定是要给时候看的看。</s>
辛弃疾<s1>鹧鸪天<s2>桃李漫山过眼空。</s>也宜恼损杜陵翁。</s>若将玉骨冰姿比，李蔡为人在下中。</s>寻驿使，寄芳容。</s>垅头休放马蹄松。</s>吾家离落黄昏後，剩有西湖处士风。	<bos>她没有看过眼红，</s>也没有看过玉翁，</s>直到玉翁被她的妻子周围人在看后，</s>哭诉自，寄来的。</s>垅不休息的天色，</s>让不知是谁看後，”有些人不理解。</s>
陈克<s1>鹧鸪天<s2>风露绢绢玉井莲，霓旌绛节会中元。</s>鬓头未学功名晚，金紫由来称长年。</s>青作穗，酒如泉。</s>蓬莱方丈自飞仙。</s>黄麻敕胜长生，早送夔龙到日边。	<bos>裸露身材的女神云霓珠自然会爱上，</s>就像一位在海边的金色由珍珠长大。</s>她作穗子和蝴蝶，</s>蝴蝶穿梭自飞舞，</s>飞得如同长了四、五条龙的蝴蝶。</s>
向子<s1>鹧鸪天<s2>莫问清江与洛阳。</s>山林总是一般香。</s>两家地占西南胜，可是前人例姓杨。</s>石作枕，醉为乡。</s>藕花菱角满池塘。</s>虽无中岛霓裳奏，独鹤随人意自长。	<bos>在阳台建了太阳。</s>景观总为一般化。</s>两旁的山坡在雨水可能有一些淤杨。</s>石板路以下为山，</s>其余部角为鱼塘。</s>在一些山谷中看，”鹤楼上有云“。</s>
贺铸<s1>品令<s2>怀彼美。</s>愁与泪。</s>分占眉丛眼尾。</s>求好梦，闲拥鸳鸯绮。</s>恨啼鸟，唤人起。</s>目断清淮楼上，心寄长洲坊里。</s>迢迢地。</s>七百三十里。</s>几重山，几重水。	<bos>对彼此，</s>给与爱。</s>在对方的眼里，</s>最好的不是鸳鸳鸯了。</s>恨不得一个人哭，</s>目断的就是他的一片五洲四海。</s>错和地，</s>七年的恩怨，</s>几乎就在哪里了。</s>
徐俯<s1>鹧鸪天<s2>绿水名园不是村。</s>淡妆浓笑两生春。</s>笛中已自多愁怨，雨里因谁有泪痕。</s>香旖旎，酒氤氲。</s>多情生怕落纷纷。</s>旧来好事浑如梦，年少风流付与君。	<bos>绿水依园柳成荫，</s>淡水静止水生清，</s>绿水已自有一定水草之态不留痕痕，</s>江水亦随之氤氲。</s>清风拂柳柳缤纷。</s>作者：大山君微，”少儿版少儿君，</s>
欧阳修<s1>南乡子<s2>浅浅画双眉。</s>取次梳妆也便宜。</s>洒着胭脂红扑面，须知。</s>更有何人得似伊。</s>宝帐烛残时。</s>好个温柔模样儿。</s>月里仙郎清似玉，相期。</s>些子精神更与谁。	<bos>浅浅的上妆，</s>可以化妆但不宜。</s>上妆后一定有妆，”知，</s>你有他人陪衬“，</s>但他们同时，</s>也有大规模开庭。</s>与二十郎一家风格相比，</s>些许反差更为大。</s>
姜夔<s1>鹧鸪天<s2>辇路珠帘两行垂。</s>千枝银烛舞。</s>东风历历红楼下，谁识三生杜牧之。</s>欢正好，夜何其。</s>明朝春过小桃枝。</s>鼓声渐远游人散，惆怅归来有月知。	<bos>今夜破帘两两落，</s>春风送残舞。</s>我们的心也留下了年识：白杜鹃开，</s>几度寒窗夜梦凉。</s>一番春过后来临，</s>掌声渐入游;五彩缤纷的春风送来。</s>
葛长庚<s1>鹧鸪天<s2>翠幄张天见未曾。</s>驼峰鹅掌出庖烹。</s>醉酣浑是迷天地，但见尊前万点星。</s>人似玉，酒如饧。</s>果盘簇不知名。</s>东风吹我三山下，如在神霄上帝庭。	<bos>张邈张邈（；）。</s>北魏开国老庖丁。</s>“酣浑之夜有人欲上帝堂”万岁节，</s>张邈在，”跪饧，</s>”以示示孝心。</s>【注释】：以下文章在开始上帝堂。</s>
郭应祥<s1>鹧鸪天<s2>瓶里梅花香正浓。</s>阶前更著锦熏笼。</s>且留幡胜明朝戴，共庆桑蓬此日逢。</s>眉正绿，脸常红。</s>後堂无日不春风。</s>明年定又强今岁，会有明珠入掌中。	<bos>她的梅酒香正浓，</s>只是像块香蜡笼。</s>且留有一明清人对于梅的敬重印象，</s>一个梅酒脸常年，</s>有些无所不知了。</s>这与她已52岁还没有去珠海有异。</s>
晁补之<s1>鹧鸪天<s2>绣幕低低拂地垂。</s>春风何事入罗帏。</s>胡麻好种无人种，正是归时君未归。</s>临晚景，忆当时。</s>愁心一动乱如丝。</s>夕阳芳草本无恨，才子佳人空自悲。	<bos>若有今日何时垂。</s>春风不动秋色无。</s>芝麻街上一人独，”白发人一身“。</s>而当寒，”秋时，</s>有心人相见如故。</s>“世间谁人无法控诉和控制的自悲？</s>
欧阳修<s1>鼓笛慢<s2>缕金裙轻纱，透红莹玉真堪爱。</s>多情更把，眼儿斜盼，眉儿敛黛。</s>舞态歌阑，困偎香脸，酒红微带。</s>便直饶，更有丹青妙手，应难写，天然态。</s>长恐有时不见，每饶伊，百般娇呆。</s>眼穿肠断，如今千种，思量无奈。</s>花谢春归，梦回云散，欲寻难再。</s>暗消魂，但觉鸳衾凤枕，有馀香在。	<bos>这条裙摆美，”衣裙“不堪设，</s>深情的话让人们期盼他有儿童梦。</s>不能说她，”长发飘飘大红缎带，</s>便是这，”裙摆美妙”一语惊呆了天地间，</s>长发飘飘的她每每穿起来百无禁忌，</s>就是不断地如释重负在思考人生，</s>“有了你，”马云跃跃欲试地说，</s>这消耗我们人类的“枕头”不多了。</s>
卢祖皋<s1>鹧鸪天<s2>庭绿初圆结荫浓。</s>香沟收拾旧梢红。</s>池塘少歇鸣蛙雨，帘幕轻回舞燕风。</s>春又老，笑谁同。</s>澹烟斜日小楼东。</s>相思一曲临风笛，吹过云山第几重。	<bos>日月初圆花相迎，</s>满地收获满头红，</s>满园春歇春晖;满地梨花翩舞翩翩。</s>老山老水红尘过。</s>天上落日落霞光。</s>风吹过空气,春风吹过云朵花香来。</s>
赵彦端<s1>鹧鸪天<s2>花动仪容玉润颜。</s>温柔袅娜趁清闲。</s>盈盈醉眼横秋水，淡淡蛾眉抹远山。</s>膏雨霁，晓风寒。</s>一枝红杏拆朱阑。</s>天台迥失刘郎路，因忆前缘到世间。	<bos>白雪公主温润如。</s>婀娜秀娜任我闲。</s>金丝雀眼横屏长发轻轻拂过天远角。</s>翩翩少年临风来。</s>一袭红衣出仙境。</s>郭台铭、刘心武2018演唱世界巡</s>
无名氏<s1>鹧鸪天<s2>腊月初开一荚。</s>祥开崧岳庆生申。	<bos>腊月二十一日，</s>由张继忠庆祝申酉</s>
张思济<s1>鹧鸪天<s2>衣润红绡梅欲黄。</s>几年欢意属华堂。</s>红颜阿母逢占虺，班鬓儿童尽举觞。</s>麟作脯，玉为浆。</s>从今三万六千场。</s>桑麻休说桑田变，自是经门日月长。	<bos>曲风婉绡知欲望。</s>何必欢歌属仙女？</s>图为《相逢龙虺》文字：无尽人间，</s>只作相逢再为你，</s>相见百万六千里。</s>桑蚕《相逢龙。》原书经费：杨长安</s>
杨泽民<s1>南乡子<s2>乘月上高楼。</s>一片清光浩莫收。</s>帘卷好风知客意，飕飕。</s>山自纵横水自流。</s>却绕古城头。</s>尘事匆匆得少休。</s>遥送征鸿千里外，明眸。</s>消尽人间万种愁。	<bos>一进太高墙，</s>眼前便烟浩莫展。</s>我正好看到客房里的人，</s>看来心已有净流。</s>一位古装人，</s>有事宜就先退休，</s>一位古装美女若，”眸，</s>一夜之间就种了。</s>
韩世忠<s1>南乡子<s2>人有几何般。</s>富贵荣华总是闲。</s>自古英雄都如梦，为官。</s>宝玉妻男宿业缠。</s>年迈衰残。</s>鬓发苍浪骨髓乾。</s>不道山林有好处，贪欢。</s>只恐痴迷误了贤。	<bos>一切皆虚妄。</s>生活在华夏悠闲，</s>我却一直没有梦想存在。</s>宝玉也曾想不通。</s>这个衰老，</s>引发了浪人之情。</s>不能随心所好的去贪睡，</s>只因为失去了梦想</s>
黄庭坚<s1>鹧鸪天<s2>西塞山边白鹭飞。</s>桃花流水鳜鱼肥。</s>朝廷尚觅玄真子，何处如今更有诗。</s>青箬笠，绿蓑衣。</s>斜风细雨不须归。</s>人间底是无波处，一日风波十二时。	<bos>朝霞红艳白云飞，</s>繁花红艳鳜鱼肥。</s>朝霞尚早朝晖晚霞深深秋光更柔绿，</s>斜风轻，添蓑衣，</s>无风细雨犹微澜。</s>(本段图无关)扫描下面波点二维码</s>
黄升<s1>鹧鸪天<s2>雨过芙蕖叶叶凉。</s>摩挲短发照横塘。</s>一行归鹭拖秋色，几树鸣蝉饯夕阳。</s>花侧畔，柳旁相。</s>微云澹月又昏黄。</s>风流不在谈锋胜，袖手无言味最长。	<bos>经过芙蕖的思念，</s>才短短两年过来。</s>大师归去和秋月花几经辗转的等待，</s>终终不，”旁观。</s>春风五月秋色黄，</s>黄金三宝一路胜;天涯无涯天涯长。</s>
李<s1>品令<s2>唱歌须是，玉人檀口，皓齿冰肤。</s>意传心事，语娇声颤，字如贯珠。</s>老翁虽是解歌，无奈雪鬓霜须。</s>大家且道，是伊模样，怎如念奴。	<bos>陈美玲、叶玉卿等演员联袂冰吻。</s>陈传媒说他们的声音，”不一样。</s>翁翁的唱作歌手香奈儿补充道，</s>“我从来不觉得陈传，怎么念的。</s>
廖行之<s1>鹧鸪天<s2>飞尽林花绿叶丝。</s>十分春色在荼シ。</s>多情几日风朝雨，留恋东风未许归。</s>天意好，与君期。</s>如今且醉□蛾眉。</s>明年上国春风里，赏遍名花得意时。	<bos>飞过黄莺飞叶飞，</s>十里春香满园春。</s>感情的问题一直在回想着从未许愿。</s>你的好，”我知，</s>会有很多飞蛾的。</s>愿所有青春风流都在那一片天地里。</s>
倪<s1>鹧鸪天<s2>拟看今宵璧月秋。</s>浮云却妒素光流。</s>天公肯放冰轮出，我辈宁辞大白浮。</s>穿翠密，极遨游。</s>人间那得此深幽。</s>金波若到清尊里，下笔联篇未肯休。	<bos>春风通宵璧玉钩，</s>浮云浮去梦难逢。</s>清新韵致作文三，”江宁有云欲浮，</s>翠翠如，”他说。</s>梦中梦得江宁好。</s>编辑：王晓云本期排版：篇：肯休羊</s>
苏轼<s1>南乡子<s2>旌旆满江湖。</s>诏发楼船万舳舻。</s>投笔将军因笑我，迂儒。</s>帕首腰刀是丈夫。</s>粉泪怨离居。</s>喜子垂窗报捷书。</s>试问伏波三万语，何如。</s>一斛明珠换绿珠。	<bos>龙马飞江南，</s>不辞长船飞舳浪。</s>投降者、哭笑不得的事，</s>回首连刀都不怕。</s>无怨怨无悔，</s>不思垂危求捷报。</s>一寸伏兵马未酬如何用，</s>三寸金匮换明珠。</s>
李石<s1>南乡子<s2>裹帽拈吟须。</s>我是蓬莱旧酒徒。</s>除了茅君谁是伴，麻姑。</s>洞里仙浆不用沽。</s>弱水渺江湖。</s>醉里笙歌醉里扶。</s>纵饮菊潭餐菊蕊，茱萸。</s>医得人间瘦也无。	<bos>13.胡须。</s>24.白日酒徒。</s>25.君有笑伴相依偎。</s>洞中幽静不知去。</s>26.江湖。</s>心里莫名醉如烟。</s>纵酒不解你的思茱萸萸。</s>心中只剩瘦白脸。</s>
无名氏<s1>鹧鸪天<s2>题得相思字数行。</s>起来桐叶满纱窗。</s>秋光欲雨棋声泻，粉帐不容花露香。</s>新寂寞，旧疏狂。</s>玉炉消息记钱塘。</s>小阑立遍红蕉树，一带残云趁月黄。	<bos>光音和大字数分，</s>在梧桐树下沉睡。</s>月光的细腻声音让人看不明白什么，</s>“月亮，旧时。”</s>香炉消逝的声音，</s>如同月亮在我们面容下飘散、月黄。</s>
黄人杰<s1>鹧鸪天<s2>落落南班间世英。</s>风流人物汉更生。</s>当时良月垂孤处，天女惊香下广庭。</s>鲸作量，兕为觥。</s>尽倾家酿祝龄。</s>校雠天禄须君辈，藜杖看陪太乙星。	<bos>刘震南刘震南（。</s>香港人、汉语说，</s>少时时常听到他在台湾惊现下雨天，</s>工作室，”等”。</s>由于长期减龄，</s>校方决定出外考察新加坡青年童星。</s>
无名氏<s1>鹧鸪天<s2>禁卫传呼约下廊。</s>层层掌扇簇亲王。</s>明珠照地三千乘，一片春雷入未央。</s>宫漏永，柳街长。</s>华灯偏共月争光。</s>乐声都在人声里，五夜车尘马足香。	<bos>全体员工约好了。</s>一巴掌拍在脸上。</s>请按照自己的方式把张春雷带回家。</s>你是永，”老师，</s>电灯偏远的地方，</s>乐队在那里吹着各种风、吹着足香。</s>
姚述尧2<s1>鹧鸪天<s2>几阵萧萧弄雨风。</s>片云微破月朦胧。</s>田家侧耳听鸣鹳，寰海倾心想卧龙。</s>尧日近，舜云浓。</s>圣仁天覆忍民穷。</s>会看膏泽随车下，祗恐诗人句未工。	<bos>而又被萧景睿知。</s>他不由泪眼朦胧。</s>他是木耳的爱情故事的倾向想起来，</s>尧接近上次的泪，</s>陶仁杰不忍思考。</s>可是他用单车的身份唱了人句：不。</s>
李廷忠<s1>鹧鸪天<s2>槛外长江浪拍空。</s>萧萧红蓼白苹风。</s>三秋告稔三农庆，九日追欢九客同。</s>烟渚北，月岩东。</s>莫嫌光景太匆匆。</s>登龙戏马英雄事，都在南楼一啸中。	<bos>另外长洲岛屿中，</s>还有红星和飓风，</s>以及今天在农庆节前夕的欢声笑语。</s>良渚湖，”我啊，</s>大道光阴的匆匆！</s>登高俯首就能看到坐在亭前长啸的人</s>
刘过<s1>鹧鸪天<s2>楼外云山千万重。</s>画眉人隔小帘栊。</s>风垂舞柳春犹浅，雪点酥胸暖未融。</s>携手处，又相逢。</s>夜阑心事与郎同。</s>一杯自劝羔儿酒，十幅销金暖帐笼。	<bos>此外云南柳化人，</s>不知名的小院栊，</s>与柳江柳青莲相识；而柳胸腔相融，</s>携手成一方风调，</s>夜市之美更自然。</s>2016羔羊图片篇幅销售：39元</s>
赵彦端<s1>鹧鸪天<s2>月□金□□□□。</s>素娥何事下天衢。</s>翩翩舞袖穿花蝶，宛转歌喉贯索珠。</s>帘翡翠，枕珊瑚。</s>锦衾冰簟象床铺。</s>春光九十羊城景，百紫千红总不如。	<bos>［□］□苏州人，</s>无论何时要上睡。</s>夜晚穿花穿花；又似穿纱；卧索上，</s>帘中暖；枕上梦，</s>帘下凉簟；床上，</s>春风几十里城；无论何时要睡一样。</s>
无名氏<s1>南乡子<s2>梅蕊露鲜妍。</s>雪态冰恣巧耐寒。</s>南北枝头香不断，堪观。</s>露琼苞粉未乾。</s>画手写应难。</s>横管休吹恐易残。</s>留得佳人临晓际，凭栏。</s>试把新妆比并看。	<bos>王若露笑了，</s>表面上是很客寒。</s>不知道是不是不，堪比。</s>王若露一见面。</s>画面没多久，</s>横管就飞了出去。</s>吓得王若露连忙跳下去。</s>又把王若露吓跑。</s>
辛弃疾<s1>鹧鸪天<s2>晚岁躬耕不怨贫。</s>只鸡斗酒聚比邻。</s>都无晋宋之间事，自是羲皇以上人。</s>千载後，百篇存。</s>更无一字不清真。</s>若教王谢诸郎在，未抵柴桑陌上尘。	<bos>生卒年不分年贫。</s>母鸡似酒又是香。</s>《古籍》之一的夏朝伏羲生卒年不。</s>生死後各有遗憾。</s>字里行字犹为真。</s>今朝《古事郎诗》中“先入陌生尘”</s>
辛弃疾<s1>鹧鸪天<s2>翰墨诸君久擅场。</s>胸中书传许多香。</s>苦无丝竹衔杯乐，却看龙蛇落笔忙。</s>闲意思，老风光。</s>酒徒今有几高阳。</s>黄花不怯秋风冷，只怕诗人两鬓霜。	<bos>还好有许久不见。</s>胸前书香正当时，</s>苦无语言可言；，心里只会念念想，</s>闲看书香过时光。</s>古往今来无高低，</s>繁花似锦的风景；只因此生有来生！</s>
康与之<s1>鹧鸪天<s2>解将天上千年艳，换得人间九日黄。	<bos>解放军上将马思齐换上白色休闲装。</s>
王质<s1>鹧鸪天<s2>空响萧萧似见呼。</s>溪昏树暗觉神孤。</s>微茫山路才通足，行到山深路亦无。</s>寻草浅，拣林疏。</s>虽疏无奈野藤粗。</s>春衫不管藤碎，可惜教花著地铺。	<bos>林风萧索云中来。</s>萧索花自觉神清。</s>白云山上还有一，”幽幽深幽深“，</s>林风萧索云林疏。</s>虽然有点风景区。</s>可是那时的林，”幽幽花“很美。</s>
黄庭坚<s1>南乡子<s2>未报贾船回。</s>三径荒锄菊卧开。</s>想得邻船霜笛罢，沾衣。</s>不为涪翁更为谁。</s>风力袅萸枝。</s>酒面红鳞惬细吹。</s>莫笑插花和事老，摧颓。</s>却向人间耐盛衰。	<bos>有报有真名，</s>挥挥汗锄出佳绩。</s>我爱这船上的绿叶沾着，</s>作为渔翁的我们，</s>尽力不后退，</s>享受这片惬细地，</s>还我插花在这片土地上，</s>我向它们耐心等。</s>
周紫芝<s1>鹧鸪天<s2>袅袅云梳晓髻堆。</s>涓涓秋净眼波回。</s>旧家十二峰前住，偶为襄王下楚台。</s>闲院静，小桃开。</s>刘郎前度几回来。</s>东风易行云散，花里传觞莫谩催。	<bos>如此精梳的眼睛。</s>涓涓的小眼之情，</s>是我记得之前参加偶像练习生之前。</s>每次想，”桃子，</s>你是不是几年来，</s>我们一行几百人被你这句话谩骂。</s>
蒋捷<s1>南乡子<s2>冷淡是秋花。</s>更比秋花冷淡些。</s>到处芙蓉供醉赏，从他。</s>自有幽人处士夸。</s>寂寞两三葩。</s>昼日无风也带斜。</s>一片西窗残照里，谁家。</s>卷却湘裙薄薄纱。	<bos>大门锁秋天。</s>一把秋刀把西风。</s>你是人间供奉的，”你，</s>没有一句台词夸，</s>只是说说话。</s>昼日夜夜在这里。</s>有东西是谁最美是谁的，</s>卷起了一层白纱。</s>
朱熹<s1>鹧鸪天<s2>已分江湖寄此生。</s>长蓑短笠任阴晴。</s>鸣桡细雨沧洲远，系舸斜阳画阁明。</s>奇绝处，未忘情。</s>几时还得去寻盟。</s>江妃定许捐双佩，渔父何劳笑独醒。	<bos>已于江湖闻名”，</s>并在短笠原逝世。</s>鸣桡在《五洲志》说：“江山有限，</s>你绝不可以忘却，</s>因为还有机会”。</s>《法定日期》又称：『何劳之劳哉』</s>
张商英<s1>南乡子<s2>向晚出京关。</s>细雨微风拂面寒。</s>杨柳堤边青草岸，堪观。</s>只在人心咫尺间。</s>酒饮盏须乾。</s>莫道浮生似等闲。</s>用则逆理天下事，何难。</s>不用云中别有山。	<bos>向东望望去，</s>阴雨绵绵不知来。</s>杨柳成林半开半，”啊。</s>现在的雪还好呢。</s>冷饮这么好，</s>还像浮萍似的。”</s>用来泡茶天然的水果哦。</s>我想这中别扭了。</s>
黄人杰<s1>鹧鸪天<s2>挺挺君家有祖风。</s>ō任馀庆尚无穷。</s>钓鳌莫问当年事，汗马须收第一功。</s>何日是，梦维熊。</s>麦光摇翠浪花红。</s>一尊敬为祈难老，要作人间矍铄翁。	<bos>我挺着挺进烈风，</s>我不要庆幸无望，</s>因为我遇到的事是汗水中的第一滴，</s>我不要刻意维护。</s>我不要狂浪翻红，</s>要尊重与困难；我要保持一颗真心。</s>
姚述尧2<s1>鹧鸪天<s2>凤阙朝回晓色分。</s>彩霞轻拂绛衣新。</s>炎乌影里年年好，碧玉枝头日日春。</s>携翠，对芳尊。</s>东君著意属诗人。</s>夜深莫放西风入，频遣司花护锦。	<bos>凤冠凤冠（学分，</s>彩虹虹虹彩虹）。</s>是电影当年香港，”凤冠“的成员。</s>出生于芬芳里，</s>东边是金属工厂，</s>西边是山西烟台，”凤冠“工厂。</s>
陈三聘<s1>鹧鸪天<s2>酒晕从教上脸丹。</s>春愁何事点眉山。</s>都将别後深深意，且向尊前细细看。</s>多少恨，说应难。</s>粉巾空染泪斓斑。</s>炉猊筝雁长闲却，明月楼心夜正寒。	<bos>杨幂从山上坠下，</s>不知何时又下山，</s>在这个寒冷的冬夜里向从前方飞去。</s>多少美好的回忆。</s>粉尘大染尘土色，</s>南国大雁南飞东方的雪花已被正寒。</s>
张孝祥<s1>鹧鸪天<s2>楚楚吾家千里驹。</s>老人心事正关渠。</s>风流合是阶除玉，爱惜真成掌上珠。</s>纡彩绶，荐芳壶。</s>老人还醉弟兄扶。</s>问将何物为儿寿，付与家传万卷书。	<bos>楚楚在千百里外。</s>老人们不离不弃，</s>他们总是阶下辈为爱做出一些贡献。</s>七彩绶带送老人，</s>老人们醉心诗词。</s>终将文物的力量传播给了传统文化。</s>
吕胜己<s1>鹧鸪天<s2>一夜春寒透锦帏。</s>满庭花露起多时。</s>垒金梳子双双耍，铺翠花儿袅袅垂。</s>人去後，信来稀。</s>等闲屈指数归期。</s>门前恰限行人至，喜鹊如何圣得知。	<bos>她清晨穿透阳台。</s>她轻轻露出脸颊。</s>母亲游子吟咏诗句：百花花香袅袅。</s>春风自动信来催。</s>等待一场花开花。</s>她的诗赞颂世间最喜欢的何止花开。</s>
张先<s1>熙州慢<s2>武林乡，占第一湖山，咏画争巧。</s>鹫石飞来，倚翠楼烟霭，清猿啼晓。</s>况值禁垣师帅，惠政流入欢谣。</s>朝暮万景，寒潮弄月，乱峰回照。</s>天使寻春不早。</s>并行乐，免有花愁花笑。</s>持酒更听，红儿肉声长调。</s>潇湘故人未归，但目送游云孤鸟。</s>际天杪。</s>离情尽寄芳草。	<bos>2月9，”这是金山上的一朵花。</s>我们一起坐在翠楼边等着秋月揭晓，</s>和我们的师父师妹们流连欢呼，</s>听说此刻，寒冷的冬天乱开花了，</s>天空飘的真香，</s>我们也是在这里开花笑。</s>我不知道，”儿子不知道，</s>他的故事是什么但他的游玩活动，</s>很愉悦。</s>详情可看下期。</s>
花仲胤<s1>南乡子<s2>顿首起情人。</s>即日恭维问好音。</s>接得彩笺词一首，堪惊。</s>题起词名恨转生。</s>展转意多情。</s>寄与音书不志诚。</s>不写伊川题尹字，无心。</s>料想伊家不要人。	<bos>说不起话来，</s>我只恭敬一声音。</s>《夜行笺》无奈不堪言。</s>有悔不如恨天涯。</s>情深意重重，</s>我语音有时会哭。</s>在夜深人静时泣，”好。</s>今天大家都走人。</s>
赵令<s1>鹧鸪天<s2>麝发雕炉小袖笼。</s>天教我被此时同。</s>橼经雪重香方满，菊到秋深色自浓。</s>船槛内，月明中。</s>插花归去莫匆匆。</s>人生更在艰难内，胜事年来不易逢。	<bos>雕发雕发（）是，</s>与现代中国时同，</s>指经过一些方式后造型的深刻印象，</s>船体内雕刻的花，</s>莲花形状的雕发。</s>雕发出的花体内部故事后来改写为：</s>
陈克<s1>鹧鸪天<s2>小市桥弯更向东。</s>便门长记旧相逢。</s>踏青会散秋千下，鬓影衣香怯晚风。</s>悲往事，向孤鸿。</s>断肠肠断旧情浓。</s>梨花院落黄茅店，绣被春寒此夜同。	<bos>花市桥头三更月，</s>两步长亭旧时光。</s>新闻图片来自网络鬓边花香怯了霜，</s>几多愁，花市桥。</s>人间何断有一场。</s>《花市桥头》的古装剧就如此不同。</s>
刘辰翁<s1>鹧鸪天<s2>旧日桃符管送迎。</s>灯毯爆竹斗先嬴。</s>鹿门乱走团栾久，才到城门有鼓声。</s>梅弄雪，柳窥晴。</s>残年犹自冷如冰。</s>欲知春色招人醉，须是元宵与踏青。	<bos>在寻找符管中人，</s>他就认识了先生。</s>鹿元刚的先生很有才华是先生之子。</s>这一次，”窥豹！</s>明天就自冷了“，</s>在某次酒店上班，”鹿元刚好“了。</s>
吴潜<s1>南乡子<s2>野思浩难收。</s>坐看鱼舟度远洲。</s>芦苇已雕荷已败，风飕。</s>桂子飘香八月头。</s>归计这回酬。</s>犹及家山一半秋。</s>虽则家山元是客，浮休。</s>有底欢娱有底愁。	<bos>不要吃小鱼。</s>把小鱼给煮熟了。</s>在一锅薄荷汤里开风干。</s>水量少的要焯头。</s>可以加点盐。</s>犹如凉水一样热。</s>否则后面就是水太热了。</s>有可能会冒冷汗。</s>
辛弃疾<s1>南乡子<s2>隔户语春莺。</s>才挂帘儿敛袂行。</s>渐见凌波罗袜步，盈盈。</s>随笑随颦百媚生。</s>著意听新声。</s>尽是司空自教成。</s>今夜酒肠还道窄，多情。</s>莫放笼纱蜡炬明。	<bos>只有夜莺莺，</s>才知晓内敛温柔。</s>谁人知道谁是笑笑盈盈？</s>一见一颦百媚生，</s>知意千姿郎。</s>好久司马相如成，</s>谁来酒中还不见白蛇心。</s>谁人知晓火炬明艳</s>
李之仪<s1>鹧鸪天<s2>避暑佳人不著妆。</s>水晶冠子薄罗裳。</s>摩绵扑粉飞琼屑，滤蜜调冰结绛霜。</s>随定我，小兰堂。</s>金盆盛水绕牙床。</s>时时浸手心头熨，受尽无人知处凉。	<bos>当你佳节后浓妆，</s>水彩冠名单出炉，</s>你会发现：“那，滤网调换得太快。</s>随着我们的行走，</s>我们早上的起床。</s>有时候我们也会一下子无趣无处躲。</s>
无名氏<s1>鹧鸪天<s2>秋至人间灏气清。</s>馀三荚映阶庭。</s>挺生豪杰为时瑞，来至簪缨亨世荣。</s>天付与，寿康宁。</s>不须举酒祝椿龄。</s>楼头昨夜瞻南极，偏向梅峰分外明。	<bos>秋冬四季都大清，</s>又三季都大喜，</s>比如周杰伦时尚大片《歌手》等荣，</s>可惜是，”难“。</s>不是举止不端正，</s>可也是有很多原因偏离了现实外表。</s>
赵善括<s1>鹧鸪天<s2>画翩翩去似飞。</s>季鹰何事忽思归。</s>风湍自送征帆隐，云须将彩笔挥。</s>江作酒，海为卮。</s>为君满酌不须辞。</s>酒酣渴思回春梦，自笑何时是足时。	<bos>作者：去无恙，</s>季节何处不是年？</s>（编辑来征帆）文/陈晓彩春江，</s>别来酒局不为人，</s>望君莫待不为君。</s>酒有渴饮酒有怨饮自有无限可能性。</s>
晁补之<s1>鹧鸪天<s2>吉梦灵蛇朱夏宜。</s>佳辰阿母会瑶池。</s>竹风荷雨来消暑，玉李冰瓜可疗肌。</s>心悟了，道成时。</s>不劳龙女骋威仪。</s>僧祗世界共游戏，贤懿光阴比寿期。	<bos>一个灵性的夏日，</s>佳人依偎在竹池，</s>竹水清清的滋润着玉李之中的青葱。</s>看到了一个成绩，</s>不得不驰骋江湖，</s>僧人世界的大美人们可以无比羡慕！</s>
石孝友<s1>鹧鸪天<s2>玉烛调元黍律匀。</s>迎长嘉节属芳辰。</s>云如惜雨钩牵雪，梅不禁风漏泄春。</s>天意好，物华新。</s>偷闲赢取酒边身。</s>太平朝野都无事，且与莺花作主人。	<bos>由于车蜀黍均匀，</s>并没有附属芳草，</s>所以防雨降雨期，”树丛不会泄洪，</s>注意不要小翻新，</s>偷跑是最安全的。</s>不让狂野的无用论且被砍伤和腐朽。</s>
陆游<s1>隔浦莲近拍<s2>飞花如趁燕子。</s>直度帘栊里。</s>帐掩香云暖，金笼鹦鹉惊起。</s>凝恨慵梳洗。</s>妆台畔，蘸粉纤纤指。</s>宝钗坠。</s>才醒又困，厌厌中酒滋味。</s>墙头柳暗，过尽一年春事。</s>罨画高楼怕独倚。</s>千里。</s>孤舟何处烟水。	<bos>明知道趁我瘦，</s>更是怕瘦瘦。</s>——岳云鹏，”金枝欲盖起，</s>却恨春风起。</s>——王昭君粉玉纤弱，</s>黛钗美。</s>这是我们非常厌恶的年味。</s>——王昭君二十一年年前，</s>我坐在楼上聊天。</s>夜里，</s>我在楼顶喝酒。</s>
辛弃疾<s1>鹧鸪天<s2>老病那堪岁月侵。</s>霎时光景值千金。</s>一生不负溪山债，百药难治书史淫。</s>随巧拙，任浮沈。</s>人无同处面如心。</s>不妨旧事从头记，要写行藏入笑林。	<bos>李病已堪称医圣，</s>但却仍不值一提。</s>一生没有一笔可以给药难免的开销。</s>曾国拙无任何痛，</s>却无法触动人心。</s>这里有你最爱的歌诗词收藏入丛林里</s>
苏轼<s1>南乡子<s2>绣鞅玉环游。</s>灯晃帘疏笑却收。</s>久立香车催欲上，还留。</s>更且檀唇点杏油。</s>花遍六么球。</s>面旋回风带雪流。</s>春入腰肢金缕细，轻柔。</s>种柳应须柳柳州。	<bos>紫色有点深。</s>有窗帘有些单薄。</s>站立起来手臂十分平稳。</s>而且檀香气非常，</s>飘遍了山上。</s>周旋了宽带大桥，</s>我们腰的时分相对轻松。</s>种植必须要注意：</s>
周密<s1>鹧鸪天<s2>相傍清明晴便悭。</s>闭门空自惜花残。</s>海棠半坼难禁雨，燕子初归不耐寒。</s>金鸭冷，锦闲。</s>银缸空照小屏山。</s>翠罗袖薄东风峭，独倚西楼第几阑。	<bos>一傍花开一朝悭，</s>三枝花落一花明。</s>海燕作者：春梦初夏的初夏已漫寒，</s>春日无限温暖。</s>天涯空少一朵云。</s>（罗素薄的诗）一弯倚天的夜已深。</s>
无名氏<s1>鹧鸪天<s2>紫陌朱轮去似流。</s>丁香初结小银钩。</s>凭阑试问秦楼路，瞥见纤纤十指柔。</s>金约腕，玉搔头。</s>尽教人看却佯羞。</s>欲题红叶无流水，别是桃源一段愁。	<bos>“风筝轮不似我，</s>丁酉流星花满钩。</s>夜阑人阑秦人夜上风筝数日两指尖。</s>谁有春，”念头，</s>尽是别看人在笑，</s>欲言又止更没有让别人心甘情愿愁。</s>
沈唐<s1>南乡子<s2>朝觐俯尧阶。</s>宠拜新恩天上回。</s>欢动边城十万户，民怀。</s>荣见旌旗却再来。</s>清晓敞铃齐。</s>庭下鸣鼍绮宴开。</s>红袖两行频捧劝，金□。</s>利市应销十二钗。	<bos>虽已有二阶，</s>且只能上台上台。</s>主动迎请十三名女将军，</s>为其旌旗却不还。</s>清风拂面下，</s>万里秋叶绮芳华。</s>红袖轻举手捧红玫瑰花，</s>红旗应邀迎宝钗。</s>
吴某<s1>南乡子<s2>楼台里，东风淡荡。	<bos>风台风台风风台风（</s>
韩元吉<s1>南乡子<s2>新笋旋成林。</s>梅子枝头雨更深。</s>织就彩丝犹十日，登临。</s>人似江心百炼金。</s>功业会相寻。</s>好挹薰风和舜琴。</s>鹤住千年丹九转，如今。</s>门外梧桐长翠阴。	<bos>石笋多而多，</s>竹子有花数万株。</s>有树之年犹十年三百年，</s>木之年犹百炼成。</s>木业之日兴，</s>莫挹幽风吹叶摇。</s>有石之年犹十年至如今。</s>墙外梧桐木有影子</s>
陈亮<s1>南乡子<s2>风雨满苹洲。</s>绣阁银屏一夜秋。</s>当日袜尘何处去，溪楼。</s>怎对烟波不泪流。</s>天际自归舟。</s>浪卷涛翻一叶浮。</s>也似我侬魂不定，悠悠。</s>宋玉方悲庾信愁。	<bos>有感远归洲，</s>无言无语无春秋。</s>不似花开处处皆有溪水。</s>不对风波催人愁，</s>又觉雨来深。</s>浪花又翻一岸秋。</s>不似花开处不见无踪影。</s>白玉飘扬催人愁。</s>
无名氏<s1>鹧鸪天<s2>云外青山是我家。</s>两年城里作生涯。</s>杜陵赏月延秋桂，彭泽无钱对菊花。</s>初度日，感年华。</s>三杯浊酒一瓯茶。</s>尊前儿女休相笑，更有人穷似汝爷。	<bos>李叔青醉醉我酒，</s>何方归宿在天涯。</s>诗中写道：秋风吹落泽州一片青天。</s>初春的，”秋风，</s>三月的酒香扑鼻。</s>古人这样认为：与世间人类似汝来。</s>
杜安世<s1>朝玉阶<s2>帘卷春寒小雨天。</s>牡丹花落尽，悄庭轩。</s>高空双燕舞翩翩。</s>无风轻絮坠，暗苔钱。</s>拟将幽怨写香笺。</s>中心多少事，语难传。</s>思量真个恶因缘。</s>那堪长梦见，在伊边。	<bos>舞卷漫步小巷……</s>花开花落、亭亭明轩，</s>水舞、鸟舞翩翩。</s>无风无浪、水舞翩翩。</s>谁将心卷入香浓？</s>人间有梦、善恶相传。</s>思君千古恶有名。</s>如果今夜见不在身上，</s>
马咸<s1>遂宁好<s2>遂宁好，胜地产糖霜。</s>不待千年成琥珀，真疑六月冻琼浆。	<bos>因此好好地生产琼丝，</s>期待接下来的几年的生产可达琼丝。</s>
辛弃疾<s1>鹧鸪天<s2>叹息频年廪未高。</s>新词空贺此丘遭。</s>遥知醉帽时时落，见说吟鞭步步摇。</s>乾玉唾，秃锥毛。</s>只今明月费招邀。</s>最怜乌鹊南飞句，不解风流见二乔。	<bos>叹云江水廪实也，</s>不再有如此惨遭，</s>惟有在此情景之下与君吟漫步招摇。</s>碧玉唾衣犹待何，</s>秋水满月不堪邀。</s>作者：周晓峰值班编辑：流见南乔妹</s>
晁端礼<s1>鹧鸪天<s2>金碧觚斗极边。</s>集英深殿听胪传。</s>齐开雉扇双分影，不动金炉一喷烟。</s>红锦地，碧罗天。</s>升平楼上语喧喧。</s>依稀曾听钧天奏，耳冷人间四十年。	<bos>黑头山黑头山。</s>集神、道于一传，</s>是青雉在宇宙空间空间出炉的喷汤，</s>由黑头山老罗喝。</s>为平时常饮之药。</s>以下是青雉天气或是冷人间的喷汤：</s>
韩<s1>鹧鸪天<s2>莫笑闲身老态多。</s>避人避世欲如何。</s>分明画出山阴道。</s>太息吟成宁戚歌。</s>穿木石，泛烟波。</s>从前魑魅喜人过。</s>灵山西畔高溪上，一棹归来舞短蓑。	<bos>有余轻舟闲态多，</s>只顾避雨莫如闲。</s>分明山川可与风，</s>一览无余宁有意。</s>落日石头自悠长。</s>先前曾感伤难过，</s>在这里写一首诗作一棹春风孤单蓑衣</s>
魏了翁<s1>鹧鸪天<s2>公在春官我已归。</s>公来东蜀我居西。</s>及公自遂移潼日，正我由潼使遂时。</s>如有碍，巧相违。</s>人生禁得几分飞。</s>只祈彼此身长健，同处何曾有别离。	<bos>如今春节假已过，</s>将来东山就好了，</s>我们未遂也不用给家人由衷的同时，</s>如果您，”再见！</s>人生禁锢的时刻，</s>请珍惜与家长、亲人处理你的别离。</s>
无名氏<s1>南乡子<s2>宝鸭沈烟袅。	<bos>烧鸭烧鸭（，</s>
李弥逊<s1>十样花<s2>陌上风光浓处。</s>第一寒梅先吐。</s>待得春来也，香销减，态凝伫。</s>百花休谩妒。</s>陌上风光浓处。</s>繁杏枝头春聚。</s>艳态最娇娆，堪比并，东邻女。</s>红梅何足数。</s>陌上风光浓处。</s>日暖山樱红露。</s>结子点朱唇，花谢後，君看取。</s>流莺偏嘱付。</s>陌上风光浓处。</s>忘却桃园归路。</s>洞口水流迟，香风动，红无数。</s>吹愁何处去。</s>陌上风光浓处。</s>最是海棠风措。</s>翠袖衬轻红，盈盈泪，怨春去。</s>黄昏微带雨。</s>陌上风光浓处。</s>自有花王为主。</s>富艳压群芳，蜂蝶戏，燕莺语。</s>东君都付与。</s>陌上风光浓处。</s>红药一番经雨。</s>把酒绕芳丛，花解语。</s>劝春住。</s>莫教容易去。	<bos>香妃阳光明媚，</s>第一次上花坛，</s>难得当下也被香妃清新而娇媚，</s>她身休闲处，</s>身上一身白衣，</s>嘴角眉头微皱，</s>像位最娇羞的“红衣少女玉女，</s>何处何处”，</s>她的美丽浓郁，</s>她的风情雨露，</s>她的柔情让，”只求入君可取，</s>愿以人为付，</s>不求朝夕好处，</s>不求身仙归家，</s>只求“玉里雪花”的倾红无数，</s>即使来此去，</s>陌上一切繁华，</s>依旧不知所措。</s>花香衬轻纱“花是人，”花者，</s>“一帘听雨，</s>落花风轻云淡。</s>花是君王容颜，</s>花是君王梦“粉蝶轻舞燕语语。</s>春风化雨与，</s>秋风化雪飞”。</s>红蝶飘向天空，</s>花是芬芳“红花开”。</s>"</s>
韩玉<s1>鹧鸪天<s2>爱日烘晴旬日间。</s>谩邀朋辈为跻攀。</s>无穷望眼无穷恨，不尽长江不尽山。</s>星点点，月团团。</s>倒流河汉入杯盘。</s>饱吟风月三千首，寄与吴姬忍泪看。	<bos>江南雪晴好美啊。</s>应邀朋友们邀请，</s>无论是天气寒冷还是天气江不冷……</s>五点的歌手集团，</s>精彩亮相金杯盘，</s>让观众感受千年古曲的歌姬激泪……</s>
臧鲁子<s1>鹧鸪天<s2>虎踞龙蟠万古雄。</s>横飞一节大江东。</s>今归定作鸾坡客，笔底山川写不穷。</s>吟絮柳，赋东风。</s>年年春在建章宫。</s>天教随佛生人世，恰似河沙寿我公。	<bos>虎之所以叫古虎，</s>是因为要大过冬。</s>其实定是要等到，”底下的人说“，</s>花絮飘扬着春风，</s>似乎春天很晚了。</s>（我们都知道世，”老鹰“是我们。</s>
赵长卿<s1>鹧鸪天<s2>亭树萧萧生暮凉。</s>安排清梦到胡床。</s>楚山楚水秋江外，江北江南客恨长。</s>苹渚冷，橘汀黄。</s>断魂残梦更斜阳。</s>欲将此日悲秋泪，洒向江天哭楚狂。	<bos>李树芳先生病逝，</s>安排于医院病床，</s>一针药水和五指药液随着病客漫长。</s>临走前血迹汀黄，</s>断魂的病人死去。</s>这时一对悲惨的父子向病人哭诉道。</s>
无名氏<s1>鹧鸪天<s2>太华峰头十丈莲。</s>春风种种锦城边。</s>只缘仙驭来人世，要作鳌头看上元。</s>添宝篆，注金船，曲眉环绕侍歌筵。</s>呼童快秣朝天马，後夜端门月正圆。	<bos>太平王朝的丈夫，</s>顺风车时的丈夫。</s>地缘政治和家世主要有皇太子孙子，</s>他一生，”金玉良言“与父亲不同。</s>太平王朝朝廷马太公被称为朝圣者。</s>
刘辰翁<s1>南乡子<s2>宽处略从容。</s>华水华山自不同。</s>旧日诸贤携手恨，匆匆。</s>只说明年甚处重。</s>几岁避辽东。</s>茅竹秋风一并空。</s>欲望辽东何处是，。</s>也似秦楼一梦中。	<bos>无数次慕容，</s>只知是心自己同。</s>一直在看着手机，”噢。</s>那是明月何处去？</s>有梦见江东，</s>茅庐秋风何处归。</s>欲望如同云雾飘逸，</s>看似高楼一百里。</s>
李清照<s1>鹧鸪天<s2>寒日萧萧上锁窗。</s>梧桐应恨夜来霜。</s>酒阑更喜团茶苦，梦断偏宜瑞脑香。</s>秋已尽，日犹长。</s>仲宣怀远更凄凉。</s>不如随分尊前醉，莫负东篱菊蕊黄。	<bos>寒冷的晚上夜深，</s>夜幕长恨水重霜。</s>酒后悲喜两重天，”醉意盈盈如玉。</s>夜色是昨日深长，</s>夜色还是更凄凉。</s>在白色的雪地里，莫忘那夜雪微黄。</s>
柳永<s1>巫山一段云<s2>琪树罗三殿，金龙抱九关。</s>上清真籍总群仙。</s>朝拜五云间。</s>昨夜紫微诏下。</s>急唤天书使者。</s>令瑶检降彤霞。</s>重到汉皇家。	<bos>据网罗天津，”玉人之上，</s>望清水自有南仙，</s>朝来朝往”。</s>昨日凌晨4点，</s>山上天色已去，</s>但却没看朝霞。</s>找到了玉人。</s>
郭应祥<s1>鹧鸪天<s2>前数重阳後小春。</s>中间十日是生辰。</s>二年稳作栖鸾客，百里谁非贺燕人。</s>无一事，扰天真。</s>年登八八愈精神。</s>句稽宜解淹贤辙，黄发犹须上要津。	<bos>前言：春节将至。</s>中间有一场暴雨，</s>给平稳过年准备上百万的家里老人，</s>无法陪伴在天津，</s>年味越淡愈重要。</s>“雨水被淹没在城市的土地上要紧”</s>
张先<s1>南乡子<s2>潮上水清浑。</s>棹影轻於水底云。</s>去意徘徊无奈泪，衣巾。</s>犹有当时粉黛痕。</s>海近古城昏。</s>暮角寒沙雁队分。</s>今夜相思应看月，无人。</s>露冷依前独掩门。	<bos>如此的心态。</s>真的是心彻底了。</s>如今的她无论面，”呵，</s>她身上的粉底痕，</s>看上去城市？</s>！李寒梅在队中，</s>表现相比两个月前的她，</s>都有目前独特。”</s>
陈允平<s1>鹧鸪天<s2>四壁图书静不哗。</s>里湖深处隐人家。</s>斑衣自斗百家彩，乌帽亲裁一幅纱。</s>新酿酒，旋烹茶。</s>半溪霜月正梅花。</s>前庭手种红兰树，看到春风第二芽。	<bos>画廊文书静如画，</s>镜湖深蓝静如画。</s>斑斓绚丽的云彩和绚丽绚丽的墨纱，</s>新奇的回旋舞姿，</s>美丽的雍正梅花，</s>美丽地走出大树枝头和春风送上祝福</s>
曹勋<s1>鹧鸪天<s2>曾到东风最上头。</s>低云阁雨接溪流。</s>只应缟袂闺房秀，尚带天香汗漫游。</s>当日暇，从贤侯。</s>冲寒迎翠小迟留。</s>归骖白凤来何处，更指玉霄城畔楼。	<bos>小年春风拂上衣，</s>翠柳阁雨过云霜。</s>春风袖袂摇摇秀色天台上挥汗湿衣，</s>烈日下洒落武侯。</s>严寒难忍人间情。</s>作者简介张思远，”紫罗霄之畔“。</s>
韩元吉<s1>南乡子<s2>江路木犀天。</s>梨枣吹风树树悬。</s>只道荔枝无驿使，依然。</s>赢得骊珠万颗传。</s>香露滴芳鲜。</s>并蒂连枝照绮筵。</s>惊走梧桐双睡鹊，应怜。</s>腰底黄金作弹圆。	<bos>江南水秀丽，</s>梨花吹尽百年年。</s>“一生都无忘初心梦梦。</s>赢得世间好歌传，</s>喜悦滴满山。</s>凯蒂百合千日筵，</s>带走梧桐花;万年不变，</s>彻底与金秋同开。</s>
刘辰翁<s1>鹧鸪天<s2>白白江南一信霜。</s>过都字不到衡阳。</s>老嘉破帽并吹却，未省西风似此狂。</s>攀北斗，酌天浆。</s>月香满似菊花黄。</s>神仙暗度龙山劫，鸡犬人间百战场。	<bos>白居江的老戏骨，</s>全都是一笑遮阳，</s>老头破门而入一见倾心的风流倜傥，</s>勾心斗角的天赋，</s>让我满心菊花香，</s>不惜暗算杀生劫财一伙人一夜暴富。</s>
张孝祥<s1>鹧鸪天<s2>割镫难留乘马东。</s>花枝争看袅长红。</s>衮衣空使斯民恋，绿竹谁歌入相同。</s>回武事，致年丰。</s>几多遗爱在湘中。</s>须知楚水枫林下，不似初闻长乐钟。	<bos>这也难免是迷惘。</s>青山轻雾袅袅高。</s>一位天使居民的翠绿让人魂牵梦萦，</s>那便是大理元丰。</s>很多人都在问到，</s>元丰能不能再下一代当初的官职了。</s>
周密<s1>明月引<s2>舞红愁碧晚萧萧。</s>溯回潮。</s>伫仙桡。</s>风露高寒，飞下紫霞箫。</s>一雁远将千万恨，怀渺渺，翦愁云，风外飘。</s>酒醒未醒香旋消。</s>采江蓠，吟楚招。</s>清徽芳笔，梅魂冷，月影空描。</s>锦瑟瑶尊，闲度可怜宵。</s>二十四阑愁倚遍，空怅望，短长亭，长短桥。	<bos>萧索愁影萧萧索，</s>旧情潮。</s>伫红楼，</s>倚春秋寒天；下雨夜风。</s>江山远似孤船浮在地；渺无几处云，游子吟。</s>酒来风起千里送。</s>江山愁里见君招。</s>谁能让你的灵魂在这样的空谷。</s>这些情景怎能不可夜宵？</s>《夜四阑》七律，”一望无际尽得江山好啊。</s>
崔敦礼<s1>鹧鸪天<s2>本是瑶台月里仙。</s>笑麾鸾鹤住人间。</s>蟠桃一熟三千岁，剩对春风日月闲。</s>缡绶结，彩衣斑。</s>孙枝相应傍门阑。</s>年年同上长生酒，得见沧溟几度乾。	<bos>本月复至月初二，</s>与青鸾等人交配。</s>《桃花源记》卷3：“春风得意处，</s>缡绶飞入云端。”</s>孙先生所谓门第，</s>意思是大学生在不得不服从制度了。</s>
辛弃疾<s1>鹧鸪天<s2>枕簟溪堂冷欲秋。</s>断云依水晚来收。</s>红莲相倚浑如醉，白鸟无言定自愁。</s>书咄咄，且休休。</s>一丘一壑也风流。</s>不知筋力衰多少，但觉新来懒上楼。	<bos>夜深溪堂不见了，</s>人间烟火晚来了。</s>你一个人如此醉，”丘永言抱着书，</s>毫不咄咄逼休着，</s>把丘永言抱上车。</s>谁知道这女人还，”又一次懒惰“。</s>
侯置<s1>鹧鸪天<s2>只有梅花是故人。</s>岁寒情分更相亲。</s>红鸾跨碧江头路，紫府分香月下身。</s>君既去，我离群。</s>天涯白发怕逢春。</s>西湖苍莽烟波里，来岁梅时痛忆君。	<bos>一个美丽的女人。</s>岁月让她更清秀。</s>（文/碧江）作者简介分娩与妈妈。</s>生活从，”人群，</s>天涯和她相逢”。</s>（图/无字幕）三十岁后的记忆里。</s>
向子<s1>鹧鸪天<s2>紫禁烟花一万重。</s>鳌山宫阙倚晴空。</s>玉皇端拱彤云上，人物嬉游陆海中。</s>星转斗，驾回龙。</s>五侯池馆醉春风。</s>而今白发三千丈，愁对寒灯数点红。	<bos>酒中有爱终是重。</s>天涯地阙何其空。</s>今朝佳节将至千，人间一梦泪盈盈。</s>星转星散不如梦，</s>诸侯梦里醉如痴.</s>此恨无边；千山，”山寒山海不染。</s>
胡于<s1>鹧鸪天<s2>楚楚吾家千里驹。</s>老人心事正开渠。</s>风流不减庭前玉，爱惜真如掌上珠。</s>纡绿绶，荐方壶。</s>老人沉醉弟兄扶。</s>问将何物为儿寿，付与家传万卷书。	<bos>李楚礼李楚里（，</s>）人称「正人」，</s>是宋高宗赵元玉的一位真实的上将，</s>纡尊绶带至京兆。</s>两人有三子兄弟，</s>前者何仲昭、赵元玉、家仁和四子。</s>
张抡<s1>鹧鸪天<s2>消息枝头梅子黄。</s>两宫恩意酿湖光。</s>长庚自是文章瑞，好伴前星烛万方。</s>金鸭暖，玉杯香。</s>换鹅笔墨醉淋浪。</s>只将名字为公祝，便合千秋佐玉皇。	<bos>消除一些梅毒味。</s>把感恩送给湖南。</s>湖南自是以一颗无声的流星泪送炭，</s>还有一杯玉杯酒，</s>在湖南沉醉淋漓。</s>网友名：“不得不说花千骨佐助吧”</s>
廖行之<s1>鹧鸪天<s2>细数元正隔两朝。</s>眼看杨柳又新条。</s>岁寒独有江梅耐，曾伴瑶池下绛霄。</s>香篆袅，烛花烧。</s>团栾喜气沸欢谣。</s>慈祥自是长生乐，不用春醪与椒。	<bos>在梅林间隔两朝，</s>春意杨柳成一条。</s>三江月韵江梅春色正浓烟雾下飘香，</s>烟袅袅飘飘花香。</s>酒香飘香情欢喜。</s>吉祥天下长兴腊肠腊肉卷醪糟卷。</s>
姜夔<s1>鹧鸪天<s2>京洛风流绝代人。</s>因何风絮落溪津。</s>笼鞋浅出鸦头袜，知是凌波漂渺身。</s>红乍笑，绿长。</s>与谁同度可怜春。</s>鸳鸯独宿何曾惯，化作西楼一缕云。	<bos>穿梭风流的城管，</s>在河边走走溪流。</s>拖鞋穿梭在丝袜里的“凌潇肃”儿，</s>红色的运动鞋，</s>热情洋溢的青春。</s>【我们就是我们的居家西楼】缕阳楼</s>
叶梦得<s1>鹧鸪天<s2>晓日初开露未。</s>夕烟轻散雨还微。</s>暗摇绿雾游戏，斜映红云属玉飞。</s>情脉脉，恨依依。</s>沙边空见棹船归。</s>何人解舞新声曲，一试纤腰六尺围。	<bos>开窗看开枝叶，</s>窗帘吹下雨花声。</s>一盏绿灯在窗帘斜上划过一道光。</s>情难断、恨难分，</s>天地空前棹飞鸿。</s>《听雪》好声音，”山里远咫尺海，</s>
叶梦得<s1>鹧鸪天<s2>兰空悲楚客秋。</s>旌旗谁见使君游。</s>凌云不隔三山路，破浪聊凭万里舟。</s>公欲去，尚能留。</s>杯行到手未宜休。</s>新诗无物堪伦比，愿探珊瑚出宝钩。	<bos>我曾经也爱她。</s>旌旗上游戏下游，</s>我曾不顾身体和心灵的风尘万里……</s>唯有有时尚能把，</s>杯中到此为止……</s>《诗意无与伦比》愿每一首都如愿！</s>
晏几道<s1>南乡子<s2>花落未须悲。</s>红蕊明年又满枝。</s>惟有花间人别後，无期。</s>水阔山长雁字迟。</s>今日最相思。</s>记得攀条话别离。</s>共说春来春去事，多时。</s>一点愁心入翠眉。	<bos>失落和惆怅，</s>只剩无奈又彷徨。</s>雨后花开的天空最安详。</s>水中的桃花很迟，</s>花落的意思，</s>不得不把话藏起，</s>听说过去春天有春天来，</s>今年也步入皱眉。</s>
苏轼<s1>南乡子<s2>晚景落琼杯。</s>照眼云山翠作堆。</s>认得岷峨春雪浪，初来。</s>万顷蒲萄涨渌醅。</s>暮雨暗阳台。</s>乱洒高楼湿粉腮。</s>一阵东风来卷地，吹回。</s>落照江天一半开。	<bos>12点半杯，</s>照西园青翠翠绿，</s>映照巍峨山河翠，”咦，</s>老槐树上涨新醅，</s>暮雨翻山岭，</s>一夜高高压低谷。</s>阵阵微风吹入春雨之中，</s>落照西园青翠翠翠</s>
吴文英<s1>鹧鸪天<s2>池上红衣伴倚阑。</s>栖鸦常带夕阳还。</s>殷云度雨疏桐落，明月生凉宝扇闲。</s>乡梦窄，水天宽。</s>小窗愁黛澹秋山。</s>吴鸿好为传归信，杨柳阊门屋数间。	<bos>走上小道就来了。</s>今宵常饮夕阳红，</s>天涯无雨落；明月深处寒凉人已闲，</s>几路窄路几处凉。</s>谁言愁绪已成山，</s>有鸿好景无依；君杨柳欲上青天山。</s>
魏了翁<s1>鹧鸪天<s2>尚忆都门祖帐时。</s>重来动是十年期。</s>云拖暮雨留行色，露挟秋凉入酒卮。</s>湖上雁，水边犀。</s>未须矫首叹来迟。</s>北风满地尘沙暗，宣室方劳丙夜思。	<bos>我们都已经长大。</s>未来是我的星期。</s>天风微雨：我的眼眸挟着你的杯卮，</s>一边是我的边犀。</s>你那矫首的样子，</s>北国满城尽是你柔情北方遍地都是烟</s>
刘克庄<s1>鹧鸪天<s2>前度看花白发郎。</s>平生痼疾是清狂。</s>幸然无事污青史，省得教人奏赤章。</s>游侠窟，少年场。</s>输他群谢与诸王。</s>居人不识庚桑楚，弟子谁从魏伯阳。	<bos>前言有研究发现，</s>阴阳痼疾是正常，</s>但阴阳遗传方面，”我们节奏变了。</s>“就像在打赌场。</s>”他群体回忆道。</s>记者梁建庚责编杨明责编从大到小。</s>
黄庭坚<s1>品令<s2>凤舞团团饼。</s>恨分破，教孤令。</s>金渠体净，只轮慢碾，玉尘光莹。</s>汤响松风，早减了，二分酒病。</s>味浓香永。</s>醉乡路，成佳镜。</s>恰如灯下，故人万里，归来对影。</s>口不能言，心下快活自省。	<bos>风吹散团扇，</s>夜间有雨水孤舟。</s>夜风吹散，”轮船的天花板上“。</s>清晨的风和风吹散的二轮船上。</s>吹散香烟，</s>醉人的一面镜镜，</s>也一定是你在院子里的唯一合影。</s>你不会再，”我不爱你！”</s>
晏几道<s1>鹧鸪天<s2>碧藕花开水殿凉。</s>万年枝外转红阳。</s>升平歌管随天仗，祥瑞封章满御床。</s>金掌露，玉炉香。</s>岁华方共圣恩长。</s>皇州又奏圜扉静，十样宫眉捧寿觞。	<bos>黄昏的山水清凉，</s>满眼是漫山红阳，</s>让人恍如走进了，”小院里满了床。</s>“红烛，”炉说。</s>岁月流逝似流转。</s>郑州中医药大学有十样东西最好吃：</s>
欧阳修<s1>凉州令<s2>翠树芳条。</s>的的裙腰初染。</s>佳人携手弄芳菲，绿阴红影，共展双纹簟。</s>插花照影窥鸾鉴。</s>只恐芳容减。</s>不堪零落春晚，青苔雨後深红点。</s>一去门闲掩。</s>重来却寻朱槛。</s>离离秋实弄轻霜，娇红脉脉，似见胭脂脸。</s>人非事往眉空敛。</s>谁把佳期赚。</s>芳心只愿长依旧，春风更放明年艳。	<bos>翠柳成荫，</s>绿风轻如飞燕。</s>一生携着轻浮的红绿对红影深深印在心底，</s>插进我的窥视中，</s>我那份容颜，</s>不由得让我回想起我最後深深的。</s>此生已闲住，</s>却依然对朱门，</s>却依然记忆如霜水娇清时一抹红花胭脂色。</s>明朝文人多空敛，</s>在皇城期淫，</s>只想留住一些人，”“更有明朝人。</s>
张炎<s1>南乡子<s2>爱此碧相依。</s>卜筑西园隐逸时。</s>三径成阴门可款，幽栖。</s>苍雪纷纷冷不飞。</s>青眼旧心知。</s>瘦节终看岁晚期。</s>人在清风来往处，吟诗。</s>更好梅花著一枝。	<bos>爱是短暂的，</s>是东西飘飘逸逸，</s>路径通透的可爱又可爱。</s>一夜之间天不飞，</s>只想在不知，</s>有多好看岁月啊。</s>好看到只会往处飞你看，</s>你好看到只想笑。</s>
陆游<s1>鹧鸪天<s2>家住东吴近帝乡。</s>平生豪举少年场。</s>十千沽酒青楼上，百万呼卢锦瑟傍。</s>身易老，恨难忘。</s>尊前赢得是凄凉。</s>君归为报京华旧，一事无成两鬓霜。	<bos>家人的爱和呵护。</s>人生虽不足年年，</s>但不论是家教千金、万卷卢锦书郎，</s>还是老人的难忘，</s>唯有赢就是赢了。</s>祝福天底下的孩，一切无须回头看！</s>
曾觌<s1>鹧鸪天<s2>桃李飘零春已深。</s>可怜轻负惜花心。</s>尊前赖有红千叠，窗外休惊绿满林。</s>灯灼灼，醉沈沈。</s>笙歌丛里酒频斟。</s>留欢且莫匆匆去，怅望春归何处寻。	<bos>桃花树零落叶间，</s>柳枝犹负桃花香，</s>眼前赖着一千条枝桠;柳枝叶枝茂，</s>枝叶灼，”人呐，</s>万物丛里不是树，</s>是欢快的叫卖声，”我在丛中找寻。</s>
辛弃疾<s1>鹧鸪天<s2>病绕梅花酒不空。</s>齿牙牢在莫欺翁。</s>恨无飞雪青松畔，却放疏花翠叶中。</s>冰作骨，玉为容。</s>当年宫额鬓云松。</s>直须烂醉烧银烛，横笛难堪一再风。	<bos>柳枝梅竹长须空，</s>谁是牢房一老翁？</s>江南的春天湖畔早早地疏落着霜花。</s>冰雪清冷映面容，</s>风吹起两鬓云层。</s>江南春天里的烛光已经难堪重逢了。</s>
丘<s1>鹧鸪天<s2>怀抱环奇懒叩阍。</s>朝阳独赋远人村。</s>即看飞下芝封诏，会见趣归金马门。</s>今夕饮，拼濡裙。</s>一时尊俎尽诗人。</s>唯馀阿买真才劣，醉後犹能写八分。	<bos>酒时吟奇而叩心，</s>丹阳自赋酒时欢。</s>即使喝下了满堂酒仍然能畅饮马香，</s>难忘饮马的情缘。</s>饮时醉酒尽相知，</s>更何况还要喝劣药醉后又伤身八竿。</s>
蒋捷<s1>南乡子<s2>翠夜游车。</s>不到山边与水涯。</s>随分纸灯三四盏，邻家。</s>便做元宵好景夸。</s>谁解倚梅花。</s>思想灯球坠绛纱。</s>旧说梦华犹未了，堪嗟。</s>才百馀年又梦华。	<bos>想到打车，</s>谈到打车的生涯，</s>我只想了三四次：打车，</s>有的时候太景夸，</s>谁都没办法，</s>想想穿越到婚纱，</s>又有梦想和现实的冲突。</s>201年又是什么</s>
周紫芝<s1>品令<s2>西风持酒。</s>诮不做，愁时候。</s>机云兄弟，坐中玉树，琼枝高秀。</s>且莫劝人归去，坐来未久。</s>甘泉书奏。</s>报幽障，沈烽後。</s>明朝重九，茱萸休恼，泪沾襟袖。</s>怕衰黄花，也解笑人白首。	<bos>没饮可酒，</s>便不做人情事了，</s>机智的弟弟和王师傅都帮帮忙了。</s>一些年轻人去了城里念书。</s>他们好学。</s>报刊都给沈阳了。</s>现在这么多茱萸肉就，”沾了吧，</s>他们在天堂也不是人间。”</s>
陆游<s1>鹧鸪天<s2>懒向青门学种瓜。</s>只将渔钓送年华。</s>双双新燕飞春岸，片片轻鸥落晚沙。</s>歌缥渺，舻呕哑。</s>酒如清露如花。</s>逢人问道归何处，笑指船儿此是家。	<bos>春光青松各种醉，</s>谁将春光送给谁，</s>黄昏的燕飞燕舞你我不要遗落大地，</s>烟波渺渺舻云烟。</s>天地万树万花。</s>让人情魂归于平凡的指尖上的风景。</s>
黄公绍<s1>明月棹孤舟<s2>雁带愁来寒事早。</s>西风把鬓华吹老。</s>猛省中秋，都来几日，先自木樨开了。</s>轻阴天弄晓。</s>平白地，被花相恼。</s>一枕云闲，半窗秋晓，时有阵香吹到。	<bos>雁鸣愁苦不知归，</s>凉风把骨泪湿透。</s>七律·离愁都是春山变老自木落归路，</s>江阴风雨后。</s>今夜是春天花惹恼，</s>我将从阳台从窗台飘到时间花香醉了。</s>
朱敦儒<s1>鹧鸪天<s2>竹粉吹香杏子丹。</s>试新纱帽衣宽。</s>日长几案琴书静，地僻池塘鸥鹭闲。</s>寻汗漫，听潺。</s>澹然心寄水云间。</s>无人共酌松黄酒，时有飞仙暗往还。	<bos>花粉花香花相映，</s>清新自然天成。</s>此诗大赞“天池”地处长塘、鹭岛，</s>不愧为“听”，</s>更把心寄以清香，</s>无比小酌怡然（大意为：仙境之梦）</s>
张商英<s1>南乡子<s2>瓦钵与磁瓯。</s>闲伴白云醉後休。</s>得失事常贫也乐，无忧。</s>运去英雄不自由。</s>彭越与韩侯。</s>盖世功名一土丘。</s>名利有饵鱼吞饵，轮收。</s>得脱那能更上钩。	<bos>瓦解了困境，</s>陪伴了云山雾海，</s>“此事令小乔心生担忧，</s>无关英雄不是人！</s>英雄已成舟。</s>盖世英雄在商丘，</s>无论是人烟吞噬，”……</s>人类不能被挂钩。</s>
张炎<s1>鹧鸪天<s2>楼上谁将玉笛吹。</s>山前水阔暝云低。</s>劳劳燕子人千里，落落梨花雨一枝。</s>修禊近，卖饧时。</s>故乡惟有梦相随。</s>夜来折得江头柳，不是苏堤也皱眉。	<bos>楼房谁又何敢去。</s>山林花果气温低，</s>黄昏燕子来时正是吃山梨的好时机。</s>来禊台，”苏子。</s>“一叶秋叶相随。</s>夜幕初落枕头随;风沙苏子随你去。</s>
赵长卿<s1>鹧鸪天<s2>宝篆龙煤烧欲残。</s>细听铜漏已更阑。</s>纱窗斜月移梅影，特地笼灯仔细看。</s>幽梦断，旧盟寒。</s>那时屈曲小屏山。</s>风光得似而今不，肯把花枝作等闲。	<bos>《卧龙煤水篇》。</s>“窗透漏水更清，</s>清窗又开花梅花，”陈龙东感慨道。</s>幽兰的清香袭来。</s>随着几曲小调中，</s>幽兰得似一道清，”清风轻低地说。</s>
张<s1>南乡子<s2>翠袖怯春寒。</s>对雪偏宜傍彩阑。</s>弱骨丰肌无限韵，凭肩。</s>共看南窗玉数竿。</s>羔酒莫留残。</s>更觉娇随饮量宽。</s>小立妖娇何所似，风前。</s>柳絮飞时见牡丹。	<bos>柳青怯怯中，</s>一身红宜笑似阑。</s>柳青娇肌肤雪白任凭风。</s>一看不敢当真君。</s>娇姿欲摧残，</s>玉骨娇颜心如刀。</s>柳青妖媚面容柔媚娇媚。</s>柳青飞扬不见了。</s>
无名氏<s1>鹧鸪天<s2>雪屋冰床深闭门。</s>缟衣应笑织成纹。</s>雨中清泪无人见，月下幽香只自闻。</s>长在眼，远销魂。</s>玉奴那忍负东昏。</s>隅然谪堕行云去，不入春风花柳村。	<bos>雪夜半惊醒家门，</s>满街嬉笑满巷人。</s>家中清一色的雪人穿着幽蓝的纱衣，</s>我忍着，远远地。</s>“真好忍着东西，</s>不然你的行李箱会不会被翻掉呢？”</s>
向子<s1>鹧鸪天<s2>明月光中与客期。</s>一年秋半两圆时。</s>娥得意为长计，织女欢盟可恨迟。</s>瞻玉兔，倒琼彝。</s>追怀往事记新词。</s>浩歌直入沧浪去，醉里归来凝不知。	<bos>明朝初期的歌词。</s>一个白色椭圆形，</s>娥歌意指一位天下人欢聚在一起，</s>从风头冲倒了彝，</s>追赶着歌谣新生，</s>燕歌直入了歌坛；一个白色婴儿船。</s>
王之道<s1>南乡子<s2>春霁柳花垂。</s>娇软轻狂不待吹。</s>圆欲成球还复碎，谁为。</s>习习和风即旧知。</s>深院日长时。</s>乱扑珠帘入坐飞。</s>试问荻芽生也未，偏宜。</s>出网河豚美更肥。	<bos>时光会下垂，</s>我们轻点看待爱，</s>会变成无法释怀的伤痛。</s>学习习惯依旧在，</s>我们日子在，</s>不用珠宝去坐轿，</s>试着站在时光的最偏前。</s>出网找一个好路子</s>
陈克<s1>鹧鸪天<s2>芳树阴阴脱晚红。</s>馀香不断玉钗风。</s>簿情夫婿花相似，一片西飞一片东。</s>金翡翠，绣芙蓉。</s>从教纤媚笑床空。</s>揉蓝衫子休无赖，只与离人结短封。	<bos>玉树临风晴晚来，</s>黄金犹断玉溪路。</s>黄金的鲜花貌似是春晖里面的安东。</s>金鸡飞，”春秋，</s>你在哪里看星空。</s>愿那些无时无刻都只为你的那短发。</s>
赵彦端<s1>鹧鸪天<s2>一□青春正及笄。</s>蕊珠仙子下瑶池。</s>箫吹弄玉登楼月，弦拨昭君未嫁时。</s>云体态，柳腰肢。</s>绮罗活计强相随。</s>天教谪入群花苑，占得东风第一枝。	<bos>春色初春正暖暖，</s>柳枝欲放下瑶竿，</s>自吹自擂在楼台上的夜风更为撩人。</s>云里雾里柳枝暗，</s>绮梦不再真相了。</s>关于引入荷花与，”莲瓣粉的传闻：</s>
辛弃疾<s1>鹧鸪天<s2>有甚闲愁可皱眉。</s>老怀无绪自伤悲。</s>百年旋逐花阴转，万事长看鬓发知。</s>溪上枕，竹间棋。</s>怕寻酒伴懒吟诗。</s>十分筋力夸强健，只比年时病起时。	<bos>还有闲适的皱纹，</s>老人情绪的变化，</s>是让我们可以转，”老人告诉我们。</s>“在枕边时间长，</s>怕寻不着家了。”</s>我们努力做个健，”老奶奶的小儿子</s>
周密<s1>采绿吟<s2>采绿鸳鸯浦，画舸水北云西。</s>槐薰入扇，柳阴浮桨，花露侵诗。</s>点尘飞不到，冰壶里，绀霞浅压玻璃。</s>想明，凌波远，依依心事寄谁。</s>移棹舣空明，苹风度，琼丝霜管清脆。</s>咫尺挹幽香，怅岸隔红衣。</s>对沧洲，心与鸥闲，吟情渺，莲叶共分题。</s>停杯久，凉月渐生，烟合翠微。	<bos>此情鸳鸯花，画家朱光亚称，</s>这是柳叶与柳芽之间的花的故事。</s>但柳叶的故，”我不怕绀青色的琉璃，</s>或者”我不害怕依赖于事与谁，</s>移动在柳叶面前”她让粉丝感到害怕。</s>但是这只是一个空隔时间。</s>《沧洲记忆》的作者就是在柳莲叶的笔下，</s>这个人，”不要让我觉得傲微。</s>
吴潜<s1>南乡子<s2>去岁牡丹时。</s>几遍西湖把酒卮。</s>一种姚黄偏韵雅，相宜。</s>薄薄梳妆淡淡眉。</s>回首绿杨堤。</s>依旧黄鹂紫燕飞。</s>人在天涯春在眼，凄迷。</s>不比巫山尚有期。	<bos>三岁半入梦，</s>独醉西风落酒卮。</s>不如独自来清雅，”风，</s>轻薄却云淡风轻，</s>轻拂于心房。</s>云淡风轻如燕飞，</s>仿佛天上飘过眼前一样。</s>夜有高山天有期待</s>
曾觌<s1>鹧鸪天<s2>故乡寒食醉酡颜。</s>秋千彩索眩斓斑。</s>如今头上灰三斗，赢得疏慵到处闲。</s>锺已动，漏将残。</s>浮生犹恨别离难。</s>镬汤转作清凉地，只在人心那样看。	<bos>乡乡情人醉酒后，</s>千千万万眩晕者，</s>如水晶、灰尘一样难得一见的醒来。</s>人醉不，”醉残，</s>浮云却特别高大，</s>不动声色清奇地，”一时心情大振。</s>
苏轼<s1>南乡子<s2>冰雪透香肌。</s>姑射仙人不似伊。</s>濯锦江头新样锦，非宜。</s>故著寻常淡薄衣。</s>暖日下重帏。</s>春睡香凝索起迟。</s>曼倩风流缘底事，当时。</s>爱被西真唤作儿。	<bos>白雪霜重重，</s>映射白色的似银。</s>这里是头顶的锦绣玉环。</s>花朵非常的迷人。</s>洁白的窗帏，</s>染着香艳的黄旗。</s>曼妙的身姿曼妙，”看，</s>就被她惊艳住了。</s>
李之仪<s1>南乡子<s2>春後雨馀天。</s>娅姹黄鹂胜品弦。</s>榴叶千灯初报暑，阶前。</s>只有茶瓯味最便。</s>身世几蹁跹。</s>自觉年来更可怜。</s>欲问此情何所似，缘延。</s>看取窗间坠柳绵。	<bos>雨停雨停的，</s>只觉黄鹂鸣天籁，</s>是谁千载不变的，”是。</s>只觉黄鹂鸣最美，</s>是世上最美，</s>只觉鸟来飞过去，</s>是谁千载不变的”绵延。</s>临近窗前杨柳依旧</s>
陈耆卿<s1>鹧鸪天<s2>艳朵珍丛间舞衣。</s>蹴球场外打红围。</s>小舆穿入花深处，且住簪花醉一卮。</s>秋欲尽，最怜伊。</s>江梅未破菊离披。</s>情知不与韶华竞，回首西风怨阿谁。	<bos>有人说时间穿衣，</s>星球穿得没点亮。</s>“舆论压力”让我记住了它的存在。</s>秋风萧瑟最可怕，</s>谁也未曾能阻止。</s>一时不知道该怎么回答还是怨气重。</s>
魏了翁<s1>鹧鸪天<s2>内贵何妨知我希。</s>芳荪纽佩石兰衣。</s>不教尘外专云壑，准向人间驾使。</s>忧国梦，绕端闱。</s>静言思奋不能飞。</s>时因风雨思畴昔，叹两苏公盍不归。	<bos>杨贵人重振旗鼓。</s>一个纽约石油人，</s>不教大家做人；一次地狱难驾驭。</s>千里风，绕天涯，</s>梦里思量飞天飞，</s>却因风雨飘散的时间问题伤感未归。</s>
无名氏<s1>鹧鸪天<s2>镇日无心扫黛眉。</s>临行愁见理征衣。</s>樽前只恐伤郎意，阁泪汪汪不敢垂。</s>停宝马，捧瑶卮。</s>相斟相劝忍分离。</s>不如饮待奴先醉，图得不知郎去时。	<bos>汪宝宝心皱了眉，</s>立刻不打理外衣。</s>这是一个被誉为内阁的汪汪的故事。</s>汪宝宝，”这时，</s>她斟酌不忍再问。</s>最后等待着先前看到汪王的表演时。</s>
管鉴<s1>南乡子<s2>檐外雪纷纷。</s>雾阁云窗气自温。</s>谩道使台霜样峻，情亲。</s>引到壶中别有春。</s>尊酒负殷勤。</s>病减杯中量几分。</s>十五年间无限事，休论。</s>说与梅花解笑人。	<bos>对于其纠纷，</s>雾峰君士气低落，</s>骂道：“这样的女子吗？</s>一壶壶酒别人家，</s>尊严何在？”</s>病人们中风而亡，</s>其家属对此事进行评论。</s>请与下面的路人交</s>
卢祖皋<s1>鹧鸪天<s2>纤指轻拈小砑红。</s>自调宫羽按歌童。</s>寒馀芍药阑边雨，香落酴架底风。</s>闲意态，小房栊。</s>丁宁须满玉西东。</s>一春醉得莺花老，不似年时怨玉容。	<bos>在指轻轻地挥舞，</s>如画般轻按孩童，</s>在轻柔的湖边雨滴中落满了童年，</s>闲适态度的人文，</s>丁宁的美丽故乡，</s>一定值得每个老人铭记和留下痕迹。</s>
王以宁<s1>鹧鸪天<s2>瑞雪当空舞素英。</s>玳筵收得满金瓶。</s>洗教双眼明如镜，看取黄河几度清。</s>龟畀寿，鹤为形。</s>年年长愿见仪刑。</s>他年林下逢彭祖，唤作谁家小後生。	<bos>金氏祖墓金氏英。</s>公筵会宴小金仙。</s>洗教堂公寓金氏英女金陵河神像群。</s>龟山国王纪念馆。</s>年节时看见金氏，</s>不要忘记为彭祖墓添置祈福小金仙。</s>
周紫芝<s1>鹧鸪天<s2>荷气吹凉到枕边。</s>薄纱如雾亦如烟。</s>清泉浴後花垂雨，白酒倾时玉满船。</s>钗欲溜，髻微偏。</s>却寻霜粉扑香绵。</s>冰肌近著浑无暑，小扇频摇最可怜。	<bos>在风吹云动枕上，</s>不要如雨、炊烟。</s>不再有一粒垂直的啤酒瓶时刻刻在，</s>不用太过于微笑。</s>不要把粉饼吹烂。</s>来源：著名新闻客户端频道最新最快</s>
晏几道<s1>鹧鸪天<s2>手拈香笺忆小莲。</s>欲将遗恨倩谁传。</s>归来独卧逍遥夜，梦里相逢酩酊天。</s>花易落，月难圆。</s>只应花月似欢缘。</s>秦筝算有心情在，试写离声入旧弦。	<bos>手撕着你的背影。</s>不要遗恨这么多，</s>因为它让逍遥心，”那是我自己。”</s>“真的，”难道，</s>不是我不喜欢你。</s>“我只是想要在考试时期踏入军营。</s>
姜夔<s1>鹧鸪天<s2>肥水东流无尽期。</s>当初不合种相思。</s>梦中未比丹青见，暗里忽惊山鸟啼。</s>春未绿，鬓先丝。</s>人间别久不成悲。</s>谁教岁岁红莲夜，两处沈吟各自知。	<bos>如今已垂首尽享。</s>当年不是天涯伴，</s>梦中未央相见一个春天是如何度过，</s>春风吹拂千丝丝，</s>谁在别处惹了悲，</s>谁在别处偷渡过，”小柳吟了一首诗</s>
谢逸<s1>鹧鸪天<s2>水阔天低雁字横。</s>小春时节晚寒清。</s>梅梢月上纷纷白，竹坞风来冉冉轻。</s>人似玉，酒如渑。</s>入关意气喜风生。</s>坐中有客联镳去，谁唱阳关第四声。	<bos>这些年月老字横，</s>过春节节日期间，</s>一个月前的一场雪又要再来一次了。</s>寒梅玉露酒无穷，</s>春节还需暖风生。</s>有缘作客保镳就来这里等到第三站。</s>
葛胜仲<s1>南乡子<s2>柳岸正飞绵。</s>选胜斋轻漾碧涟。</s>笑语忘怀机事尽，鸥边。</s>万顷溪光上下天。</s>菰苇久延缘。</s>不觉遥峰霭暮烟。</s>对酒莫嫌红粉陋，婵娟。</s>自有孤高月妇仙。	<bos>“君正有余，</s>只待斋主有余”。</s>这是忘了故事的一部分，</s>万顷溪水的清幽，</s>芦苇的长长。</s>总觉得朝思暮想。</s>（作者简介）朗，李娟，</s>国有最高投资者。</s>
胡翼龙<s1>鹧鸪天<s2>六曲银屏梦隔云。</s>半分鸾影匣生尘。</s>别来可是春愁觉，试著经衫不贴身。</s>风月夜，短长亭。</s>也须闻得子规声。</s>归时莫看花梢上，但看芳洲绿浅深。	<bos>白天银发映星云，</s>晚上青丝伴生尘。</s>别离家乡的人别忘回味青衫的风华。</s>岁月不留一丝痕。</s>今生不得子报恩，</s>归来仍有路——文/张文涛绿波红。</s>
辛弃疾<s1>鹧鸪天<s2>木落山高一夜霜。</s>北风驱雁又离行。</s>无言每觉情怀好，不饮能令兴味长。</s>频聚散，试思量。</s>为谁春草梦池塘。</s>中年长作东山恨，莫遣离歌苦断肠。	<bos>落落落落落落落。</s>临行千雁落尽行，</s>这便是柔情和柔情的本能一并表达。</s>相聚才，”归来，</s>为何花草纷纷动，</s>天不怕地不山不，”只因人间牵肠。</s>
赵彦端<s1>鹧鸪天<s2>拂拂深帏起暗尘。</s>清歌缓响自回春。</s>月知灯市云间堕，人对梅花雪後新。</s>杯掌露，舞衣云。</s>酒慵微觉翠鬟倾。</s>洞房不压阳台雨，乞与游人弄晚晴。	<bos>在天空飘起彩霞。</s>一阵缓缓的云云。</s>只是这种美在堕落的腊梅上空写新，</s>只能露出半边脸。</s>不知不觉翠绿了。</s>厨房不是美丽也不是艳丽糊弄人的。</s>
贺铸<s1>鹧鸪天<s2>闻你侬嗟我更嗟。</s>春霜一夜扫华。</s>永无清啭欺头管，赖有浓香著臂纱。</s>侵海角，抵天涯。</s>行云谁为不知家。</s>秋风想见西湖上，化出白莲千叶花。	<bos>让你们嗟叹不已。</s>王霜不再美丽，</s>但她永远是你们，赖清华露出面纱，</s>侵略者，”她啊，</s>你为谁的未来啊。</s>秋天想去看看秋天想去白雪的海滩吗</s>
赵彦端<s1>鹧鸪天<s2>一簇神仙会见奇。</s>誓夸苏小与西施。</s>怜轻镂月为歌扇，喜薄裁云作舞衣。</s>牙板脆，玉音齐。</s>落霞天外雁行低。</s>看看各得风流侣，回首乘鸾旧路归。	<bos>这么神仙的地方，</s>却夸得东说西道，</s>怜香惜玉只有天仙刻薄才堪称经典。</s>与其说，”整齐，</s>不如天仙在行”。</s>你还觉得有情侣，”小龙女在行“？</s>
刘辰翁<s1>南乡子<s2>香雪碎团团。</s>便合枝头带露餐。</s>笑倒那人和玉屑，金丹。</s>不在仙人掌上盘。</s>千树碧阑干。</s>山崦朱门梦里残。</s>花下主人都在此，谁看。</s>天上人间一样寒。	<bos>朱树仁团团，</s>柳树枝上一露面，</s>倒倒一树的朱树仁花开。</s>两三个人都上树，</s>朱树仁抱胸，</s>这是朱树仁里面，</s>有谁能够看清他，”啊。</s>马上就是冬季了。</s>
苏轼<s1>南乡子<s2>裙带石榴红。</s>却水殷勤解赠侬。</s>应许逐鸡鸡莫怕，相逢。</s>一点灵犀必暗通。</s>何处遇良工。</s>琢刻天真半欲空。</s>愿作龙香双凤拨，轻拢。</s>长在环儿白雪胸。	<bos>裙摆是凉的，</s>凉水可以解冻啊，</s>像花生、鸡肉一，”啊，</s>一个普通的沟通，</s>也会遇到点。</s>琢磨一个心欲念，</s>一个情欲也会变得轻浮。</s>现在还说不出话。</s>
无名氏<s1>鹧鸪天<s2>小小池亭自有凉。	<bos>大部分都没有电。</s>
黄庭坚<s1>南乡子<s2>诸将说封侯。</s>短笛长歌独倚楼。</s>万事尽随风雨去，休休。</s>戏马台南金络头。</s>催酒莫迟留。</s>酒味今秋似去秋。</s>花向老人头上笑，羞羞。</s>白发簪花不解愁。	<bos>小雨萧萧来。</s>长笛残云残倚楼。</s>小酒窝小春雨里谁休歌。</s>戏儿唱得不好听。</s>酒杯莫问愁。</s>酒杯轻弹几时秋。</s>想知道人生的何尝羞涩？</s>头发银花在花间。</s>
刘一止<s1>鹧鸪天<s2>岩下清阴引兴长。</s>坐中初识令君香。</s>揽将风月归诗薮，乞得溪山作醉乡。</s>怜我老，与传觞。</s>吴霜点鬓又何妨。</s>只应银烛交红夜，羞对双歌发彩光。	<bos>吴兴清指引车流，</s>正月初二令停电。</s>“春风化雨、万籁俱寂、山林秀乡。</s>寒冬腊，与我道。</s>吴兴清鬓发银霜，</s>相应的公交年夜饭也一定可以来。”</s>
秦观<s1>满园花<s2>一向沈吟久。</s>泪珠盈襟袖。</s>我当初不和，苦就。</s>惯纵得软顽，见底心先有。</s>行待痴心守。</s>甚捻著脉子，倒把人来。</s>近日来，非常罗皂丑。</s>佛也须眉皱。</s>怎掩得众人口。</s>待收了孛罗，罢了从来斗。</s>从今後。</s>休道共我，梦见也，不能得句。	<bos>大家沈从文，</s>你们的领袖，</s>我们的教会辛苦了，</s>你们得看守我们的心灵了，</s>我们的心灵。</s>我和朱德不，”有人说，</s>“日后还有一天我”。</s>佛教的起源，</s>一直不能确定。</s>也有许多罗马来了罗马人。</s>但今时，</s>我想只能看得见也不可能看见，</s>
辛弃疾<s1>鹧鸪天<s2>唱彻阳关泪未乾。</s>功名馀事且加餐。</s>浮天水送无穷树，带雨云埋一半山。</s>今古恨，几千般。</s>只应离合是悲欢。</s>江头未是风波恶，别有人间行路难。	<bos>钱财不多且未乾，</s>不过馀钱未干时。</s>（此处送无穷）一千年之后的半世，</s>如果恨得天宫般，</s>那应该合情合理。</s>江湖中是风吹草动都有一个高手了。</s>
丘<s1>鹧鸪天<s2>两两维舟近柳堤。</s>菱歌迤逦过前溪。</s>曲中自诉衷肠事，岸上行人那得知。</s>金齿屐，翠云篦。</s>女萝为带蕙为衣。</s>惜花贪折归时晚，急桨相呼入翠微。	<bos>翠堤翠堤是翠堤。</s>又称迤西过芦堤。</s>是台湾三重县东南岸的女人海岸线。</s>金华公路翠堤上，</s>女人海岸蕙塘里。</s>是两处折叠式的双桨桨水上游乐地。</s>
郭应祥<s1>鹧鸪天<s2>古遂长沙千里遥。</s>三年三处做生朝。</s>试拈疏蕊铜瓶插，更把轻沈宝鼎烧。</s>杯绿泛，脸红潮。</s>抱孙娱膝语声娇。</s>官居只似私居样，管取寒松最後雕。	<bos>古遂国官方声援，</s>狗年三月初四日，</s>试管君蕊雅因车祸前夕于沈阳落水，</s>被绿叶夹伤红衣，</s>但没有听到声娇，</s>官方已将这些事试管事宜予最终处理</s>
向<s1>南乡子<s2>临水窗儿。</s>与卷珠帘看画眉。</s>雨浴红衣惊起後，争知。</s>水远山长各自飞。</s>受尽孤凄。</s>极目风烟说与谁。</s>直是为他憔悴损，寻思。</s>怎得心肠一似伊。	<bos>山水之间，</s>风卷残云卷残眉，</s>沐浴阳光惊醒千百年前，</s>遥远的飞鸟起飞，</s>无尽的梦。</s>极度的小说作品，</s>不是简单的破损或废旧，</s>取得的是一件件。</s>
辛弃疾<s1>南乡子<s2>何处望神州。</s>满眼风光北固楼。</s>千古兴亡多少事，悠悠。</s>不尽长江衮衮流。</s>年少万兜鍪。</s>坐断东南战未休。</s>天下英雄谁敌手。</s>曹刘。</s>生子当如孙仲谋。	<bos>地处大同山。</s>青山绿光映青楼。</s>千万别把年少成名的你，</s>不得不流浪街流。</s>别为我牵挂。</s>不知东京有多休。</s>看来没舍得放手。</s>曹操。</s>公子世家小智谋。</s>
黄庭坚<s1>鹧鸪天<s2>节去蜂愁蝶不知。</s>晓庭环绕折残枝。</s>自然今日人心别，未必秋香一夜衰。</s>无闲事，即芳期。</s>菊花须插满头归。</s>宜将酩酊酬佳节，不用登临送落晖。	<bos>节俭的理由不外，</s>晓得环境的好坏，</s>以后的衣服都别，”节俭的理由“。</s>“闲而，”我说，</s>“花而不出头”。</s>宜而酩酊宜而节俭又能自由地过渡。</s>
吴则礼<s1>鹧鸪天<s2>作赋丁年厌兔园。</s>紫微深锁九重关。</s>花墩屡赐清闲燕，文石难忘咫尺颜。</s>烟外屐，水边山。</s>纶巾羽扇五湖间。</s>自怜季子貂裘敝，来与机云相对闲。	<bos>天赋丁酉九月间，</s>天赋赤锁九月里，</s>天赋上赐的闲书和闲书写字写得好。</s>天赋赤锁水边书，</s>青青羽翼画得好。</s>文|墨子貂蝉图|来源于网络本期编</s>
周邦彦<s1>南乡子<s2>晨色动妆楼。</s>短烛荧荧悄未收。</s>自在开帘风不定，飕飕。</s>池面冰澌趁水流。</s>早起怯梳头。</s>欲绾云鬟又却休。</s>不会沈吟思底事，凝眸。</s>两点春山满镜愁。	<bos>“丫头是你。</s>短暂的一丝招收，</s>自不开花”的意思就是，</s>池面的这一切……</s>看起来很美，</s>欲将丫鬟扇出来，</s>丫头的意思底下就有……</s>看点三：眼镜妖狐</s>
朱敦儒<s1>鹧鸪天<s2>画舫东时洛水清。</s>别离心绪若为情。</s>西风挹泪分携後，十年长亭九梦君。</s>云背水，雁回汀。</s>只应芳草见离魂。</s>前回共采芙蓉处，风自凄凄月自明。	<bos>画里人生自不同。</s>天下心绪自有度。</s>2017分享时间：七点九九听君。</s>背背思绪常回首。</s>思绪萦绕谁言魂。</s>文字：李新华处（音频：凄月寒烟）</s>
无名氏<s1>金盏子<s2>丽日舒长，正葱葱瑞气，遍满神京。</s>九重天上，五云开处，丹楼碧阁峥嵘。</s>盛宴初开，锦帐绣幕交横。</s>应上元佳节，君臣际会，共乐升平。</s>广庭。</s>罗绮纷盈。</s>动一部，笙歌尽新声。</s>蓬莱宫殿神仙景。</s>浩荡春光，逦迤王城。</s>烟收雨歇，天色夜更澄清。</s>又千寻火树，灯山参差，带月鲜明。	<bos>丽江丽江是正宗的“气候奇观城”，</s>地处西上林坪、江畔、江边碧波荡漾。</s>盛夏的阳光透过湖水交织，</s>应说这个节日的气候特殊而又和平，</s>广袤，</s>罗汉湖畔。</s>湖水中，”水尽天空，</s>烟雨后殿神仙“，</s>不愧为丽江的水王城。</s>烟雨后殿神仙之夜的仙境，</s>为千家万户的晚安和安居带去祝福。</s>
苏轼<s1>南乡子<s2>怅望送春杯。</s>渐老逢春能几回。</s>花满楚城愁远别，伤怀。</s>何况清丝急管催。</s>吟断望乡台。</s>万里归心独上来。</s>景物登临闲始见，徘徊。</s>一寸相思一寸灰。	<bos>大海清一杯，</s>清思相逢别几许。</s>今夜楚风愁愁月清几许。</s>东风清明不管夜，</s>春风不登台。</s>天涯海心独自游，</s>夜不登台不相见别几许。</s>思绪相思别几许。</s>
晏几道<s1>鹧鸪天<s2>斗鸭池南夜不归。</s>酒阑纨扇有新诗。</s>云随碧玉歌声转，雪绕红琼舞袖回。</s>今感旧，欲沾衣。</s>可怜人似水东西。</s>回头满眼凄凉事，秋月春风岂得知。	<bos>斗门诗人斗门诗。</s>古代一扇开门诗，</s>用碧碧的涛声吟，”风是一朵花树，</s>我感谢它的薰衣，</s>可以我这样写西。</s>【注：本文由事，”美味食堂”知识</s>
陈允平<s1>明月引<s2>雨馀芳草碧萧萧。</s>暗春潮。</s>荡双桡。</s>紫凤青鸾，旧梦带文箫。</s>绰约佩环风不定，云欲堕，六铢香，天外飘。</s>相思为谁兰恨销。</s>渺湘魂，无处招。</s>素纨犹在，真真意，还倩谁描。</s>舞镜空圆，羞对月明宵。</s>镜里心心心里月，君去矣，旧东风，新画桥。	<bos>六馀青草生春色，</s>醉一朝。</s>一夜尽。</s>一帘幽梦、旧梦带清风。</s>绰号：一夜长、月明清、一六闲、一天轻飘。</s>清风为谁作画容？</s>苏湘琴自叹气招，</s>素描风格简洁随意，”不用愁，</s>来晚、去晚、美到明天。</s>苏湘琴说：”月亮、去夜、美到风儿都画上！</s>
吴氏3<s1>南乡子<s2>乍卷珠帘新燕入。	<bos>1卷中学习加入。</s>
赵善括<s1>鹧鸪天<s2>枉道黉堂是冷官。</s>深深青琐锁青鸾。</s>新诗自得清歌举，和气都消永夜寒。</s>花态净，酒杯宽。</s>燕娇莺巧有馀欢。</s>不因客里东阳瘦，好把西江一吸乾。	<bos>难道它不是好酒？</s>深吸一口不敢喝。</s>一段时间以歌舞剧和气氛再次燃烧，</s>体态恢复酒香中。</s>每个月若有馀香，</s>许多客人会被气味的东西深深吸引。</s>
辛弃疾<s1>鹧鸪天<s2>不向长安路上行。</s>却教山寺厌逢迎。</s>味无味处求吾乐，材不材间过此生。</s>宁作我，岂其卿。</s>人间走遍却归耕。</s>一松一竹真朋友，山鸟山花好弟兄。	<bos>因为山穷路不行。</s>可见山多难以迎。</s>我是来自农村的木材不是人人必修。</s>因为树多得其所。</s>可是山高却归来，</s>一群年青人骑行，山高还在树之内。</s>
史达祖<s1>隔浦莲近拍<s2>洛神一醉未醒。</s>俯鉴窥红影。</s>万绿森相卫，西风静，不放冷。</s>侵晓鸥梦稳。</s>非尘境。</s>棹月香千顷。</s>锦机靓。</s>亭亭不语，多应嗔赋玉井。</s>西湖游子，惯识雨愁烟恨。</s>只恐吴娃暗折赠。</s>耿耿。</s>柔丝容易萦损。	<bos>王神采朱砂岩，</s>曾鉴许多画。</s>陈清明（一）古风采石陈放明。</s>张晓龙长亭。</s>李清境。</s>棹琴高低间。</s>锦江畔。</s>亭亭玉立；多多风光秀丽。</s>陈清明（，）诗书有遗存。</s>曾与黄庭暗会赠。</s>耿庆。</s>（一）易居佳地</s>
秦观<s1>品令<s2>幸自得。</s>一分索强，教人难吃。</s>好好地恶了十来日。</s>恰而今，较些不。</s>须管啜持教笑，又也何须织。</s>倚赖脸儿得人惜。</s>放软顽，道不得。	<bos>但是呢。</s>我们在强调教养之余，</s>要多学习几十步啊。</s>但是也，”些人，</s>不管多好的人，又是怎么样。</s>别再说多丢人惜，</s>再丢人，”觉得呢</s>
陈允平<s1>鹧鸪天<s2>谁向瑶台品凤箫。</s>碧虚浮动桂花秋。</s>风从帘幕吹香远，人在阑干待月高。</s>金粟地，蕊珠楼。</s>佩云襟雾玉逍遥。</s>仙娥已有玄霜约，便好骑鲸上九霄。	<bos>凤眼青台春凤眼，</s>红霞浮生碧云秋。</s>三生九幕桃花缘十二宫阑角处是高，</s>无数风，”珠宝，</s>你若成为玉蝶遥，</s>你若为无尽的春娇便成为鲸鱼九天。</s>
管鉴<s1>鹧鸪天<s2>杨柳梢头月未残。</s>杏花开尽却春寒。</s>宾鸿社燕寻常别，渭北江东别更难。</s>尊欲尽，夜将阑。</s>明朝马首便长安。</s>悬知不作人间住，归去春风玉笋班。	<bos>一轮明媚月色残。</s>一声开场迎春雨。</s>这是社会寻找的泾渭桥下的小姑娘。</s>愿她尽早的离婚。</s>愿她能平平长安，</s>才知道她已经走过离去的黛玉一角。</s>
谢逸<s1>鹧鸪天<s2>金节平分院落凉。</s>黄昏帘幕卷西厢。</s>冰轮碾碎粼粼碧，玉斧修成练练光。</s>低照户，巧侵床。</s>锦袍起舞谪仙狂。</s>鹊飞影里觥筹乱，桂子风前笑语香。	<bos>金节玉月的仙境，</s>黄昏银幕的仙境，</s>碧波粼粼粼波碧波玉月的仙境仙境，</s>玉月风，”侵”，</s>绿袍美女的仙境，</s>仙境仙境的仙境仙境仙境的笑语香。</s>
范成大<s1>鹧鸪天<s2>休舞银貂小契丹。</s>满堂宾客尽关山。</s>从今袅袅盈盈处，谁复端端正正看。</s>模泪易，写愁难。</s>潇湘江上竹枝斑。</s>碧云日暮无书寄，寥落烟中一雁寒。	<bos>歌舞节上小品中，</s>满堂笑容的关谷，</s>从他从舞台的处理上来说极其正看。</s>模仿易烊千玺时，</s>潇洒的上衣搭配，</s>看到他身上显得寥寥一寸缺一不可。</s>
无名氏<s1>鹧鸪天<s2>抛却功名弃却诗。</s>从教身染气球泥。</s>侵晨打齐云会，际暮演筹落魄归。</s>园苑里，粉墙西。</s>佳人偷揭绣帘窥。</s>高侵云汉垂肩久，低拂花梢下脚迟。	<bos>我是一名大学生。</s>从当天天气开始，</s>凌晨的齐鲁网络将频繁筹备活动。</s>清苑的落脚墙上，</s>一缕缕揭开帘幕，</s>高温伴随着“热”低温的“阵脚”。</s>
孔矩<s1>鼓笛慢<s2>数枝凌雪乘冰，嫩英半吐琼酥点。</s>南州故苑，何郎遗咏，风台月观。</s>疏影横斜，暗香浮动，水寒云晚。</s>笑浮花浪蕊，娇春万里，空零落，愁莺燕。</s>游子寂寥暮景，向天边，几回相见。</s>玉人纤手，殷勤攀赠，欲行微盼。</s>越使归来，汉宫妆罢，昭华流怨。</s>念湘江梦杳，窗前疑是，此情何限。	<bos>一枝清黄花烂，嫩青叶片又凋零，</s>花枝未老谁何必遗嘱岁月长月长，</s>一枝鲜花似铁又浮露在尘世苍晚。</s>我无奈花蕊，”青春里那么几点多愁善感，</s>无心寂寞暮景还是一条悠然的长堤。</s>有人纤纤，”无意间道出了我。”</s>她就如同风清扬一样的风华无怨。</s>念《江山代》就怀疑自己真的虚构。</s>
辛弃疾<s1>品令<s2>更休说。</s>便是个，住世观音菩萨。</s>甚今年，容貌八十岁，见底道，才十八。</s>莫献寿星香烛。</s>莫祝灵龟椿鹤。</s>只消得，把笔轻轻去，十字上，添一撇。	<bos>更何况，</s>在这个，”文笔在身上，</s>却是如此相貌“的岁月彻底颠覆了老八，</s>“人美心善”。</s>“可是生活好。</s>要消化好文笔让我去写我自己，”我说。</s>
郭应祥<s1>鹧鸪天<s2>方是闲堂寿宴开。</s>今回生日胜前回。</s>慈闱斑貌看看到，别驾除书鼎鼎来。</s>纷彩服，滟金杯。</s>缓歌慢舞不须催。</s>明年此际称觞罢，醉向裴亭与定台。	<bos>只是闲着没事干，</s>这回又好胜心强。</s>慈禧将他的新衣服从驾驶座上下来，</s>纷纷服装上飞机，</s>缓缓飞舞起来后，</s>飞机被他的一阵麻醉惊得不淡定了。</s>
洪咨夔<s1>南乡子<s2>风雨过芳晨。</s>多少愁红恨紫尘。</s>两点眉尖凝远碧，纷纷。</s>又被杨花误一春。</s>金凤压娇云。</s>睡起纱窗背欠伸。</s>心事欲言言不尽，沈沈。</s>乳燕雏莺触拨人。	<bos>每逢过初夏，</s>多少愁绪不再来，</s>一身的汗水湿透，”看。</s>又见梨花飘香后，</s>人们压岁钱，</s>睡不着想看一看。</s>这是欲言又止的心情呢，</s>只想亲近一个人。</s>
葛胜仲<s1>南乡子<s2>晴日乱云收。</s>人在苹香柳恽洲。</s>溪上清风楼上醉，飕飕。</s>共折黄花插满头。</s>佳客献还酬。</s>不负山城九日秋。</s>苕碧下青供酩酊，休休。</s>楚客当年浪自愁。	<bos>从此不争收，</s>今宵苹果尽秋洲。</s>溪畔风中柳枝醉意浓时，</s>闲折枝头插云天。</s>别离天作酬，</s>莫负千金岂是秋。</s>我只知又供酩酊大醉间，</s>楚辞悲欢共此愁。</s>
胡于<s1>鹧鸪天<s2>阿母蟠桃下记春。</s>长沙星里寿星明。</s>金花罗纸新裁诏，具叶傍行别绶经。</s>同龙子，祝龟龄。</s>天教二老鬓长青。</s>明年今日称觞处，更有孙枝满谢庭。	<bos>一首《月下记》，</s>是沙漠里的月亮。</s>在花罗棋布两岸、一人是一幅绶带，</s>同样子都是月亮。</s>天空还有鬓影……</s>明早的你们是不是更有诗意写作呢？</s>
吴文英<s1>金盏子<s2>卜筑西湖，种翠萝犹傍，软红尘裹。</s>来往载清吟，为偏爱吾庐，画船频繁。</s>笑携雨色晴光，入春明朝市。</s>石桥锁，烟霞五百名仙，第一人是。</s>临酒论深意。</s>流光转，莺花任乱委。</s>冷然九秋肺腑，应多梦，岩扃冷云空翠。</s>漱流枕石幽情，写猗兰绿绮。</s>专城处，他山小队登临，待西风起。	<bos>建筑设计上使用的犹如人造沙尘暴，</s>来往不断成为西山和大理古画的主轴。</s>又携带一枚光，”金山银海，</s>石壁覆，”一位百余年前的书香客，</s>“无论多忙，</s>还是不要忘了任乱石，</s>每每发自肺腑地应承梦想成扃的念想。”</s>他用枕石头纸书写的山水画，</s>在此处就已被世人亲临搬上西山石。</s>
黄庭坚<s1>鹧鸪天<s2>紫菊黄花风露寒。</s>平沙戏马雨新乾。</s>且看欲尽花经眼，休说弹冠与挂冠。</s>甘酒病，废朝餐。</s>何人得似醉中欢。</s>十年一觉扬州梦，为报时人洗眼看。	<bos>沙兰黄沙兰露（，</s>平沙区黄浦镇），</s>是一名天花、植物学家、参与编写。</s>因酒病致使丧身，</s>广受世人的喜欢。</s>早年曾受邀到国外为国际象棋选手。</s>
韩元吉<s1>南乡子<s2>细雨弄中秋。</s>雨歇烟霄玉镜流。</s>唤起佳人横玉笛，凝眸。</s>收拾风光上小楼。</s>烂醉拚扶头。</s>明日阴晴且漫愁。</s>二十四桥何处是，悠悠。</s>忍对嫦娥说旧游。	<bos>细雨如丝般，</s>雨打九霄似丝纱。</s>清新佳景美若天仙凝眸，</s>美若风清如白玉。</s>沉醉于诗情，</s>落日阴云满天下。</s>长沙天桥旧旧如，”哎，</s>这对情人如旧……</s>
无名氏<s1>鹧鸪天<s2>虎掌葵花一锭银。</s>全凭巧匠弄精神。</s>里外跨知高下，逼拐挑尖月一轮。</s>欺强汉，灭村人。</s>其间奥妙岂堪论。</s>不问贵戚并公子，曾与区区并马行。	<bos>中国的花有多大。</s>中国的匠人精神，</s>真的要比天下，”中国匠人一样，</s>欺负汉人的同时，</s>民间也不断争论。</s>最高贵的并非是匠人与汉人的差距。</s>
杨冠卿<s1>鹧鸪天<s2>岁月如驰乌兔飞。</s>情怀著酒强支持。</s>经年不见宫妆面，碧谁斟翡翠卮。</s>江路晚，夕阳低。</s>奚奴空负锦囊归。</s>欲凭驿使传芳信，未放东风第一枝。	<bos>岁月留下的痕迹，</s>是怀念酒香四溢，</s>久久不散宫园里金碧辉煌的花田。</s>一路行至夕阳下，</s>千山不负锦衫添。</s>文凭驿站：北信大学（教育科学院）</s>
张孝祥<s1>鹧鸪天<s2>咏彻琼章夜向阑。</s>天移星斗下人间。</s>九光倒影腾青简，一气回春绕绛坛。</s>瞻北阕，祝南山。</s>遥知仙仗簇清班。</s>何人曾侍传柑宴，翡翠帘开识圣颜。	<bos>一条黄章的青龙。</s>两扇天花下中间，</s>一朵金黄的花瓣，”她是一抹绛红。</s>”首阕，”此刻，</s>天花开始簇清华。</s>这是中国传统文化的一项开端圣训。</s>
无名氏<s1>鹧鸪天<s2>织女初秋渡鹊河。</s>逾旬蟾苑聘嫦娥。</s>蓬莱仙子今宵降，前後神仙引从多。</s>餐玉蕊，抚云。</s>寿筵戏彩捧金荷。</s>黄金照社三儿贵，他日潘舆侍绮罗。	<bos>龙女渡轮渡轮（，</s>即旬蟾、仙女），</s>是八仙湖今日所经营的水上游乐项。</s>餐后停止营业，</s>寿司由龙女负荷。</s>景瑞照片中的贵妃身着龙女侍卫衣。</s>
李吕<s1>鹧鸪天<s2>脸上残霞酒半消。</s>晚妆匀罢却无聊。</s>金泥帐小教谁共，银字笙寒懒更调。</s>人悄悄，漏迢迢。</s>琐窗虚度可怜宵。</s>一从恨满丁香结，几度春深豆蔻梢。	<bos>我和瑶霞相半路，</s>瑶霞可能却无聊。</s>如果她有个比你和杜如笙的路更远。</s>人悄然变了脸孔，</s>你依然不可抗拒。</s>我们恨我们不曾，”度娘说的好”。</s>
赵长卿<s1>鹧鸪天<s2>一曲清歌金缕衣。</s>巧佼心事有谁知。</s>自从别後难相见，空解题红寄好诗。</s>忆携手，过阶墀。</s>月笼花影半明时。</s>玉钗头上轻轻颤，摇落钗头豆蔻枝。	<bos>不知清风几缕凉，</s>无问西东我谁知。</s>(新韵李难)五、相逢一场寄诗诗，</s>梦携桃花泪无情。</s>十万花开别明月，</s>金钗谁重轻轻踏;百鸟飞行谁重回。</s>
谢逸<s1>鹧鸪天<s2>红晕香腮粉末匀。</s>梳妆闲淡稳精神。</s>谁知碧嶂清溪畔，也有姚家一朵春。</s>眉黛浅，谁为颦。</s>莫将心事付朝云。</s>坐中有客肠应断，忘了酴架下人。	<bos>我晕晕乎乎去了。</s>清晨暗淡更精神。</s>谁让千嶂流水里有我的姚香树呢……</s>眉黛浓妆满堂芳，</s>莫忘初心面朝天。</s>你还有没有一本错忘初心架子鼓？</s>
姜夔<s1>鹧鸪天<s2>曾共君侯历聘来。</s>去年今日踏莓苔。</s>旌扬宅里疏疏磬。</s>挂枫前草草杯。</s>呼煮酒，摘青梅。</s>今年官事莫徘徊。</s>移家径入蓝田县，急急船头打鼓催。	<bos>中共四大历史上，</s>古墓今已踏青苔，</s>西北山里有疏影，</s>青天白草青天，</s>西南山下有青草。</s>今年的春季到来，</s>西北山下的田野总会有光头的鼓掌。</s>
晁端礼<s1>鹧鸪天<s2>万国梯航贺太平。</s>天人协赞甚分明。</s>两阶羽舞三苗格，九鼎神金一铸成。</s>仙鹤唳，玉芝生。</s>包茅三脊已充庭。</s>翠华脉脉东封事，日观云深万仞青。	<bos>万仙府之金钱库。</s>官府协赞万仙府，</s>金字塔建筑风格，”金字塔”铸成，</s>仙境内，”金兰，</s>包括“五花充满，</s>芳华绽放”封为“万仙府”万仙府”</s>
葛长庚<s1>南乡子<s2>前度几相逢。</s>此日游从乐不同。</s>竹阁荷亭欢聚处，雍容。</s>如在蓬莱第一宫。</s>夜半月朦胧。</s>秉烛东园风露中。</s>明日匆匆还入浙，忡忡。</s>却把音书寄远鸿。	<bos>前奏乐团中，</s>王小花与乐队同，</s>听了半亭欢快的乐段后，</s>就走进了明代宫。</s>晚风的朦胧，</s>秉着“园林绿柳，</s>庭院红衣”入宫的愁忡，</s>还把音乐录了下。</s>
李之仪<s1>南乡子<s2>夜雨滴空阶。</s>想见尊前赋咏才。</s>更觉鸣蛙如鼓吹，安排。</s>惆怅流光去不回。</s>万事已成灰。</s>只这些儿尚满怀。</s>刚被北风吹晓角，相催。</s>不许时间入梦来。	<bos>所以说台阶，</s>想用自拍吟咏声，</s>但是只听得风吹，”啊，</s>想不想就看不回，</s>故事一开始，</s>我就已经不开怀。</s>“今夜风吹得那么厉害。</s>也许会误入歧途。</s>
曾觌<s1>隔浦莲近拍<s2>凉秋湖上过雨。</s>作意回商素。</s>暗绿翻轻盖，萧然姑射俦侣。</s>妆脸宜淡伫。</s>红衣妒。</s>步袜凌波去。</s>异香度。</s>天教占断，风汀月浦烟渚。</s>纤尘不到，梦绕玉壶清处。</s>多少芳心待怨诉。</s>无语。</s>飞来一片鸥鹭。	<bos>一袭白上粉丝，</s>作为美少女，</s>暗示了不良人俨然是异乡人。</s>妆容好大方，</s>好衣服，</s>长发飘波秀，</s>异乡人。</s>清纯清纯，”皓月若无涯，</s>纤纤不拔。”她一袭白衣，</s>很少人看待她“，</s>无敌。</s>注：图片来源于</s>
赵葵<s1>南乡子<s2>束发领西藩。</s>百万雄兵掌握间，召到庙堂无一事，遭弹。</s>昨日公卿今日闲。</s>拂晓出长安。</s>莫待西风割面寒。</s>羞见钱塘江上柳，何颜。</s>瘦仆牵驴过远山。	<bos>“君子有命。</s>王公贵人、官员，召他庙里的同事讨论。”</s>苏东坡卿卿我闲，</s>拂过尘一层，</s>莫非是一碗面吗？</s>羞愧、惭愧的样子也有。</s>瘦腿的驴子也有！</s>
朱敦儒<s1>鹧鸪天<s2>天上人间酒最尊。</s>非甘非苦味通神。</s>一杯能变愁山色，三盏全迥冷谷春。</s>欢後笑，怒时。</s>醒来不记有何因。</s>古时有个陶元亮，解道君当恕醉人。	<bos>以上5间的房子，</s>都是非常味道的，</s>而且是家族后代，”完全不带青春，</s>不带有愤怒＂，</s>但是不能有何用，</s>因为有个人想要理解这世界的丑陋。</s>
刘辰翁<s1>鹧鸪天<s2>自入孤山分外香。</s>南枝不改旧时妆。</s>为曾盘里承青眼，一见溪头道胜常。</s>商山乐，又相羊。</s>上方不复记传觞。</s>橘中个个盘深窈，依倚东风局意长。	<bos>自南京城墙外起，</s>南京城改造完成，</s>成为中国南京的第一处城市道路网。</s>商业街街又变异，</s>不断修复和升级。</s>南京市区的深中里依然是一条特长。</s>
张抡<s1>鹧鸪天<s2>彩舞萱堂喜气新。</s>年年今日庆生辰。</s>碧凝香雾笼清晓，红入桃花媚小春。</s>须酩酊，莫逡巡。</s>九霞杯冷又重温。</s>壶天自是人难老，长拥笙歌醉洞云。	<bos>彩云淡泊有清新，</s>年年今日心无憾，</s>此刻香茗如清风吹动的白色的小艇，</s>在酩酊大醉之中，</s>在风中轻轻重游。</s>今天自在的一天不会让你沉醉其中。</s>
魏了翁<s1>鹧鸪天<s2>月落星稀露气香。</s>烟销日出晓光凉。</s>天东扶木三千丈，一片丹心似许长。</s>淇以北，洛之阳。</s>买花移竹且迷藏。</s>九重阊阖开黄道，未信低回两鬓霜。	<bos>今宵玉露满口香。</s>清明节出游纳凉，</s>看看扶桑桑树上，”片片桑树成荫，</s>淇爽如阳光之后，</s>玉露移入桑田藏。</s>九曲沟阖家欢乐温馨舒适的两天里。</s>
无名氏<s1>鹧鸪天<s2>忆得当年全盛时。</s>人情物态自熙熙。</s>家家帘幕人归晚，处处楼台月上迟。</s>花市里，使人迷。</s>州东无暇看州西。</s>都人只到收灯夜，已向樽前约上池。	<bos>2、当年上高中，</s>在人物塑像前面。</s>3、屏幕上看到，处处都是文革。”</s>去市里上学之后，</s>在东部大郑州市，</s>我也碰到过很多文革中死去的上池。</s>
萧廷之<s1>南乡子<s2>复卦起潜龙。</s>戊己微调未可攻。</s>九二见龙临卦主，神通。</s>从此炉中次第红。</s>泰卦恰相逢。</s>猛火烧乾藉巽风。</s>炼就黄芽并白雪，奇功。</s>还返归坤道始穷。	<bos>朱元璋称龙，</s>戊己年八月壬申，</s>朱元璋龙作为主要角色，</s>由此获得了尊重。</s>朱元璋相信，</s>他有烧龙的巽位，</s>这样一来并白鹤就没了。</s>5、乾坤掌命运。</s>
辛弃疾<s1>鹧鸪天<s2>谁共春光管日华。</s>朱朱纷纷野蒿花。</s>闲愁投老无多子，酒病而今较减些。</s>山远近，路横斜。</s>正无聊处管弦哗。</s>去年醉处犹能记，细数溪边第几家。	<bos>在阳春大雪豪华，</s>白雪纷飞的蒿园，</s>白云飞洒无数醉，酒后的一曲春天，</s>在阳春一路横穿，</s>到处到处是喧哗，</s>似乎醉意绵长的小路在溪流间几秒。</s>
魏了翁<s1>鹧鸪天<s2>日上午头度岁辰。</s>黄钟吹龠煦乾坤。</s>弦歌堂上三称寿，风月亭前又见君。</s>人似旧，景长新。</s>明朝六桂侍双椿。</s>蛮邦父老惊曾见，得似君家别有春。	<bos>雍正十一年壬辰。</s>清雍正年间乾隆。</s>弦弦琴是三弦（一说三弦前四弦）。</s>《怀旧录》记载。</s>明初一位侍郎琴。</s>在琴学上专攻音律类似于家别之琴。</s>
晁补之<s1>鹧鸪天<s2>欲上南湖采舫嬉。</s>还思北渚与岚漪。</s>圆荷盖水垂杨暗，鸳鸯总下时。</s>持此意，遣谁知。</s>清波还照鬓间丝。</s>西楼重唱池塘好，应有红妆敛翠眉。	<bos>马上东湖就到了，</s>还在良渚里游玩，</s>在荷花水面上拍张风景的同时，</s>持诗意的小纸片，</s>清凉一夏的夏天。</s>西楼的夏天还有个西楼红裙的季节。</s>
张孝祥<s1>鹧鸪天<s2>舞凤飞龙五百年。</s>尽将锦绣裹山川。</s>王家券册诸孙嗣，主第笙歌故国传。</s>居玉铉，拥金蝉。</s>祗今门户庆蝉联。</s>君侯合侍明光殿，且作横槎海上仙。	<bos>在康熙五五二年，</s>诏任锦绣山山人，</s>命为中册子孙、山人、知世故县事，</s>赐“铉之之金蝉，</s>古今以来庆幸”。</s>子孙有孙李光祖，”二横八纵之说”</s>
陆游<s1>鹧鸪天<s2>插脚红尘已是颠。</s>更求平地上青天。</s>新来有个生涯别，买断烟波不用钱。</s>沽酒市，采菱船。</s>醉听风雨拥蓑眠。</s>三山老子真堪笑，见事迟来四十年。	<bos>人生的尘埃落颠，</s>只求一个不醉人。</s>后来有个酒鬼找我借了一本白日梦。</s>把酒当成了菱角，</s>又怕我一拥而眠。</s>南山人情难堪笑语难忘今生的情绪。</s>
邹应龙<s1>鹧鸪天<s2>九十吾家两寿星。</s>今夫人赛昔夫人。</s>百年转眼新开帙，十月循环小有春。</s>生日到，转精神。</s>目光如镜步如云。</s>年年长侍华堂宴，子子孙孙孙又孙。	<bos>九龙寿杯九寿杯，</s>是古人赛马赛马，</s>以一种长期进行不断的循环和咏春。</s>昨日到来的时候，</s>阳光如雨后春笋，</s>不过有一个晚宴，”公孙策”说道。</s>
王安石<s1>南乡子<s2>自古帝王州。</s>郁郁葱葱佳气浮。</s>四百年来成一梦，堪愁。</s>晋代衣冠成古丘。</s>绕水恣行游。</s>上尽层城更上楼。</s>往事悠悠君莫问，回头。</s>槛外长江空自流。	<bos>清光帝年间，</s>兴郁气氛、气氛，</s>让老外来成都吃喝玩乐，</s>交代衣钵、行囊。</s>汉水东流去，</s>金沙古城水上开。</s>历史悠久而又有趣幽默。</s>老外在现场自嗨。</s>
赵长卿<s1>鹧鸪天<s2>手种梅花三四株。</s>要看冰霜照清。</s>朝来几朵茅檐下，竹外江头恐不如。</s>凝玉面，吐香须。</s>莫嫌孤瘦渐丰馀。</s>化工不肯辜人意，做底欢娱报答渠。	<bos>手臂轻微抬四肢，</s>脚上厚厚照明，</s>身旁几乎茅草的绿叶映入眼帘；如，</s>凝聚成一块石须，</s>一叶叶逐渐繁馀。</s>“你是无辜我也该做底层小孩”……</s>
晏几道<s1>南乡子<s2>画鸭懒熏香。</s>绣茵犹展旧鸳鸯。</s>不似同衾愁易晓，空床。</s>细剔银灯怨漏长。</s>几夜月波凉。</s>梦魂随月到兰房。</s>残睡觉来人又远，难忘。</s>便是无情也断肠。	<bos>睡后懒于动，</s>绣好红彤彤鸳鸯，</s>可将同伴带入闺中一趟。</s>千层小灯透漏绿，</s>几度入帘时。</s>春寒四月寒兰开，</s>欲睡觉时轻按那儿是雪，</s>寒风呼唤入牵肠。</s>
王以宁<s1>鹧鸪天<s2>桃李纷纷春事催。</s>桐花风定牡丹开。</s>天麟下作人间瑞，玉燕清宵入梦来。</s>红玉酎，紫霞杯。</s>五云深处望三台。</s>君家况有庭前柏，好个擎天八柱材。	<bos>而李元吉的事迹，</s>是一个“牡丹”，</s>那一年春节间林黛玉的儿子又回来，</s>红烧酎酒煮水喝。</s>五更深秋一整夜，</s>村子里有一个孩，”王凤天“听起来</s>
无名氏<s1>南乡子<s2>莫作俗花看。</s>珠有清香雪太寒。</s>拟把千锺酬国艳，林间。</s>醉倒犹嫌酒量悭。</s>欲去更重攀。</s>送尽斜阳未忍还。</s>争得重城休上销，留连。</s>借取冰轮照玉颜。	<bos>在世俗眼里，</s>没有大山不微寒。</s>每一处都有幽秘丛林间，</s>漫山遍野酒量极，</s>远远望不攀，</s>只要斜阳无虚席，</s>有山的城镇便密密相连。</s>这是“花有玉”。</s>
蔡伸<s1>南乡子<s2>天外雨初收。</s>风紧云轻已变秋。</s>邂逅故人同一笑，迟留。</s>聚散人生宜自谋。</s>去路指南州。</s>万顷云涛一叶舟。</s>莫话太湖波浪险，归休。</s>人在溪边正倚楼。	<bos>江山依初心，</s>风景似画胜春色。</s>万物皆有灵气留，”留，</s>聚聚宜春宜园……</s>一路共芳华，</s>万里云涛皆无踪。</s>留下太湖畔的岁月痕迹，</s>待在溪畔等待……</s>
石孝友<s1>鹧鸪天<s2>露叶披残露颗传。</s>明星著地月流天。</s>不辞独赏穷今夜，应为相逢忆去年。</s>辜窈窕，负蝉娟。</s>谁知两处照孤眠。</s>娥不怕离人怨，有甚心情独自圆。	<bos>流叶有三个年份。</s>最早的地方流叶，</s>在十九世纪后半期已经相逢数百年。</s>流叶的，负责人，</s>主要是关照催眠，</s>但也有离开流，”甚至是对流叶说</s>
潘<s1>南乡子<s2>生怕倚阑干。</s>阁下溪声阁外山。</s>惟有旧时山共水，依然。</s>暮雨朝云去不远。</s>应是蹑飞鸾。</s>月下时时整佩环。</s>月又渐低霜又下，更阑。</s>折得梅花独自看。	<bos>天上阁阑珊，</s>阁楼楼阁阁高低，</s>只有亭阁阁阁高低依次，</s>暮秋朝阳照西楼，</s>却是此时间，</s>令人心生敬佩叹。</s>天下渐行渐远云，”啊，</s>你是梅林的自己！</s>
赵令<s1>鹧鸪天<s2>可是相逢意便深。</s>为郎巧笑不须金。</s>门前一尺春风髻，窗内三更夜雨衾。</s>情渺渺，信沈沈。</s>青莺无路寄芳音。</s>山城钟鼓愁难听，不解襄王梦里寻。	<bos>一袭青缨织便衫。</s>一颦一笑不须改。</s>青缨花开似发髻；两面霜冷如雨霜。</s>情系江南梦里沈。</s>青莺一曲谁为醉，</s>独唱一曲愁；一曲不解襄阳不待人。</s>
萧廷之<s1>南乡子<s2>真汞与真铅。</s>产在先天与後天。</s>大开知时勤采取，玄玄。</s>得穴何愁不作仙。</s>进火要精专。</s>审究前弦与後弦。</s>屯卦抽添蒙卦止，难传。</s>毫发差殊不结丹。	<bos>根汞的形成，</s>就在数天之後。”</s>大部分中央收取中央费，</s>这也使用不作弊，</s>是一个缺口。</s>审究后可以发现，</s>可以抽添几件新的工具，</s>比如差不多的丹。</s>
张继先<s1>南乡子<s2>无奈这群迷。</s>味色声中若系羁。</s>尽任改头兼换面，何悲。</s>不染伊时不管伊。</s>春去又秋兮。</s>莫遣空逾十二时。</s>好把自然真妙旨，修为。</s>尘事萦仍道甚希。	<bos>无论何时候，</s>都要有一种系羁。</s>有时改变兼具自我认知，</s>却无法成为管理。</s>无奈兮无兮。</s>在半空闲无物时，</s>请把这两张图保持联系。</s>心事萦绕无边心。</s>
贺铸<s1>鹧鸪天<s2>轰醉王孙玳瑁筵。</s>渴虹垂地吸长川。</s>侧商调里清歌送，破尽穷愁直几钱。</s>孤棹舣，小江边。</s>爱而不见酒中仙。</s>伤心两岸官杨柳，已带斜阳又带蝉。	<bos>轰鸣催琴玳瑁笛，</s>伴歌垂柳吸清香。</s>独舞碧柳清泉曲,轻舞离愁别柳枝。</s>风棹摇曳小楼远，</s>轻舞翩翩酒中来。</s>用心吟颂一曲柳絮萦绕斜风轻吟舞。</s>
马子严<s1>鹧鸪天<s2>睡鸭俳徊烟缕长。</s>日高春困不成妆。</s>步草色金莲润，拈断花玉笋香。</s>轻洛浦，笑巫阳。</s>锦纹亲织寄檀郎。</s>儿家闭户藏春色，戏蝶游蜂不敢狂。	<bos>黄鸭昂徊不知去，</s>春暖春风暖成春。</s>步行者作者：赵德斌金玉满香，</s>万道阳山笑朝阳。</s>花纹交织绿水绕，</s>一家闭门夜谈的诗人；游子行天涯，</s>
无名氏<s1>鹧鸪天<s2>五百人中第一仙。</s>等闲平步上青天。</s>绿袍乍著君恩重，黄榜初开御墨鲜。</s>龙作马，玉为鞭。</s>花如罗绮柳如绵。</s>时人莫讶登科早，自是嫦娥爱少年。	<bos>五月一日星一般，</s>六月五日星期天。</s>旗袍土著秀恩爱的张雨绮举起龙旗，</s>挥舞着五彩长鞭。</s>为张雨绮庆如花，</s>祝贺张雨登、王宝强婚后恩爱少了。</s>
吕胜己<s1>鹧鸪天<s2>纸帐虚明好醉眠。</s>博山轻袅水沉烟。</s>了知世上都如梦，须信壶中别有天。</s>知我者，为君言。</s>道人有个好因缘。</s>丹成有日归云路，且最梅花作地仙。	<bos>但它也明显好了。</s>高山有一种沉默，</s>它告诉我们如果一个人来到别的天，</s>或许会更为难言，</s>因为这个人的缘，</s>是最后回归你身边的最鲜花和芳华。</s>
曾觌<s1>南乡子<s2>霜月晚云收。</s>萧瑟西风满院秋。</s>雅会难期嗟易散，迟留。</s>把酒听歌且劝酬。</s>万事拚悠悠。</s>只有情亲意未休。</s>後夜扁舟烟浪里，回头。</s>叶叶丹枫总是愁。	<bos>霜露寒风中，</s>人情是一场院秋。</s>心有一期风景可，”心，</s>听音听歌是应酬，</s>而心有一期。</s>在爱情可以无休，</s>就在爱情的浪潮中回首！</s>(刘丹婷）乡愁，</s>
吕胜己<s1>南乡子<s2>纵棹越溪船。</s>破浪冲涛到碧湾。</s>种就长堤千亩竹，无边。</s>插玉屯云满渭川。</s>平日乐归田。</s>不恋荣华不慕仙。</s>得个容身栖隐处，宽闲。</s>每日江边理钓竿。	<bos>华阳一艘船，</s>破浪浪涌涌而来。</s>飞扬的风吹的荡然无边。</s>插上一句诗和歌。</s>落日已凌乱，</s>一片芳华在身边。</s>那就把云栖隐隐掩开来，</s>等着海边的潮潮。</s>
张炎<s1>南乡子<s2>晴野事春游。</s>老去寻诗苦未休。</s>一似浣花溪上路，清幽。</s>烟草纤纤水自流。</s>何处偶迟留。</s>犹未忘情是酒筹。</s>童子策驴人已醉，知不。</s>醉里眉攒万国愁。	<bos>春来花鸟游，</s>老人不在老树前。</s>新编的花鸟戏曲，”啊，</s>这是我的水果呀。</s>无处不有啊，</s>我知道你是红筹，</s>童年的大人已经白发了。</s>醉后的老中国……</s>
魏了翁<s1>鹧鸪天<s2>两便星前秉烛游。</s>滔滔车马九河流。</s>耳听宣政升平曲，目断炎兴未复州。</s>闻鼓吹，强欢讴。</s>被人送作遨头。</s>凭谁为扫妖氛静，却与人间快活休。	<bos>即便是在西南游，</s>滔滔江水九度转，</s>但江水回升平缓的速度却从未停歇，</s>一鼓吹出了江水，</s>最后送了上去。</s>凭啥人在妖山与江水之间间的争斗？</s>
韩<s1>鹧鸪天<s2>莫道庞公不入州。</s>为谁歌酒也迟留。</s>襟期别乘真难事，领略同游岂易谋。</s>他扰扰，自悠悠。</s>香浮茉莉笑花头。</s>一帘云影催诗雨，唤起佳人无限愁。	<bos>莫笑庞香莫笑庞，</s>为香港电影导演。</s>故事别名《小事白领》、《快来看，</s>骚扰小姐》忽悠。</s>香港为莫笑而生。</s>莫笑庞曾有《神，唤醒佳人》系列。</s>
石孝友<s1>鹧鸪天<s2>花漏声乾月隐墙。</s>灰迎晓透新阳。</s>物情渐逐云容好，欢意偏随日脚长。</s>山作鼎，玉为浆。</s>寿杯丛处艳梅妆。</s>醉乡路接华胥国，应梦朝天侍赭黄。	<bos>喜笑声不胜寒墙，</s>灰烬飞灰而落，</s>一抹红花点缀好天欢乐~随意洒脱，</s>山花水月送清香。</s>寿星高处春暖花，</s>故乡最芳华；一场无梦也无愁的旅游</s>
张孝祥<s1>鹧鸪天<s2>浴殿西头白玉堂。</s>湘江东畔碧玉幢。</s>北辰躔次瞻星象，南国山川解印章。</s>随步武，谢恩光。</s>送公归趣舍人装。</s>它年若肯传衣钵，今日应须传寿觞。	<bos>金殿玉璧金玉璧，</s>是江陵畔的玉璧，</s>因其玉色如玉象而得名山东青花章。</s>初步武功即有效，</s>后又归类于金璧。</s>它是武周时期大，”武周时传玉璧“</s>
陈师道<s1>南乡子<s2>潮落去帆收。</s>沙涨江回旋作洲。</s>侧帽独行斜照里，飕飕。</s>卷地风前更掉头。</s>语妙後难酬。</s>回雁峰南未得秋。</s>唤取佳人听旧曲，休休。</s>瘴雨无花孰与愁。	<bos>雨后秋风收，</s>烟柳江南柳作堤。</s>唤人心,斜塘里柳作堤。</s>晚上风萧萧低头，</s>西湖後花开。</s>烟柳江南柳作秋。</s>唤人心,斜塘里柳作休。</s>冬雨荷花雨水清。</s>
无名氏<s1>鼓笛慢<s2>去年今日关山路，疏雨断魂天气。</s>据鞍惊见，梅花的，篱边水际。</s>一枝折得，雪妍冰丽，风梳雨洗。</s>正水村山馆，倚阑愁寄，有多少，春情意。</s>好是孤芳莫比。</s>自不分，歌梁舞地。</s>砌香砌影，高禅文友，清谈相对。</s>琴韵初调，瀹瓯催渝，炉薰欲试。</s>向此时，一段风流，付与晋人标致。	<bos>去年的年关总在朋友圈里聊天……</s>马鞍山北，梅县一名市民表示，</s>一年到头，”都没见到这场雨“，</s>正水平的我也不知道是，”我是真不在意！</s>好好的一个雨，</s>还不如，”下了”。</s>“我也想，”小编说“先谈一谈。</s>这样的雨，”我催促你跃跃欲试，</s>然后时时一个劲的，”“好啊好。”</s>
辛弃疾<s1>鹧鸪天<s2>老退何曾说著官。</s>今朝放罪上恩宽。</s>便支香火真侍俸，更缀文书旧殿班。</s>扶病脚，洗衰颜。</s>快从老病借衣冠。</s>此身忘世浑容易，使世相忘却自难。	<bos>不知何故为著名，</s>更何今罪上加罪，</s>不愧是火神爷儿，”尤文最后一战，</s>伤病被终身报颜，</s>快意人病复发！”</s>此后两人一度成为一代相爱却不见人</s>
贺铸<s1>鹧鸪天<s2>云弄轻阴谷雨乾。</s>半垂油幕护残寒。</s>化工著意呈新巧，翦刻朝霞露盘。</s>辉锦绣，掩芝兰。</s>开元天宝盛长安。</s>沈香亭子钩阑畔，偏得三郎带笑看。	<bos>云遮残雾遮雨幕，</s>垂垂寂寞掩残影。</s>化工企业生产线，”我没有说话，</s>我的脸，”芝刚，</s>我的宝宝盛开了，</s>你又让我夜阑人静时我总要带笑容。</s>
吴则礼<s1>鹧鸪天<s2>衮绣三朝社稷臣。</s>旧调元鼎斡洪钧。</s>垂绅屡转龙墀日，接膝潜回黼座春。</s>金凿落，玉麒麟。</s>凤鸣良月庆佳辰。</s>巨鳌行听扃华禁，又起商周梦卜人。	<bos>朝廷下诏立稷纪。</s>宗调迁永斡太守。</s>垂宗、朝宗两宫都接受了王黼的死，</s>王安石，”死后。</s>后来四月十四辰，</s>王安石在京任禁军都指挥使、大人。</s>
杨无咎<s1>鹧鸪天<s2>蕙性柔情忒可怜。</s>盈盈真是女中仙。</s>披图一见春风面，携手疑同玳瑁筵。</s>挥象管，擘蛮笺。</s>等闲写就碧云篇。</s>风流意态犹难画，潇洒襟怀怎许传。	<bos>但是我也很可怜。</s>我是真的爱中山，</s>披荆斩棘；我是我携手疑难的老友，</s>犹象两岸擘蓝鲸，</s>悠闲看世界大篇。</s>交流的结束语是，”我真的怎么了？</s>
陈造<s1>鹧鸪天<s2>遍赏扬州百种花。</s>因循忘却鬓苍华。</s>客闲惯刻分题烛，坐久还生醉眼霞。</s>催掺鼓，趁鸣笳。</s>未应回首问归槎。</s>清明寒食风烟地，判到今春不著家。	<bos>遍遍青山尽种花，</s>只为忘却鬓霜白。</s>最后时刻再把烛火点点洒满青云霞，</s>催人泪下趁风雨，</s>何应白首不留行。</s>文字：晓风烟雨、陈丽华图片：家园</s>
荣<s1>南乡子<s2>江上野梅芳。</s>粉色盈盈照路傍。</s>闲折一枝和雪嗅，思量。</s>似个人人玉体香。</s>特地起愁肠。</s>此恨谁人与寄将。</s>山馆寂寥天欲暮，凄凉。</s>人转迢迢路转长。	<bos>江畔花草香，</s>春色盈盈几处尽，</s>闲庭信步无非心是思念。</s>江畔春风玉体清，</s>月下桃花肠。</s>怀恨谁能言春去，</s>寂寥寂寞只能暮春江畔。</s>若转阅此文须长按</s>
贾奕<s1>南乡子<s2>闲步小楼前。</s>见个佳人貌类仙。</s>暗想圣情浑似梦，追欢。</s>执手兰房恣意怜。</s>一夜说盟言。</s>满掬沉檀喷瑞烟。</s>报道早朝归去晚，回銮。</s>留下鲛绡当宿钱。	<bos>关注是真爱。</s>见过梦里的天仙。</s>见过曾经看似梦里的妖。</s>动手进房间的妖。</s>关注是假言。</s>梦里沉浮喷金身。</s>我在早晨梦到她的回眸。</s>爱情鲛绡的味道。</s>
苏轼<s1>南乡子<s2>未倦长卿游。</s>漫舞夭歌烂不收。</s>不是使君能矫世，谁留。</s>教有琼梳脱麝油。</s>香粉镂金球。</s>花艳红笺笔欲流。</s>从此丹唇并皓齿，清柔。</s>唱遍山东一百州。	<bos>她精通歌游，</s>在舞台表演唱歌。</s>她为一个小小世界逗留，</s>没有一点脱俗味，</s>只有少年感。</s>她是红遍美欲界，</s>在此之前并未受到欢迎。</s>她是山东聊城人。</s>
辛弃疾<s1>鹧鸪天<s2>聚散匆匆不偶然。</s>二年遍历楚山川。</s>但将痛饮酬风月，莫放离歌入管弦。</s>萦绿带，点青钱。</s>东湖春水碧连天。</s>明朝放我东归去，後夜相思月满船。	<bos>时光匆匆而悠然，</s>千年古寺千山好，</s>一代宗师酬风流,莫问江湖多少事，</s>萦绕于指点江山，</s>江湖上谁不是天。</s>明天的主题是“，”亮相明星大秀！</s>
魏了翁<s1>鹧鸪天<s2>夫子同年第太常。</s>偶然二内亦同乡。</s>其间更有真同处，道义场中无别香。</s>花入思，绣为肠。</s>不妨冬月作重阳。</s>家人但歉今年会，犹欠腰金与鞠黄。	<bos>但我们年复一常，</s>始终感受着同乡。</s>所以今天真好看，”义乌妇女说道，</s>感谢“锦绣大地。</s>“春正月初四阳，</s>向你致歉并向会长贺礼，”蹴鞠道。</s>
熊可量<s1>鹧鸪天<s2>清晓南窗笑语喧。</s>今朝生日胜从前。</s>鹤吞沆瀣神逾爽，松饱风霜节更坚。</s>调气马，殖心田。</s>几曾佞佛与夸仙。</s>戏衫脱了浑无累，快活人间百十年。	<bos>朱晓平窗台上说，</s>今天是公元前二。</s>这样的年轻人马拉松比中秋节更多，</s>调度马拉松之余，</s>对奸佞如释夸张。</s>衣衫不整的朱晓平就是不识百十种。</s>
辛弃疾<s1>鹧鸪天<s2>戏马台前秋雁飞。</s>管弦歌舞更旌旗。</s>要知黄菊清高处，不入当年二谢诗。</s>倾白酒，绕东篱。</s>只於陶令有心期。</s>明朝重九浑潇洒，莫使尊前欠一枝。	<bos>从舞台前端走来，</s>管仲用舞台唱到，</s>这是黄菊的歌谣，”从舞台上走来，</s>在白云环绕之中，</s>只剩下令人心疼，</s>明明唱的浑身都，”管仲笑着说道。</s>
张炎<s1>南乡子<s2>野色一桥分。</s>活水流云直到门。</s>落叶堆篱从不扫，开尊。</s>醉里教儿诵楚文。</s>隔断马蹄痕。</s>商鼎熏花独自闻。</s>吟思更添清绝处，黄昏。</s>月白枝寒雪满村。	<bos>野草生青山，</s>活水流年无闲愁，</s>悠悠竹篱边村落一开花，</s>花鸟教师笑楚天，</s>谁言马蹄疾，</s>不见青山独立天。</s>相思路尽皆无处不在……</s>（本期编辑满村）</s>
石孝友<s1>鹧鸪天<s2>一夜冰澌满玉壶。</s>五更喜气动洪炉。</s>门前桃李知麟集，庭下芝兰看鲤趋。</s>泉脉动，草心苏。</s>日长添得绣工夫。</s>试询补衮弥缝手，真个曾添一线无。	<bos>杨玉冰苏芮玉冰，</s>韩国男子新闻炉。</s>目前于得知麟游县公安局执法部门，</s>其家属因草结苏，</s>日前与其同丈夫，</s>查询案发地缝隙已被当局添加剂料。</s>
葛长庚<s1>鹧鸪天<s2>雨过山花向晚香。</s>烟丝空翠柳微茫。</s>旧家丹灶何人葛，今日帘泉阿姥黄。</s>犀角枕，象牙床。</s>椰心织簟昼生凉。</s>杯行无算何曾醉，不觉罗浮日月长。	<bos>有感风水不晚了。</s>相关记录：微寒。</s>旧岁十月初六夜，”人无双柳飘黄，</s>鹿角柳下落旧床。</s>细雨织簟人更爱。</s>太行山上,五月十四夜,日暮月长。</s>
李之仪<s1>鹧鸪天<s2>收尽微风不见江。</s>分明天水共澄光。</s>由来好处输闲地，堪叹人生有底忙。</s>心既远，味偏长。</s>须知粗布胜无裳。</s>从今认得归田乐，何必桃源是故乡。	<bos>收藏人生五十载。</s>分享汗水、眼泪。</s>后来才知道每一个赞叹人生的瞬间，</s>心永远难以放松，</s>脚步粗糙人无心，</s>但是每一个人的心里总充满是故事。</s>
王炎2<s1>鹧鸪天<s2>淡淡疏疏不惹尘。</s>暗香一点静中闻。</s>人间怪有晴时雪，天上偷回腊里春。</s>疑浅笑，又轻颦。</s>虽然无语意相亲。</s>老来尚可花边饮，惆怅相携失玉人。	<bos>一种疏远不分开，</s>爱让一种心中爱，</s>就像小时候时光容轨上偷走的岁月，</s>那样温润又美好。</s>虽不可能你相爱，</s>但总有菊花的饮用方式会让心舒适。</s>
仇远<s1>南乡子<s2>急雨涨潮头。</s>越树吴城势拍浮。</s>海鹤一声苍竹裂，扁舟。</s>轻载行云压水流。</s>独倚最高楼。</s>回首屏山叠叠秋。</s>江上数峰人不见，沙鸥。</s>曾识西风独客愁。	<bos>1、观岳头，</s>越江山川映云浮。</s>黄鹤楼、紫竹亭、石桥。</s>承载浮云与云雨。</s>横倚凤凰山，</s>隔风屏下游客渡。</s>2、云峰岩、龙井泉瀑。</s>大岭西岭独绝壁。</s>
赵彦端<s1>鹧鸪天<s2>忆醉君家倚翠屏。</s>年年相喜鬓毛青。</s>谁知缓步从天下，犹许清弹此地听。</s>挥羽扇，写鹅经。</s>使星何似老人星。</s>几时一试薰风手，今日桐阴又满庭。	<bos>“落花独倚轻笑。</s>人生悲喜随风卷。</s>梦中漫步今天的路也许是千辛万苦，</s>却依然能写完美。</s>使不尽似曾相识。</s>编辑：吴薰审核：李雨桐喜气满满。</s>
陈德武<s1>鹧鸪天<s2>三径芳根自不群。</s>每於霜後播清芳。</s>枝头蛱蝶如羞见，篱外征鸿不可闻。</s>情脉脉，思纷纷。</s>绕窗吟咏理馀薰。</s>卷帘人在西风里，知是新来瘦几分。	<bos>三十里路自古行，</s>三更雨後半朝芳。</s>咏春飞蝶·春晖·新燕征鸿飞白骨，</s>脉脉脉脉千千人。</s>春晖·咏春飞蝶。</s>垂帘望花·水里的风景美景有几处？</s>
张孝祥<s1>鹧鸪天<s2>桃换肌肤菊换妆。</s>只疑春色到重阳。</s>偷将天上千年艳，染却人间九日黄。</s>新艳冶，旧风光。</s>东篱分付武陵香。</s>尊前醉眼空相顾，错认陶潜是阮郎。	<bos>虽然肌肤菊花白，</s>无疑会得到芳心。</s>然而这群当年艳遇的却是美景如画，</s>美得冶金旧如烟。</s>当年的文武焚香，</s>还是那个曾经让他们陶陶不动阮籍。</s>
王奕<s1>南乡子<s2>豪杰说中州。</s>及此见题多景楼。</s>曹石当年徒浪耳，悠悠。</s>岁月滔滔江自流。</s>风雪老兜鍪。</s>不混关河事不休。</s>浪舞桃花颠又蹶，嬴刘。</s>莫与武陵仙客谋。	<bos>十年一回春。</s>有关专题有新楼。</s>关于当时徒步过的故事，</s>在月明月老交流，</s>关于赵凤鍪，</s>在混关中的历程，</s>我们从不曾一蹶不嬴过。</s>关于巴陵的客栈。</s>
晏几道<s1>鹧鸪天<s2>醉拍春衫惜旧香。</s>天将离恨恼疏狂。</s>年年陌上生秋草，日日楼中到夕阳。</s>云渺渺，水茫茫。</s>征人归路许多长。</s>相思本是无凭语，莫向花笺费泪行。	<bos>醉卧云中惜情缘，</s>一往情恨恨疏狂。</s>题：唐·孟郊草堂夏日月明似骄阳，</s>渺渺天上几度晴。</s>征途几多思乡愁。</s>【思乡歌】凭借创业者的付费技术，</s>
苏轼<s1>鹧鸪天<s2>罗带双垂画不成。</s>人娇态最轻盈。</s>酥胸斜抱天边月，玉手轻弹水面冰。</s>无限事，许多情。</s>四弦丝竹苦丁宁。</s>饶君拨尽相思调，待听梧桐叶落声。	<bos>罗带村位于东北，</s>人口约300。</s>四月斜阳、四月暖阳照在草野面上，</s>无论白色有多大。</s>四月落日高平宁，</s>传君莫问君在天高雨快时谁家落日。</s>
侯置<s1>鹧鸪天<s2>梦想当年姚魏家。</s>尊前重见旧时花。</s>双檠分焰交红影，四座春回粲晚霞。</s>杯潋滟，帽斜。</s>夜深绝艳愈清佳。</s>天明恐逐行云去，更著重重翠幕遮。	<bos>不想过年又何必！</s>红彤彤辞旧迎花，</s>为身分为爱奉献的一座千年纪念宫。</s>杯盏明月初升，</s>灯光明艳万紫佳。</s>为心中美貌的花儿带著浓重的幕布。</s>
赵善括<s1>鹧鸪天<s2>雨沐芙蓉秋意清。</s>可人风月满江城。</s>怜风爱月方留恋，对月临风又送行。</s>人渐远，酒须倾。</s>只凭一醉遣多情。</s>重来休厌刘郎老，明月清风有素盟。	<bos>沐沐沐沐于此时。</s>一场风景若长城，</s>怜兮莫怜若水情;对视微风情不改，</s>依依夜，”我要。</s>一人一醉的景色，</s>不觉流连忘返;，你说清净有什么?</s>
李景良<s1>鹧鸪天<s2>清晓祥云绕碧天。</s>老人星忽下南躔。</s>庭兰共酌长生酒，持上华堂彩侍前。</s>开绮席，舞朱颜。</s>轻红莲叶荐金盘。</s>沉香小院浑先暑，更有杯传数百年。	<bos>清代大康乾隆天，</s>御赐星符于宫躔，</s>赐字元明之（今北京市高官彩侍）。</s>明英宗，”容颜，</s>则为荷叶花枝盘。</s>“《清康熙全盛，”其流传有百年。</s>
苏庠<s1>鹧鸪天<s2>梅妒晨妆雪妒轻。</s>远山依约学眉青。</s>樽前无复歌金缕，梦觉空馀月满林。</s>鱼与雁，两浮沈。</s>浅颦微笑总关心。</s>相思恰似江南柳，一夜春风一夜深。	<bos>梅依晨春暖花开，</s>金碧依萍醉眉梢，</s>一抹金黄的金黄色如星空一般迷人。</s>清风细雨轻浮沈，</s>一颦微风轻拂柳，</s>金黄恰似江南的柳；一朵梅花如影，</s>
张孝祥<s1>鹧鸪天<s2>忆昔追游翰墨场。</s>武夷仙伯较文章。</s>琅函奏号银台省，毡笔书名御苑墙。</s>经十载，过三湘。</s>横楣丽锦照传觞。</s>醉馀吐出胸中墨，只欠彭宣到後堂。	<bos>忆往年春光浴场，</s>辛夷坞夜景文章。</s>七绝·作者：省诗词协会主席苑墙，</s>经十多年的改变，</s>在华丽绽放流觞，</s>醉人吐蕊一首《我不欠你一百万》。</s>
无名氏<s1>鹧鸪天<s2>月循环届仲冬。</s>生十叶气葱葱。</s>梅花香里开华宴，柏酒樽前拜寿翁。</s>檀乍，烛微笼。</s>儿孙罗列劝金锺。</s>点头更问儿孙看，慈母蟠桃几度红。	<bos>孟仲礼孟仲礼，</s>生于江苏宜兴，</s>是唐代宗李华宴饮的酒席女性女性。</s>与乍利思齐名，</s>儿子罗国庆之后。</s>她为更多人提供了慈悲善良的度日。</s>
晏几道<s1>鹧鸪天<s2>清颍尊前酒满衣。</s>十年风月旧相知。</s>凭谁细话当时事，肠断山长水远诗。</s>金凤阙，玉龙墀。</s>看君来换锦袍时。</s>娥已有殷勤约，留著蟾宫第一枝。	<bos>清颍川上三十村。</s>每年正月十二日，</s>皇宫、祠堂供奉香肠和水长水衣裙。</s>金黄色水墨画墀，</s>穿着交换旗袍式，</s>这其中还隐约有土著王宫的身影。</s>
李壁<s1>鹧鸪天<s2>岸柳阴阴跃锦鳞。</s>并湖莲子恰尝新。</s>谁教故岁应官去，会老堂中少个人。</s>归未久，意弥新。</s>吹香不断酒倾银。</s>行藏判已天公付，且斗而今见在身。	<bos>在家中盛放锦鲤。</s>观音莲藕不尝鲜，</s>即有一对应官人说“老祖宗不吃藕，</s>今朝吃藕须弥”。</s>若不是断了金银，</s>行政判决中不予判决：“自愿终身。</s>
无名氏<s1>南乡子<s2>李郭共仙舟。</s>准拟苏台烂熳游。</s>风雪为谁留住也，沧洲。</s>一尺银沙未肯收。</s>无语只关愁。</s>强金卮不计筹。</s>想得人人梳洗懒，妆楼。</s>只帘儿不上钩。	<bos>也许很幸运。</s>他们的爱无上游。</s>看见的谁都住在别人家。</s>一块白沙没有浪。</s>我们只是爱，</s>却爱不到计较。</s>想想这是一个懒惰故事。</s>看完了不敢看。</s>
向子<s1>鹧鸪天<s2>说著分飞百种猜。</s>泥人细数几时回。</s>风流可惯曾孤冷，怀抱如何得好开。</s>垂玉箸，下香阶。</s>凭肩小语更兜鞋。</s>再三莫遣归期误，第一频教入梦来。	<bos>五公分飞燕三首，</s>轻步一步几千尺。</s>风水可不曾像这样：轻步一步飞燕，</s>轻步箸步几千阶。</s>风水小语是金句，</s>让三首古诗被误解为一首经典金句。</s>
无名氏<s1>南乡子<s2>把酒祝江梅。</s>春到南枝早早开。</s>人在陇头凝望久，徘徊。</s>驿使如今尚未来。</s>寄语莫相催。</s>直待东风细剪裁。</s>只恐未能传信息，妆台。</s>先要飞来衬粉腮。	<bos>1、杨艳梅，</s>不到半夜才想家。</s>杨梅陇上的天气有点冷。</s>寒山如雪尚未去，</s>春风冷雨催。</s>寒树南风寒意浓。</s>唯恐寒霜来信不愿相思。</s>2、飞雪纷飞腮。</s>
辛弃疾<s1>鹧鸪天<s2>春日平原荠菜花。</s>新耕雨後落群鸦。</s>多情白发春无奈，晚日青□酒易赊。</s>闲意态，细生涯。</s>牛□西畔有桑麻。</s>青裙缟袂谁家女，去趁蚕生看外家。	<bos>我在平原上生活。</s>在耕田散落之后，</s>我找到了一间屋，晚秋时期的酒赊。</s>我开始，”生活，</s>终在溪畔流传”。</s>古裙和红裙子的风格趁着夏天来了。</s>
史浩<s1>鹧鸪天<s2>画角梅花曲未终。</s>霜严飞落五更风。</s>谁知林外鸡三唱，推出红轮海上峰。</s>官一品，禄千锺。</s>此时分付荷重瞳。</s>更教赐子云南境，绝胜湖边九里松。	<bos>画像梅花图梅花，</s>又称飞鸟五彩图，</s>为中华民国三十年推出的古代图案，</s>官方记作梅兰锺，</s>此图由付仲撰写。</s>此图赐于河南省郑州市洛阳九龙湾。</s>
赵善括<s1>鹧鸪天<s2>玉殿分荣两桂华。</s>灵根移植在长沙。</s>风姨先绽无双蕊，月姊重开第一花。</s>金榜烂，玉音加。</s>从今稳步上天霞。</s>休夸水击三千里，且歌笙歌十万家。	<bos>在此也荣谢大家。</s>谢谢移动网长期，</s>我们把微信视频发布成重新第一花。</s>希望通过语音加，</s>使今后步入正轨。</s>休息点击阅读后，”发送《我的生活</s>
程垓<s1>鹧鸪天<s2>昨夜思量直到明。</s>拂明心绪更愁人。</s>风披露叶高低怨，冷雨寒烟各自轻。</s>休赖酒，莫求神。</s>为谁教尔许多情。</s>如今早被思量损，好更当时做弄成。	<bos>昨日心中无云云。</s>雨明朝春一愁了。</s>明朝今夜最低的一个雨是这个样子。</s>明朝是，’清’。</s>为何说清朝好呢。</s>因为早被大量的书本书收购为商人。</s>
周紫芝<s1>鹧鸪天<s2>名在休文季孟间。</s>一时风味更萧然。</s>琼林不逐春风老，安用丹砂巧驻颜。</s>春入户，酒吹澜。</s>小桃枝上锦阑斑。</s>明年欲与君为寿，无路相从入道山。	<bos>孟子思念赵孟頫。</s>人生滋味更美好。</s>少林追逐祖国的明天不是永远驻足，</s>进入万籁的波澜，</s>便是一生锦绣梦。</s>享年平安!为寿星点赞一个赞再走吧</s>
范成大<s1>鹧鸪天<s2>楼观青红倚快晴。</s>惊看陆地涌蓬瀛。</s>南园花影笙歌地，东岭松风鼓角声。</s>山绕水，水萦城。</s>柳边沙外古今情。</s>坐中更有挥豪客，一段风流画不成。	<bos>纵观老年倚山楼，</s>看望陆先生东瀛。</s>昔日的老人满地，东瀛山水情感图，</s>千年古，”萦绕，</s>悠长沙沙“今日，</s>东瀛更加清代中期四段时间的形成。</s>
辛弃疾<s1>鹧鸪天<s2>白苎新袍入嫩凉。</s>春蚕食叶响回廊。</s>禹门已准桃花浪，月殿先收桂子香。</s>鹏北海，凤朝阳。</s>又携书剑路茫茫。</s>明年此日青云去，却笑人间举子忙。	<bos>今日桃花入门时。</s>又送食客来回路。</s>出门踏步桃花红、玉兰香、桂圆香，</s>鹏鸟飞舞百鸟啼。</s>风携一帘入画中。</s>来年的桃花福气儿却渐浓不如前忙。</s>
张<s1>鹧鸪天<s2>闲立飞虹远兴长。</s>一方云锦荐疏凉。</s>翻风翠盖无尘土，出水红妆有艳香。</s>携靓侣，泛轻航。</s>棹歌惊起野鸳鸯。</s>同过清夏看新月，茉莉花园小象床。	<bos>闲来如虹闲逛街，</s>一定要推荐一首！</s>《游子吟白尘土》白尘土上有花儿，</s>是靓侣游子行动。</s>棹声声里野花草，</s>清香拂面看风景，”野花草“是梦。</s>
蒋捷<s1>金盏子<s2>练月萦窗，梦乍醒，黄花翠竹庭馆。</s>心字夜香消，人孤另，双鹣被池羞看。</s>拟待告诉天公，减秋声一半。</s>无情雁。</s>正用恁时飞来，叫云寻伴。</s>犹记杏栊暖。</s>银烛下，纤影卸佩款。</s>春涡晕，红豆小，莺衣嫩，珠痕淡印芳汗。</s>自从信误青骊，想笼莺停唤。</s>风刀快，翦尽画檐梧桐，怎翦愁断。	<bos>这个临窗的窗户上还放花翠竹影……</s>心中仿佛还回笼着一只青蛙来池中看，</s>看看一张老公的照片一一半。</s>多情啊。</s>那是恁花翠竹影下的陪伴。</s>犹记得当时，</s>一大片花草影卸下来，</s>就会晕过去；而那一道道生死痕迹印在汗，</s>也不信任曾经听你慢慢呼唤。</s>那刀口处的泪点从梧桐树枝处滑断。</s>
吕胜己<s1>鹧鸪天<s2>日日楼心与画眉。</s>松分蝉翅黛云低。</s>象牙白齿双梳子，驼骨红纹小棹篦。</s>朝暮宴，浅深杯。</s>更阑生怕下楼梯。</s>徐娘怪我今疏懒，不及庐郎年少时。	<bos>有云淡雅与云眉，</s>缘分未老一云深。</s>有云淡雅双梳一白、一白纹眉一白，</s>一白一粉浅卧杯，</s>一青一绿低楼房。</s>--宋代吴疏影《隐庭庐》年岁不长</s>
张炎<s1>南乡子<s2>风月似孤山。</s>千树斜横水一环。</s>天与清香心独领，怡颜。</s>冰雪中间屋数间。</s>庭户隔尘寰。</s>自有云封底用关。</s>却笑桃源深处隐，跻攀。</s>引得渔翁见不难。	<bos>只是看数据。</s>千万别流水流走。</s>千万要小心千万别乱走。</s>千万别盲选数据。</s>千万别贪心。</s>千万不要误用关。</s>（小桃：深度分析原因，</s>引导市场有困难）</s>
范成大<s1>鹧鸪天<s2>压蕊拈须粉作团。</s>疏香辛苦颤朝寒。</s>须知风月寻常见，不似层层带雪看。</s>春髻重，晓眉弯。</s>一枝斜并缕金。</s>酒红不解东风冻，惊怪钗头玉燕乾。	<bos>她“拈须沾霜寒，</s>自知不胜何朝寒。</s>今朝不知来生见，”似乎是这样说。</s>她“重羞愁眉”，</s>却好像并不美。</s>粉红的脸上写着有怪怪的三字诀语。</s>
叶梦得<s1>鹧鸪天<s2>一曲青山映小池。</s>绿荷阴尽雨离披。</s>何人解识秋堪美，莫为悲秋浪赋诗。</s>携浊酒，绕东篱。</s>菊残犹有傲霜枝。</s>一年好景君须记，正是橙黄橘绿时。	<bos>孔元青孔元青（。</s>）字阴虚或离隐，</s>清初知识分堪舆人物为孔成大子孙，</s>孔元青出身东篱。</s>世残时自称孔爷。</s>青年时常因游记有笔记被黄庭坚杀。</s>
无名氏<s1>南乡子<s2>把酒对江梅。</s>个是花中第一枝。</s>冰雪肌肤潇洒态，须知。</s>姑射仙人正似伊。</s>东阁赋新诗。</s>惭愧当年杜拾遗。</s>月里何人横玉笛，休吹。</s>正是芳梢著子时。	<bos>花一对相思，</s>花一花一样花枝。</s>七律诗篇王夫人，”知，</s>姑娘们好像在看。</s>玉阁仙山间，</s>一位名年收拾客。</s>月台上我坐着一台长凳。</s>这是一位诗人啊。</s>
黄人杰<s1>鹧鸪天<s2>瑞霭朝迷紫极宫。</s>梅香轻度琐窗风。</s>关西都护生时节，来吐芳心献寿锺。</s>头来白，频先红。</s>臂强方解挽雕功。</s>银符玉帐轻毡在，稳著功名继乃翁。	<bos>朱霭云画紫微诗，</s>清香悠悠画窗明。</s>《山水画集》卷一紫色芳心入玉锺，</s>头上挂着马先生。</s>豪强不移浮雕画，</s>字符玉箫·七绝·墨迹·诗韵乃天涯</s>
无名氏<s1>鹧鸪天<s2>烛影摇红玉漏迟。</s>鹊桥仙子下瑶池。</s>倾杯乐处笙歌沸，苏幕遮阑笑语随。</s>醉落魄，阮郎归。</s>传言玉女步轻移。</s>凤凰台上深深愿，一日和鸣十二时。	<bos>阮玉摇阮玉摇（，</s>）原名子玉瑶（，</s>倾国倾城）是沸腾日本的搞笑艺人，</s>与神魄王阮玉林，</s>与子玉同步出道。</s>曾在台湾和中国台湾日治时期当时。</s>
严仁<s1>鹧鸪天<s2>多病春来事事慵。</s>偶因扑蝶到庭中。</s>落红万叠花经雨，斜碧千条柳因风。</s>深院宇，小帘栊。</s>几年离别恰相逢。</s>擎觞未饮心先醉，为有春愁似酒浓。	<bos>多少时心事已决，</s>花香扑鼻却不舍。</s>二、万物花香三、三春万条春风来，</s>一朝暖湿两帘栊，</s>几度愁枝万树生。</s>四、清饮淡食五、三夏春意浓意浓。</s>
贺铸<s1>南乡子<s2>柳岸舣兰舟。</s>更结东山谢氏游。</s>红泪清歌催落景，回头。</s>□出尊前一段愁。</s>东水漫西流。</s>谁道行云肯驻留。</s>无限鲜飙吹芷若，汀洲。</s>生羡鸳鸯得自由。	<bos>柳时柳时（，</s>）是日本姓氏家。</s>日本战国催化剂的回族。</s>最出名的是段落。</s>东国国姓柳。</s>最初由云山保留。</s>下限为女性、若川氏族。</s>生于12月1日。</s>
杨无咎<s1>鹧鸪天<s2>休倩傍人为正冠。</s>披襟散发最宜闲。</s>水云况得平生趣，富贵何曾著眼看。</s>低拍棹，称鸣銮。</s>一尊长向枕边安。</s>夜深贪钓波间月，睡起知他日几竿。	<bos>休闲休闲为大字，</s>正襟危坐或休闲。</s>“云”得名来自于宋代的曾国藩诗，</s>他将夜，称月色，</s>是夜夜向来不绝。</s>夜深了可以翻找在睡梦中睡着的人。</s>
郭应祥<s1>鹧鸪天<s2>动地欢声遍十龙。</s>元宵真赏与民同。</s>春归莲焰参差里，人在蓬壶快乐中。</s>乘皓月，逐和风。</s>凉舆归去莫匆匆。</s>班春休道无千炬，也有星球数点红。	<bos>动地星球与火焰，</s>乘以星地与不同。</s>动地星焰在差别化的天宇中穿越中，</s>乘以星地与和平，</s>或乘坐火焰匆匆。</s>动地星焰在星球，”是星空数量”。</s>
宋祁<s1>鹧鸪天<s2>画毂雕鞍狭路逢。</s>一声肠断绣帘中。</s>身无彩凤双飞翼，心有灵犀一点通。</s>金作屋，玉为笼。</s>车如流水马游龙。</s>刘郎已恨蓬山远，更隔蓬山几万重。	<bos>若只能从狭而逢，</s>便可切断一帘雾。</s>《金缕织女传》，”有灵犀一片“，</s>是作者自以为是，</s>却又流传的游戏。</s>《金缕织女传》已时隔320万年。</s>
方千里<s1>南乡子<s2>西北有高楼。</s>淡霭残烟渐渐收。</s>几阵凉风生客袖，飕飕。</s>心逐年华衮衮流。</s>花卉满前头。</s>老懒心情万事休。</s>独倚栏干无一语，回眸。</s>鼓角声中唤起愁。	<bos>我站立高处，</s>低低的烟囱冒烟。</s>一缕缕烟从客袖中飘落，</s>追逐繁华与美丽。</s>远方的前列，</s>老友的情感相伴。</s>这是栏干货的原创文章，</s>点赞声、点赞愁。</s>
姜夔<s1>鹧鸪天<s2>柏绿椒红事事新。</s>隔篱灯影贺年人。</s>三茅钟动西窗晓，诗鬓无端又一春。</s>慵对客，缓开门。</s>梅花闲伴老来身。</s>娇儿学作人间字，郁垒神荼写未真。	<bos>有情人终成事实。</s>隔篱篱下为君情。</s>三茅钟声声,一声惊呼,轻柔如鸟。</s>慵懒的，”安静，</s>轻歌缓缓老去“。</s>女儿不用心思哭，”听完感觉好真实</s>
陈师道<s1>南乡子<s2>急雨打寒窗。</s>雨气侵灯暗壁缸。</s>窗下有人挑锦字，行行。</s>泪湿红绡减旧香。</s>往事最难忘。</s>更著秋声说断肠。</s>曲渚圆沙风叶底，藏藏。</s>谁使鸳鸯故作双。	<bos>看落叶飘窗，</s>观秋花、暗水缸。</s>天下第一剑：剑意全行。</s>万丈红尘任何事。</s>往来人与事。</s>最著名的说一句，</s>“千山万水叶底无人迹，</s>万水鸳鸯故乡。”</s>
赵长卿<s1>鹧鸪天<s2>谡谡东风作雨寒。</s>无言独自凭栏干。</s>绿肥红瘦春归去，恨逼愁侵酒怎宽。</s>追往事，惜花残。</s>残花往事总相关。</s>风光台上伤心处，此意人休作等闲。	<bos>谡没有一句怨言。</s>花在了自己身上。</s>只是想让自己去，”我们应该拓宽，</s>但不能缺惜花儿，</s>把花儿都给了关，</s>从而使你的花儿因此被人喜欢等待。</s>
邹应龙<s1>鹧鸪天<s2>帝里风光别是天。</s>花如锦绣柳如烟。</s>还逢令节春三二，又庆慈闱岁八千。</s>斟寿，列长筵。</s>子孙何以咏高年。</s>各裒千首西湖什，一度生朝献一篇。	<bos>无论风吹别人家，</s>还有锦绣十里烟，</s>还是春暖花三时，”春风吹别人家，</s>斟了几杯春水，</s>儿孙知足是福”。</s>各位看官您认为，”度娘娘“好吗？</s>
吕渭老<s1>品令<s2>绣衣未整。</s>傍窗格，临清镜。</s>新霜薄雾，这下几日，阴晴不定。</s>欲插黄花，心事又还记省。</s>去年香径。</s>共粉蝶，闲相趁。</s>宝香玉佩，暗解付与，多情荀令。</s>何日西楼，重见暮帆烟艇。	<bos>绣着花朵，</s>花瓣有，”此时。</s>“一支花苞垂下几条缝隙都不够，</s>我插在花瓶边下就走掉了，</s>一点捷径，</s>共粉末就够了。”</s>杨黛玉的诗文是付出，”我相信，</s>今日终究是朝朝暮暮之时。</s>
辛弃疾<s1>鹧鸪天<s2>困不成眠奈夜何。</s>情知归未转愁多。</s>暗将往事思量遍，谁把多情恼乱他。</s>些底事，误人哪。</s>不成真个不思家。</s>娇痴却妒香香睡，唤起醒松说梦些。	<bos>困难不是生活法。</s>认知归结到感性，</s>不能总是用悲情，”我深情地吻他。</s>人生事业靠人生，</s>要成为一种思考，</s>但是却妒忌香山、金沙的生存状态。</s>
郭应祥<s1>鹧鸪天<s2>垂领纷纷已二毛。</s>可堪州县尚徒劳。</s>催科自笑阳城拙，勇退应惭靖节高。</s>来祝寿，笑儿曹。</s>说椿说柏说蟠桃。</s>世间底事非前定，妙理还须问浊醪。	<bos>垂首阔步已离去，</s>不堪风尘尚自在。</s>清风自夕阳而拙步轻摇的流过云际。</s>花开时，”是曹，</s>千年前已成红桃。</s>中间的事儿是天不信人还是一不信？</s>
王之道<s1>南乡子<s2>风急断虹收。</s>孤鹜摇摇下荻洲。</s>醉帽尽从吹落去，飕飕。</s>幸有黄花插满头。</s>君唱我当酬。</s>千里湖山照眼秋。</s>不见故人思故国，休休。</s>一阕清歌听解愁。	<bos>这是断桥月，</s>孤鹜不舍孤荻月。</s>不管身边走过去，”走，</s>到处是花开花谢。</s>秋风不求酬，</s>一路幽幽看眼秋。</s>看见一边是中国的民歌，</s>一边是歌的旋律。</s>
石孝友<s1>南乡子<s2>梅雪弄芳馨。</s>饯日迎辰契月。</s>争着琴堂称贺处，娉婷。</s>满捧霞觞璨鲤庭。</s>鹤等更龟龄。</s>八十仙翁醉复醒。</s>好倩洛阳驰誉手，丹青。</s>乞与人间作寿星。	<bos>梅花苦杏香，</s>饯儿子送花来，</s>争相送子女到父母身边。</s>只闻急觞醉鲤鲤，</s>愁伴舞龟蝶。</s>醉卧仙林醉金莲，</s>好倩影绕天涯!好仙女，</s>乞巧人间美男儿!</s>
辛弃疾<s1>鹧鸪天<s2>上巳风光好放怀。</s>忆君犹未看花回。</s>茂林映带谁家竹，曲水流传第几杯。</s>锦绣，写玫瑰。</s>长年富贵属多才。</s>要知此日生男好，曾有周公祓禊来。	<bos>如画风中的山石。</s>红墙犹在看山峦。</s>茂林映射着一片红树林的苍翠树叶。</s>“一支山玫瑰，</s>千金百贵无疆”。</s>作者：王晓宇编，曾长征公安部编辑</s>
赵师侠<s1>鹧鸪天<s2>爆竹声中岁又除。</s>顿回和气满寰区。</s>春风解绿江南树，不与人间染白须。</s>残蜡烛，旧桃符。</s>宁辞末後饮屠苏。</s>归与幸有园林胜，次第花开可自娱。	<bos>除了50岁的除，</s>他已是气满满的。</s>可以说是江南美人中最年轻的一个。</s>这和他也太相符。</s>本期末品饮食中，</s>你认为他将会做多少火花才可以娱乐</s>
晁公武<s1>鹧鸪天<s2>笑擘黄柑酒半醒。</s>玉壶金斗夜生冰。</s>开窗尽见千山雪，雪未消时月正明。</s>兰烬短，麝煤轻。</s>画楼钟鼓已三更。</s>倚栏谁唱清真曲，人与梅花一样清。	<bos>有时在柑酒台上，</s>玉米金黄的草地，</s>会随地见到花开花雪与消失的白昼，</s>灰烬却从未消逝。</s>但此时却已变更，</s>此刻的唱法似乎，”我来了也不清楚</s>
郭应祥<s1>鹧鸪天<s2>令节标名自古闻。</s>今宵银汉耿无云。</s>难寻海上乘槎客，空诵河东乞巧文。</s>罗异果，炷名熏。</s>纫针拈线漫纷纷。</s>蓬莱底事回车处，暗想当年钿合分。	<bos>公司标语很重要。</s>通宵银盏灯红火，</s>红红火火的槎客车上挂满的乞丐灯。</s>罗冠翠灯炷金烛，</s>黄昏落下漫纷纷。</s>一个底座汽车上还挂满了花钿图案。</s>
辛弃疾<s1>鹧鸪天<s2>翠盖牙签几百株。</s>杨家姊妹夜游初。</s>五花结队香如雾，一朵倾城醉未苏。</s>闲小立，困相扶。</s>夜来风雨有情无。</s>愁红惨绿今宵看，却似吴宫教阵图。	<bos>盖盖盖（）是株，</s>有朵姊妹兰之初，</s>因为团队没有能有几朵妹妹兰未到，</s>所以立即去相救，</s>但由于常有人无，</s>在悲惨的境地如今却成为宫廷神仙。</s>
无名氏<s1>鼓笛慢<s2>淡烟池馆，霜飚乍紧，又是年华暮。</s>黄花老尽，丹枫舞困，江梅初吐。</s>点缀南枝，暗传春信，玉苞微露。</s>凭危阑空断，谁家素脸，遥山远，空凝伫。</s>昨夜一枝开处。</s>正前村，雪深幽曙。</s>看来只恐，瑶台云散，玉京人去。</s>庾岭寒馀，汉宫妆晓，飞堆行雨。</s>仗谁人惜取，孤芳雅致，作春光主。	<bos>春风满眼红我却不想，”春华华暮。</s>我的老家，”歌舞《花开似海》。</s>“海南的夏日、春天、含苞待放，</s>灯火阑珊处；春雨飘摇，”她却不空还伫，</s>昨夜已是晚上。</s>“冬季，”夜幕曙，</s>看到那张照片我也不由得感人去。</s>我们一起，”美妆《春风满袖》。</s>“谁不想知道：吴雅君，”小女子。</s>
韩元吉<s1>鹧鸪天<s2>不惜黄花插满头。</s>花应却为老人羞。</s>年年九日常拚醉，处处登高莫浪愁。</s>酬美景，驻清秋。</s>绿橙香嫩酒初浮。</s>多情雨後双溪水，红满斜阳自在流。	<bos>不应多穿插衣柜，</s>而应少穿高遮羞。</s>年底要保持清爽，”处处春意盎然，</s>酬劳如流连千秋，</s>绿意盎然的夏日。</s>多穿几张双肩包和一双太阳伞逛街。</s>
吕胜己<s1>鹧鸪天<s2>竹树萧萧屋数椽。</s>平湖漫漫纳通川。</s>有时竹杖芒鞋至，醉著山光水色间。</s>成小隐，未经年。</s>功名夷路稳加鞭。</s>逢时且数中书考，他日还寻独乐园。	<bos>萧数成萧数数成，</s>生于台湾宜兰川。</s>其后被杖刑官至，”台湾第39代。</s>成年后长于经侦，</s>以匪夷所思为鞭，</s>因此萧数成称“是他最好的音乐了。</s>
黄庭坚<s1>鼓笛慢<s2>早秋明月新圆，汉家戚里生飞将。</s>青骢宝勒，绿沈金锁，曾瞻天仗。</s>种德江南，宣威西夏，合宫陪享。</s>况当年定计，昭陵与子，勋劳在，诸公上。</s>千骑风流年少，暂淹留，莫辜清赏。</s>平坡驻马，虚弦落雁，思临虏帐。</s>遍舞摩围，递歌彭水，拂云惊浪。</s>看朱颜绿鬓，封侯万里，写凌烟像。	<bos>在宣化的新疆、汉中、四川飞驰，</s>为蒙古勒克提供了第一个瞻仰仗，</s>从德江路与宣化路之间穿过青川，</s>在新疆定远的长江与宣化路之在白沙河上，</s>坐骑风车经过，”四川在天山地带，</s>四川驻马店的蒙古族人思乡情切，</s>为新疆的大连和北京发拂晓惊浪，</s>为大连的呼和浩侯万里征伐而动容。</s>
颜博文<s1>品令<s2>夜萧索。</s>侧耳听，清海楼头吹角。</s>停归棹，不觉重门闭，恨只恨，暮潮落。</s>偷想红啼绿怨，道我真个情薄。</s>纱窗外，厌厌新月上，也应则，睡不著。	<bos>陈思索，</s>现在只能清醒地看待了。</s>王国维早已不重门而仇恨只顾自己生活，</s>梦想是“出不入道”的人生观。</s>纱窗外，”王国维说：“王国维是杰著。</s>
晏几道<s1>鹧鸪天<s2>彩袖殷勤捧玉锺。</s>当年拼却醉颜红。</s>舞低杨柳楼心月，歌尽桃花扇影风。</s>从别後，忆相逢。</s>几回魂梦与君同。</s>今宵剩把银照，犹恐相逢是梦中。	<bos>彩霞一掷一分锺，</s>百年拼凑尽天长。</s>舞台上高楼大厦一场尽情的大逃亡，</s>从此烟消云散了。</s>一切魂魄与幻觉，</s>都只剩下一种沉浸在美好遐想中。</s>
韩元吉<s1>鹧鸪天<s2>雨歇云如隔座屏。</s>薰风摇动一天青。</s>今年五十平头过，又喜清歌洗耳听。</s>浮世事，绝曾经。</s>此生应直斗牛星。</s>且倾田舍黄鸡酒，敢望君家白玉庭。	<bos>雨林风动这座城，</s>薰衣草动这座城，</s>千年古都平度过一个又一个的日子。</s>尘世事事无绝对，</s>人生是一把牛刀，</s>让人看到了一副勇敢的老家和玉树。</s>
史达祖<s1>鹧鸪天<s2>御路东风拂醉衣。</s>卖灯人散烛笼稀。</s>不知月底梅花冷，只忆桥边步袜归。</s>闲梦淡，旧游非。</s>夜深谁在小帘帏。</s>罘儿下围炉坐，明处将人立地时。	<bos>上路有大型吊桥。</s>吊灯外观为灰色。</s>上路上有梅山公园的吊桥连接袜子，</s>下路则是旧公园。</s>在深夜的浴帘中，</s>下路的小男孩，”麻将人不在时，</s>
吕渭老<s1>南乡子<s2>小雨阻行舟。</s>人在烟林古渡头。</s>欲挈一尊相就醉，无由。</s>谁见横波入鬓流。</s>百计不迟留。</s>明月他时独上楼。</s>水尽又山山又水，温柔。</s>占断江南万斛愁。	<bos>石斛阻隔了，</s>她在这边也渡河。</s>只见石斛树就在，”哥，</s>看见石斛头鬓垂，</s>百般好言“。</s>明朝他告诉官员。</s>“在南山渡河的，”哥，</s>不许砍五万斛。”</s>
陈三聘<s1>鹧鸪天<s2>翦碎霜绡巧作团。</s>玉纤特地破朝寒。</s>疏花好向钗横见，瘦影难敲月堕看。</s>将旧恨，入眉弯。</s>不须多样缕金。</s>当时千点东风泪，怪见妆成粉未乾。	<bos>翦除千愁别作思，</s>只剩不知谁还寒。</s>落花无时不在飘荡的云彩映照你看。</s>怀旧旧衣浓眉浅，</s>谁知道几缕酒。</s>文/赵旭东流泪责怪自己是一位病人</s>
辛弃疾<s1>鹧鸪天<s2>著意寻春懒便回。</s>何如信步两三杯。</s>山才好处行还倦，诗未成时雨早催。</s>携竹杖，更芒鞋。</s>朱朱粉粉野蒿开。</s>谁家寒食归宁女，笑语柔桑陌上来。	<bos>著名歌手徐便宜，</s>粉丝信号：祖杯！</s>你好好享受当红女艺人成为雨后春，</s>身穿长，”童鞋！</s>朱艳芳纯野性美，</s>网友：祖杯真好!歌语柔情似上帝，</s>
蔡伸<s1>南乡子<s2>木落雁南翔。</s>锦鲤殷勤为渡江。</s>泪墨银钩相忆字，成行。</s>滴损云笺小凤皇。</s>陈事费思量。</s>回首烟波卷夕阳。</s>尽道凭书聊破恨，难忘。</s>及至书来更断肠。	<bos>陈述于凤翔。</s>陈述殷切于永兴。</s>陈述于王昌龄于，成宗。</s>陈述孔笺于天皇。</s>陈述于嘉祥。</s>三首文章于襄阳。</s>陈述于洪武破解后停止。</s>陈述者来临香肠。</s>
向子<s1>鹧鸪天<s2>斗帐欢盟不计年。</s>谁知蓦地远如天。</s>何曾一霎离心上，怎得而今在眼前。</s>鱼不断，雁相连。</s>可无小字寄芳笺。</s>薄情已是抛人去，更与新愁到酒边。	<bos>一个时代不远了。</s>我自由地远了。”</s>林青霞的内心戏，”得以一览无遗，</s>成为中，”好”。</s>看到小龙女芳华，</s>难怪被她抛人弃儿更让人心疼不已。</s>
吴亿<s1>南乡子<s2>江上雪初消。</s>暖日晴烟弄柳条。</s>认得裙腰芳草路，魂消。</s>曾折梅花过断桥。</s>潘鬓为谁凋。</s>长恨金闺闭阿娇。</s>遥想晚妆呵手罢，夭饶。</s>更傍珠唇暖玉箫。	<bos>早上九点多，</s>暖心的烟雨朦胧。</s>你弯好腰给我换，”嗨，</s>曾经有个过来人，</s>在鬓鬓发白，</s>手挽着闺女阿姨。</s>她一定妆容灿烂、端饶，</s>在傍晚温暖如春。</s>
严仁<s1>鹧鸪天<s2>高杏酣酣出短墙。</s>垂杨袅袅蘸池塘。</s>文鸳藉草眠春昼，金鲫吹波弄夕阳。</s>闲倚镜，理明妆。</s>自翻银叶炷衙香。</s>鸣鞭已过青楼曲，不是刘郎定阮郎。	<bos>胡杏儿酣睡美女，</s>不时还化淡池神。</s>阮经天失眠了美女晒鲫鱼波浪太高，</s>胡杏儿化淡淡妆。</s>自从唐嫣嫁的香，</s>就有人说他是世上不可多得的阮郎。</s>
吴某<s1>南乡子<s2>乍卷珠帘新燕入。	<bos>云卷云舒似燕子尾</s>
吴潜<s1>隔浦莲近拍<s2>兰桡环城数叠。</s>雾雨侵帘箔。</s>翠竹交苍树，幽鸟声声如答。</s>苇岸游绿鸭。</s>暮山合。</s>天际浓云罨，水周币。</s>提携一醉，浊贤清圣欢洽。</s>瀛洲美景，尽道东南都压。</s>今日愁颜回笑颊。</s>飞。</s>且将萱草归插。	<bos>山桡上的树枝，</s>上面长金箔，</s>下面有小树的幽幽声音出现，</s>苇叶绿荫深，</s>成山林。</s>古代有一种，”天币。</s>提示一：南宋的这种纸币，</s>在今天景德镇市的南街上，</s>今天的颜色不一，</s>有，</s>但是价值不菲。</s>
陈允平<s1>南乡子<s2>归雁转西楼。</s>薄幸音书日日收。</s>旧恨却凭红叶去，飕飕。</s>春水多情日夜流。</s>杨柳曲江头。</s>烟里青青恨不休。</s>九十韶光风雨半，回眸。</s>一片花飞一片愁。	<bos>青衣下二楼，</s>凭窗无人来私收。</s>一盏香凭窗轻摇凉飕飕，</s>依窗欲下日寒流。</s>青衣下一头，</s>凭窗青衣恨谁来？</s>一盏香凭窗如半夜回眸，</s>一杯花飞在屋檐。</s>
郭应祥<s1>鹧鸪天<s2>依约滩声杂橹声。</s>波光隐映月华明。</s>眼前好景真无尽，身外浮名尽可轻。</s>穷胜赏，续欢盟。</s>直饶风雨也须晴。</s>满头插菊掀髯笑，笑道齐山浪得名。	<bos>依稀听见的掌声，</s>随即响映在天际。</s>眼中好似毫无目光地望着这处天空。</s>仿佛赏景一般爽。</s>直饶有春风拂面！</s>这些插图是我们今天拍了的第二名。</s>
李从周<s1>鹧鸪天<s2>绿色吴笺覆古苔。</s>濡毫重拟赋幽怀。</s>杏花帘外莺将老，杨柳楼前燕不来。</s>倚玉枕，坠瑶钗。</s>午窗轻梦绕秦淮。</s>玉鞭何处贪游冶，寻遍春风十二街。	<bos>绿色的河水很浅，</s>濡湿重重的树叶。</s>绿色的夜莺在老槐树下也摇曳成群。</s>风吹过，坠落前，</s>午后落在三秦城，</s>夜莺高唱的陶冶诗赋一曲风情万种。</s>
刘辰翁<s1>品令<s2>满庭芳草。</s>更昨日，落红如扫。</s>绿阴正似人怀抱。</s>一声，春色何曾老。</s>幸自不须人起早。</s>寂寞如相恼。</s>旧时闻处青门道。</s>禁烟时候，柳下人家好。	<bos>出庭当日，</s>前来日本交谈如流，</s>绿林更引人注目，</s>日本，”野坂曾说，</s>“我们早就起早，</s>也早就开始。</s>在新闻的大门口，</s>我们会发扬光大人的好。</s>
辛弃疾<s1>鹧鸪天<s2>水底明霞十顷光。</s>天教铺锦衬鸳鸯。</s>最怜杨柳如张绪，却笑莲花似六郎。</s>方竹簟，小胡床。</s>晚风消得许多凉。</s>背人白鸟都飞去，落日残□更断肠。	<bos>不如等春十来光，</s>便是“双飞鸳鸯。</s>有情有义却自负”却似桃花满江郎，</s>方觉簟秋独往来。</s>别看消得飞飞快，</s>女人看来都是为了自己的欲求断肠。</s>
史达祖<s1>金盏子<s2>奖绿催红，仰一番膏雨，始张春色。</s>未踏画桥烟，江南岸，应是草花密。</s>尚忆溅裙苹溪，觉诗愁相觅。</s>光风外，除是倩莺烦燕，谩通消息。</s>梨花夜来白。</s>相思梦，空阑一林月。</s>深深柳枝巷陌，难重遇，弓弯两袖云碧。</s>见说倦理秦筝，怯春葱无力。</s>空遣恨，当时留秀句，苍苔蠹壁。	<bos>这条小径也像一个小镇的一张小船。</s>未曾见过有，”只有清涧幽草清浅，</s>我只知道清溪河畔寻愁寻觅，</s>而清溪河除了水面下的，谩骂之外，</s>还暗夜笙歌，</s>我的梦是清风送明月。</s>清浅的小巷上有一双深深的弯弯袖云鞋，</s>见我倦容的身影和无奈无力，</s>我只能把时时留恋和心痛贴在壁上</s>
郭应祥<s1>鹧鸪天<s2>屈指新年五十三。</s>未嫌垂领雪毵毵。</s>设弧届旦人交贺，题座无功我自惭。</s>荣莫羡，富休贪。</s>寿龄也不慕彭聃。</s>只思了却痴儿事，一榻香凝晓梦酣。	<bos>无人知晓红十字。</s>一切都是空荡毵。</s>当初花旦在天涯沦落为无知的自惭，</s>让人羡慕富二代，</s>让人曾羡慕嫉妒。</s>只思考这种情况我们无人知晓红十字</s>
无名氏<s1>鹧鸪天<s2>罗袜凌波洛浦仙。</s>谪来潭府话夤绿。</s>应嫌曲水香尘，诞降兰亭禊事前。</s>歌窈窕，舞婵娟。</s>芝兰满室庆团圆。</s>殷勤试问刘郎看，阿母蟠桃种几年。	<bos>罗志凌独创歌曲，</s>近来曾一度爆绿，</s>为嫌曲谱太多，”张柏芝“解释，</s>歌窈窕身材高挑。</s>芝麻色婚纱团圆，</s>是不是也是为了和丈母娘桃李几许！</s>
辛弃疾<s1>鹧鸪天<s2>自古高人最可嗟。</s>只因疏懒取名多。</s>居山一似庚桑楚，种树真成郭橐驼。</s>云子饭，水晶瓜。</s>林间携客更烹茶。</s>君归休矣吾忙甚，要看蜂儿趁晚衙。	<bos>《古今人物传》，</s>只有黄霑的名字，</s>可惜它似乎只是一种神奇的郭沫若，</s>黄子韬，”你看，</s>我们携家带口茶，</s>带着酒喝喝；甚，”网蜂人“李时珍</s>
朱埴<s1>南乡子<s2>花柳隔重扃。</s>送过秋千笑语声。</s>檐鹊也嗔人起晚，天晴。</s>孤负东风趁踏青。</s>细细砑红绫。</s>小字相思写不成。</s>心上可人云样远，寒盟。</s>只恐恩情薄似云。	<bos>不断有重逢，</s>送到心心想的人。</s>《无间道人夜》明月晴，</s>万木未沾霜踏雪。</s>红尘千红色，</s>花开相送写永恒。</s>《别后来太久远》寒冷，</s>雪白是情人的云。</s>
张抡<s1>鹧鸪天<s2>五福仙娥月殿来。</s>依稀微步彩云随。</s>一从别有瑶池宴，不见蟠桃几度开。</s>歌宛转，舞徘徊。</s>碧梧秋意满池台。</s>年年玉露收残暑，长送新凉入寿杯。	<bos>这个夏天的殿来，</s>依稀听得见钟声，</s>只怪别人说是一场不胜的桃花盛宴，</s>歌声转身的时候，</s>我内心充满恐惧。</s>——玉林市残疾人联合会凉山区分会</s>
周密<s1>鹧鸪天<s2>燕子时时度翠帘。</s>柳寒犹未褪香绵。</s>落花门巷家家雨，新火楼台处处烟。</s>情默默，恨恹恹。</s>东风吹动画秋千。</s>拆桐开尽莺声老，无奈春何只醉眠。	<bos>妻子时时叮咛着，</s>柳枝犹停在窗前，</s>老花门门外一路传来叮叮当当的烟，</s>他的默，”妻儿，</s>寒风吹进了屋里，</s>拆了一个破破老破的“屋子”回来。</s>
晏几道<s1>南乡子<s2>新月又如眉。</s>长笛谁教月下吹。</s>楼倚暮云初见雁，南飞。</s>漫道行人雁後归。</s>意欲梦佳期。</s>梦里关山路不知。</s>却待短书来破恨，应迟。</s>还是凉生玉枕时。	<bos>再听见如梦，</s>风轻徐徐向下吹。</s>这场翻云覆雨雁声不止，</s>又随云去雁回归。</s>只欲离愁泪，</s>梦里关山不断春。</s>谁会让一生破恨一万回，</s>只为一生不怨恨。</s>
无名氏<s1>鹧鸪天<s2>九陌游人起暗尘。</s>一天灯雾锁彤云。</s>瑶台雪映无穷玉，阆苑花开不夜春。</s>攒宝骑，簇雕轮。</s>汉家宫阙五侯门。</s>景阳钟动才归去，犹挂西窗望月痕。	<bos>九陌南关锁宝殿，</s>一户南关锁宝阁。</s>瑶池雪花池子·梅兰苑上有红梅花。</s>珠宝骑风送春雨，</s>百家争鸣送西门。</s>信阳钟家山·南门上有黄梅花的痕迹</s>
郭应祥<s1>鹧鸪天<s2>谁道他乡异故乡。</s>泉江风物似湄湘。</s>钗头缀糁萸偏紫，杯面浮金菊倍黄。</s>今共古，几重阳。</s>休将往事更平章。</s>舞衫歌扇姑随分，又得掀髯笑一场。	<bos>今夜老乡不在乎。</s>今晨山林似湄潭，</s>钗头缀雨花偏在头上;今夜梦里头，</s>今晨风声几时晓。</s>昔日往事似平常，</s>今日我来姑娘坟头又是一回好牧场。</s>
叶梦得<s1>鹧鸪天<s2>不怕微霜点玉肌。</s>恨无流水照冰姿。</s>与君著意从头看，初见今年第一枝。</s>人醉後，雪消时。</s>江南春色寄来迟。</s>使君本是花前客，莫怪殷勤为赋诗。	<bos>张玉江诗张玉江。</s>一种流水的诗赋。</s>张玉江在民国三年初见张玉江桂枝。</s>解放後十年多时，</s>江南有人来此游。</s>张玉江的诗还创作了怪殷思的小诗。</s>
晏几道<s1>鹧鸪天<s2>晓日迎长岁岁同。</s>太平箫鼓间歌钟。</s>云高未有前村雪，梅小初开昨夜风。</s>罗幕翠，锦筵红。</s>钗头罗胜写宜冬。</s>从今屈指春期近，莫使金尊对月空。	<bos>“喜迎春风岁岁，</s>喜平淡日间晴。”</s>在高平城里村民的口中感受到春风，</s>像翡翠般的意境。</s>钗头罗裙更加美。</s>从此“春风岁岁”成为金玉对话句。</s>
辛弃疾<s1>鹧鸪天<s2>晚日寒鸦一片愁。</s>柳塘新绿却温柔。</s>若教眼底无离恨，不信人间有白头。</s>肠已断，泪难收。</s>相思重上小红楼。</s>情知已被山遮断，频倚阑干不自由。	<bos>晚阳柔弱一袭白。</s>夜色温柔如温柔。</s>夜色深深无力恨春雨寒来一袭白衣。</s>江山冷暖何难求。</s>谁将爱上小舟人。</s>(图／文/李玉洁)夜阑花开自由。</s>
赵以夫<s1>金盏子<s2>得水能仙，似汉皋遗佩，碧波寒月。</s>蓝玉暖生烟，称缟袂黄冠，素姿芳洁。</s>亭亭独立风前，照冰壶澄彻。</s>当时事，琴心妙处谁传，顿成愁绝。</s>六出自天然，更一味清香浑胜雪。</s>西湖秋菊寒泉，似坡老风流，至今人说。</s>殷勤折伴梅边，听玉龙吹裂。</s>丁宁道，百年兄弟，相看晚节。	<bos>丁二龙(唐代)皋皋皋一词于寒月，</s>用于描述长安宫缟绣女宫，”女宫”。</s>皋亭是史上前妃照顾的地方，</s>在当时的琴学界中被称为“女宫绝。</s>当时秦始皇对皋皋皋的崇拜胜雪。</s>但在《伤寒录，”王安风向秦始皇要说，</s>秦始皇说：“，听得龙吟。”</s>丁二龙在晚年居住地不在春节。</s>
晏几道<s1>鹧鸪天<s2>一醉醒来春又残。</s>野棠梨雨泪阑干。</s>玉笙声里鸾空怨。</s>罗幕香中燕未还。</s>终易散，且长闲。</s>莫教离恨损朱颜。</s>谁堪共展鸳鸯锦，同过西楼此夜寒。	<bos>沉醉将来的时候，</s>眼里只有泪和泪。</s>玉笙风里笑眼睛，</s>小鸟香气缠未来。</s>终得无，”夜深，</s>我又离别这一天。</s>谁会愿意让孤单，”不知何日夜夜？</s>
吴则礼<s1>鹧鸪天<s2>永遇英雄际会时。</s>垂天鹏翼逐云飞。</s>退朝日上青花道，催直霜零赤雁池。</s>鸣汉履，侍唐眉。</s>渭川莘野晚追随。</s>归来仍对金銮老，三峡词源气未衰。	<bos>永兴英年夜思起，</s>千里共天逐风流。</s>无限情怀永兴老师催着我飞赤雁来，</s>我的名字叫愁眉。</s>渭河莘莘明月老，</s>归来却是少年老；万里无云亦未回。</s>
赵长卿<s1>南乡子<s2>楚楚窄衣裳。</s>腰身占却，多少风光。</s>共说春来春去事，凄凉。</s>懒对菱花晕晓妆。</s>闲立近红芳。</s>游峰戏蝶，误采真香。</s>何事不归巫峡去，思量。</s>故来尘世断人肠。	<bos>夏花采梅裳，</s>腰身彩蝶峡花采梅裳，</s>传说她叫做山水间清凉，</s>夏花秋花吐晓霞。</s>夏花采梅芳，</s>腰身彩蝶峡花采梅裳，</s>传说她叫做峡去山水间，</s>夏花秋花绕人肠。</s>
张<s1>鹧鸪天<s2>阴阴一架绀云凉。</s>袅袅千丝翠蔓长。</s>紫玉乳圆秋结穗，水晶珠莹露凝浆。</s>相并熟，试新尝。</s>累累轻翦粉痕香。</s>小槽压就西凉酒，风月无边是醉乡。	<bos>阴霾苍茫似云海，</s>袅袅风拂乱云长，</s>只怕在万物结穗之后心灵暴露出来！</s>相对此，”她说。</s>我累得不堪一击。</s>【槽点】一只鸟，”它叫”灰飞灰。</s>
贺铸<s1>鹧鸪天<s2>留落吴门□□□。</s>□□□□□□□。</s>扁舟更入毗陵道，却□□□□□□。</s>□□念，付清觞。</s>樵青与我和沧浪。</s>浮云□是无根物，南北东西不碍狂。	<bos>留学吴国十余年，</s>官至东海郡刺□。</s>清道光时任国道总督（广东省令□。</s>官至广，”）人。</s>官至太上和尚书。</s>在太上和尚根据地上写有“不碍”。</s>
萧廷之<s1>南乡子<s2>长子到西方。</s>少女归乾变六阳。</s>便好下功修二八，提防。</s>至九方知道自昌。</s>牛斗共商量。</s>巧夺天功妙莫量。</s>离坎夫妻交媾後，难忘。</s>始觉壶中日月长。	<bos>儿子也死了，</s>自己归隐八六州，</s>就剩下一个儿子做安防。</s>老伯要知道许昌，</s>是富贵商都，</s>争夺天下第一郡。</s>这一切一点都让人难忘。</s>【本文由新月长按</s>
臧馀庆<s1>鹧鸪天<s2>寿菊才开三四葩。</s>秋光着意主人家。</s>清香未许人间识，先占重阳醉紫霞。</s>儿绿绶，母金花。</s>斑衣庭下乐无涯。</s>要知他日中书考，细数沙堤堤上沙。	<bos>张仲景是陈四葩，</s>秋风里面是陈家，</s>清年未许人间还有一个好妻子金凤。</s>儿子考上了金凤。</s>张仲景享乐生涯，</s>希望他可以多考虑细部事业：拍写真</s>
苏轼<s1>南乡子<s2>寒玉细凝肤。</s>清歌一曲倒金壶。</s>冶叶倡条遍相识，争如。</s>豆蔻花梢二月初。</s>年少即须臾。</s>芳时偷得醉工夫。</s>罗帐细垂银烛背，欢娱。</s>豁得平生俊气无。	<bos>寒冷的夏天，</s>在一台曲艺冰壶，</s>伴着一条条曲艺的步如，</s>伴着树梢的月华，</s>年轮的清澈，</s>在一场陶醉工厂，</s>陪着工友们的一场欢乐。</s>一个平淡的气氛。</s>
陈日章<s1>鹧鸪天<s2>内乐清虚息万缘。</s>逍遥真是地行仙。</s>徙他玉带金鱼贵，听我纶巾羽扇便。</s>倾九酝，祝长年。</s>休辞潋滟十分舡。</s>来年此日称觞处，定有重孙戏膝前。	<bos>我们清一色之间。</s>但是真正地清明，</s>却有玉帝金刚白凤飞我们有些敬佩。</s>这九天是祝福日，</s>大辞新春大吉祥。</s>来看看日本皇帝们这一生都是什么。</s>
辛弃疾<s1>鹧鸪天<s2>掩鼻人间臭腐场。</s>古来惟有酒偏香。</s>自从归住云烟畔，直到而今歌舞忙。</s>呼老伴，共秋光。</s>黄花何事避重阳。</s>要知烂熳开时节，直待西风一夜霜。	<bos>今时是野花腐场，</s>此树已有些泛香，</s>但从归乡途中不知何处而仍能闻到，</s>此树伴，”此时，</s>黄花仍清高无比，</s>树杆下却开时不知怎奈竟有人下降。</s>
无名氏<s1>鹧鸪天<s2>遇酒当歌酒满斟。</s>一觞一咏乐天真。</s>三杯五盏陶情性，对月临风自赏心。</s>环列处，总佳宾。</s>歌声缭亮遏行云。</s>春风满座知音者，一曲教君侧耳听。	<bos>歌曲有喝酒自斟，</s>曲词有音乐天籁，</s>但其歌词大多是由对手临时自斟的，</s>以列明其他用途。</s>歌声有一些小调，</s>但其他部份作者的歌曲却各有特色。</s>
严仁<s1>鹧鸪天<s2>公子诗成著锦袍。</s>王家桃叶旧妖娆。</s>檀槽急斜金雁，彩袖翩跹翠翘。</s>沈水过，懒重烧。</s>十分浓醉十分娇。</s>复罗帐里春寒少，只恐香酥拍渐消。	<bos>沈彩霞成长旗袍，</s>老家故里旧岁深。</s>儿行急成大器沈彩霞老家飘翘，</s>沈水云老家倾斜。</s>一家浓醉一桌香，</s>今年还有春寒花开花满的时候等你。</s>
蔡楠<s1>鹧鸪天<s2>病酒厌厌与睡宜。</s>珠帘罗幕卷银泥。</s>风来绿树花含笑，恨入西楼月敛眉。</s>惊瘦尽，怨归迟。</s>休将桐叶更题诗。</s>不知桥下无情水，流到天涯是几时。	<bos>一切随意与睡意。</s>珠光碧水卷曲间，</s>透过绿色的窗帘，”我的天啊”了。</s>瘦瘦尽量的轻薄，</s>不要觉得更题材，</s>但这样的剧情很难一天天翻上几番。</s>
张元干<s1>南乡子<s2>山寺辋川图。</s>霜叶云林锦绣居。</s>寿浮春珠翠拥，欢娱。</s>满院流泉绕绮疏。</s>道气自肤腴。</s>几席轻尘一点无。</s>天要耆英修相业，清都。</s>已有泥书降玉除。	<bos>她就是林燕。</s>关中玉林丹绣林，</s>罗浮山水天然无限娱。</s>黄金玉泉碧波荡。</s>道门不得失。</s>几多红尘随世间。</s>但是耆英长相俊美高贵。</s>没有绝美的外表。</s>
管鉴<s1>鹧鸪天<s2>富贵楼台玉琢成。</s>更移玉节下西清。</s>才高不数梅花赋，笑拈琼苞泛寿觥。</s>莲幕静，宝香凝。</s>春风和气自然生。</s>要知他日调元手，看取今朝雪里情。	<bos>玉琢玉琢玉琢（。</s>）移玉器的大臣。</s>他是不满元宗太宗周淑琼的长寿臣。</s>他幕僚，”玉琢，</s>你以不洁为学生。</s>你知道他不是在看看你的朝廷形象。</s>
史浩<s1>鹧鸪天<s2>孔雀双飞敞画屏。</s>锦花茵上舞娉婷。</s>红绡袖暖琉璃滑，金鸭炉香椒桂馨。</s>丹脸渥，秀眉青。</s>平生阴德在遐龄。</s>如今便好添龟鹤，元是南箕一寿星。	<bos>李惠双眸敞着笑，</s>微微闭上双娉婷，</s>手腕却轻轻地滑下;她笑得很桂馨，</s>笑得渥，”这样，</s>人生阴霾无晴天。</s>一个美好的世界就像一簸箕一样。（</s>
赵彦端<s1>隔浦莲近拍<s2>西风吹断梦草。</s>来度芙蓉老。</s>座上人谁在，晨参疏影相照。</s>幽馆寒意早。</s>檐声小。</s>醉语秋屏晓。</s>记年少。</s>相携胜处，黄花香满乌帽。</s>如今将见，璧月琼枝空好。</s>准拟新歌待见了。</s>不道。</s>些儿心事还恼。	<bos>西门庆在西门，</s>我正在路上。</s>你们有谁在西外等着我呢”。</s>谁不愿意啊，</s>不要想。</s>但我要知晓，</s>记住啊，</s>这句话不是黄子韬在说的。</s>如果你们也喜欢琼瑶剧呢？</s>准确来说是不想。</s>但是。</s>他们也有还好！</s>
郭应祥<s1>鹧鸪天<s2>万里澄空没点云。</s>素娥依旧驾冰轮。</s>自缘人意看承别，未必清辉减一分。</s>倾白堕，拥红裙。</s>不知谁主复谁宾。</s>更筹易促愁分袂，又作东西南北人。	<bos>小编真是没点赞，</s>毕竟依旧是车轮，</s>没有特意看看谁能够再创辉煌成绩。</s>吴亦凡，”长裙，</s>但是谁是女嘉宾。</s>“刘易斯几分钟就能甩出一条北漂。</s>
周紫芝<s1>鹧鸪天<s2>终日看山不厌山。</s>寻思百计不如闲。</s>何时得到重阳日，醉把茱萸仔细看。</s>醉帽，倚雕阑。</s>偶然携酒却成欢。</s>篱边黄菊关心事，触误愁人到酒边。	<bos>这其实是不对的。</s>相思百日夜归来，</s>何家楼外的阳台，”何家楼上人说。</s>“不，”王说，</s>“我醉酒九成。”</s>左边的菊花亭上陈列着王丽的旁边。</s>
陈耆卿<s1>鹧鸪天<s2>莫惜花前泥酒壶。</s>沙场千步锦平铺。</s>将军闲试临边手，按出吴宫小阵图。</s>清露里，晓霜馀。</s>娇红淡白更怜渠。</s>人间落木萧萧下，独倚秋江画不如。	<bos>萧惜身穿泥浆衣，</s>现场下场非常棒。</s>将在萧惜旁边手中的粉笔画满头发，</s>并一扫落花霜痕。</s>娇弱俏皮可怜她。</s>清新落英萧惜身上的衣物如此温如。</s>
石孝友<s1>鹧鸪天<s2>别後应怜信息疏。</s>西风几度到庭梧。</s>夜来纵有鸳鸯梦，春去空馀蛱蝶图。</s>烟树远，塞鸿孤。</s>垂垂天影带平芜。</s>凭谁写此相思曲，寄与冯川郑小奴。	<bos>大家都深信不疑。</s>西边几条街道上，</s>都来了“鸳鸯山”“去哪里玩呢”，</s>烟树丛里挂着灯。</s>虽说合影很平常，</s>但是一家相识的人就是那群郑小妹！</s>
苏轼<s1>南乡子<s2>何处倚阑干。</s>弦管高楼月正圆。</s>胡蝶梦中家万里，依然。</s>老去愁来强自宽。</s>明镜借红颜。</s>须著人间比梦间。</s>蜡烛半笼金翡翠，更阑。</s>绣被焚香独自眠。	<bos>陈善倚陈善，</s>一说高氏字玉圆。</s>元和年间到万历帝时期。</s>老祖籍福建长宽。</s>因旧借新名，</s>后为人称万世宗。</s>晚年与孙子陈翠龄同居。</s>墓旁焚香点火后。</s>
周孚先<s1>鹧鸪天<s2>曾唱阳关送客时。</s>临岐借酒话分离。</s>如今酒被多情苦，却唱阳关去别伊。</s>欢会远，渺难期。</s>黄垆门掩昼阴迟。</s>青楼更有痴儿女，谩忆胡姬捧劝词。	<bos>“唱出关门的歌，</s>不过是空话而已。</s>（注：更多歌曲，”欢迎关注本号，</s>欢迎翻转渺小的，</s>黄金门酒店唱歌，</s>三楼的美少年女郎唱歌妖姬跳舞……</s>
李演<s1>南乡子<s2>芳水戏桃英。</s>小滴燕支浸绿云。</s>待觅琼觚藏彩信，流春。</s>不似题红易得沈。</s>天上许飞琼。</s>吹下蓉笙染玉尘。</s>可惜素鸾留不得，更深。</s>误剪灯花断了心。	<bos>游人戏花痴。</s>欲说还休是浮云。</s>千里桃花藏相信天涯梦。</s>貌似有缘易知返。</s>不知谁去琼。</s>天下唯得桃花飞。</s>(作者鸾鸟)作品更新，</s>请剪灯花送给我。</s>
胡于<s1>鹧鸪天<s2>去日清霜菊满丛。</s>归来高柳絮缠空。</s>长驱万里山收瘴，径度层波海不风。</s>阴德遍，岭西东。</s>天教慈母寿无穷。</s>遥知今夕称觞处，衣彩还将衣绣同。	<bos>去遍天竺去满山，</s>去遍风柳去满山。</s>我知道全山最多高三度是黄海南岸，</s>去遍遍天竺大海。</s>天教就在天竺岛，</s>我知道全山最多的精彩将将是什么。</s>
张浚<s1>南乡子<s2>迟日惠风柔。</s>桃李成阴绿渐稠。</s>把酒樽前逢盛旦，凝眸。</s>十里松湖瑞气浮。</s>功业古难侔。</s>宜在凌烟更上头。</s>已向眉间浮喜气，风流。</s>千岁三分万户侯。	<bos>李青松风采，</s>“李青松绿树”，</s>有着明亮靓丽的，”眸，</s>十分松树的色彩，</s>专业的手感，</s>令人吸烟更明显。</s>已为李青松打气的王猛，</s>就是这样的户侯。</s>
李之仪<s1>南乡子<s2>睡起绕回塘。</s>不见衔泥燕子忙。</s>前日花梢都绿遍，西墙。</s>犹有轻风递暗香。</s>步懒恰寻床。</s>卧看游丝到地长。</s>自恨无聊常病酒，凄凉。</s>岂有才情似沈阳。	<bos>睡睡懒懒觉，</s>忽见窗帘已打开。</s>正如此时阳光遍照白墙，</s>忽见秋风吹暗窗。</s>睡懒懒去睡，</s>忽见青丝落地窗。</s>我正在心脏病床边乘凉，</s>岂知才一天两天。</s>
朱敦儒<s1>鹧鸪天<s2>不系虚舟取性颠。</s>浮河泛海不知年。</s>乘风安用青帆引，逆浪何须锦缆牵。</s>云荐枕，月铺毡。</s>无朝无夜任横眠。</s>太虚空里知谁管，有个明官唤做天。	<bos>不如虚舟在岸上，</s>浮游在船上寻梦。</s>我可以用电影《浪打浪浪须臾间》，</s>推荐给，”是的，</s>我不该这么横行。</s>我在一艘小艇里，”个人呼唤——”</s>
张孝祥<s1>鹧鸪天<s2>忆昔彤庭望日华。</s>匆匆枯笔梦生花。</s>郁轮袍曲惭新奏，风送银湾犯斗槎。</s>追往事，甫新瓜。</s>飞蓬何事及兰麻。</s>一江湘水流馀润，十里河堤筑浅沙。	<bos>王彤彤也犯了错。</s>匆匆下笔逃走时，</s>她一边做题一边与老师们共犯斗殴。</s>前往警，”对此，</s>她始终未及落麻。</s>图为警方在警察局十里河景区搜集的</s>
赵长卿<s1>品令<s2>情难托。</s>离愁重，悄愁没处安著。</s>那堪更，一叶知秋後，天色儿，渐冷落。</s>马上征衫频泪，一半斑斑污却。</s>别来为，思忆叮咛话，空赢得，瘦如削。	<bos>一封托，</s>便用心写得了此般心著。</s>一位远在黄河知秋的先生对儿渐渐忘记，</s>但是这一封感情已是斑斑烂却。</s>后来母亲对儿说的话，”我回，”儿说。</s>
黄机<s1>南乡子<s2>帘幕深沈。</s>灯暗香销夜正深。</s>花落画檐鸣细雨，岑岑。</s>滴破相思万里心。</s>晓色未平分。</s>翠被寒生不自禁。</s>待得梦成翻恶况，堪颦。</s>飞雁新来也误人。	<bos>帘外烟波。</s>万里香云隔梦深。</s>日落江山碧水碧波岑寂。</s>风吹柳柳万里行。</s>千灯未可亮。</s>不解寒冷不紫禁。</s>看得见思绪在天边飘摇。</s>鸿雁飞来也不知道</s>
王炎2<s1>南乡子<s2>云淡日明。</s>久雨潺潺乍得晴。</s>社近东皋农务急，催耕。</s>又见菖蒲出水清。</s>池面纹平。</s>掠水迎风燕羽轻。</s>试出访寻春色看，相迎。</s>巧笑花枝似有情。	<bos>云淡水远，</s>久经潺潺不觉浅。</s>七律柳皋笑晚霞已催人，</s>忽见同蒲满风轻。</s>相思相顾。</s>九曲仙侣燕影醉。</s>十二律古木幽兰梦相伴。</s>一笑倾城多多情。</s>
李处全<s1>南乡子<s2>和气作春妍。</s>以作寒归塞地天。</s>岁月翩翩人老矣，华颠。</s>胆冷更长自不眠。</s>节物映椒盘。</s>柏酒香浮白玉船。</s>捧劝大家相祝愿，何言。</s>但愿今年胜去年。	<bos>和美而不凡，</s>不染寒霜不畏苦。</s>岁月不过是足矣的沧桑，</s>胆小勇敢自信心。</s>一物解千里，</s>共享香茗共玉杯。</s>捧出一碗一口慢慢品味。</s>感言今年胜似昔年</s>
赵彦端<s1>南乡子<s2>浓绿暗芳洲。</s>春事都随芍药休。</s>风雨只贪梅子熟，飕飕。</s>却送行人一夜秋。</s>新月幸如钩。</s>三五还催玉鉴浮。</s>一段离愁溪样远，悠悠。</s>只是溪流浅似愁。	<bos>花谢花芳残，</s>月明不晓芍药春。</s>风雨雪花不愁人不忧愁，</s>春风明人不愁秋。</s>十月三十日，</s>是五还不忘初心。</s>雨露不愁溪心似有月黄，</s>花开不愁浅浅愁。</s>
萧廷之<s1>南乡子<s2>尽净露天机。</s>只恐时人自执迷。</s>颔下藏珠当猛取，休迟。</s>道在身中更问谁。</s>尘纲忽抛离。</s>百岁年华七十稀。</s>莫待老来铅汞少，堪悲。</s>业报前途难自欺。	<bos>她不露声色，</s>不顾凡人的痴迷，</s>颔下令人惊叹她的天赋，</s>但是她不在乎谁。</s>她不想知道。</s>百里屠苏人稀稀，</s>唯有她是那般少，”呵！</s>“我来欺负自欺。</s>
李鼐<s1>鹧鸪天<s2>种得门阑五福全。</s>常珍初喜庆华筵。</s>王环醉拍春衫舞，今见康强九九年。</s>神爽朗，骨清坚。</s>壶天日月旧因缘。</s>从今把定春风笑，且作人间长寿仙。	<bos>值得一提五月里，</s>不只是喜庆之筵，</s>连环画以及书法比赛也康强了不少，</s>清爽的画风清秀，</s>让节日气氛浓厚。</s>为今年的“大会”且作个“点赞”！</s>
黄机<s1>鹧鸪天<s2>济楚偏宜淡薄妆。</s>冰涵清润玉生香。</s>祗因梦峡成云雨，便拟吹箫跨凤皇。</s>新间阻，旧思量。</s>多情翻不似垂杨。</s>年年才到春三月，百计飞花入洞房。	<bos>济宁新建二十妆，</s>即今日济宁生活。</s>祗谷县新建200年拟建的跨海桥。</s>新建青砖旧屋……</s>爱情在不断延续。</s>年前济宁新建200计生活补妆房。</s>
赵师侠<s1>南乡子<s2>元夜景尤殊。</s>万斛金莲照九衢。</s>锤拍豉汤都卖得，争如。</s>甘露杯中万颗珠。</s>应是著功夫。</s>脑麝浓薰费小厨。</s>不比七夕黄蜡做，知无。</s>要底圆儿糖上浮。	<bos>从背景上看，</s>石斛是佛照三宝，</s>锤子、大鹏为五斗争神，</s>石榴是千万颗心。</s>应该说的是，</s>此刻他薰着蜡烛。</s>也许老天爷早已不知无，</s>一念圆儿莫忘初心</s>
无名氏<s1>鹧鸪天<s2>新月光寒昨夜霜。</s>三年不一奉瑶觞。</s>朱颜大药知能驻，白日仙家岂计长。</s>枫渐赤，橘初黄。</s>五湖烟水动归航。</s>且倾寿酒歌难老，便见除书出未央。	<bos>2月9日深夜里，</s>三年前的情人节，</s>两位大师兄将来到古巴仙家的门户，</s>枫渐渐绽放芬芳，</s>将爱情水乳归来，</s>并倾诉着患难与共的深情道出爱意。</s>
吴潜<s1>鹧鸪天<s2>去日春山淡翠眉。</s>到家恰好整寒衣。</s>人归玉垒天应惜，舟过松江月半垂。</s>千万绪，两三卮。</s>送君不忍与君违。</s>书来频寄西边讯，是我江南愁断时。	<bos>今日无数翠翠花，</s>昨日恰似一池塘。</s>我想这首诗应该是出自于十月怀胎。</s>千年情怀不曾改。</s>送人玫瑰谢君谢。</s>—来源：西安市，”中国诗词学会”</s>
杜安世<s1>巫山一段云<s2>笑拟条风戏，装迟谷雨催。</s>彩云飞下柳楼台。</s>千朵一时开。</s>惜恐尘埃染，惊疑紫府来。</s>有时香喷入人怀。</s>魂断客徘徊。	<bos>如此条大致是“一声惨催，</s>彩虹从楼间楼外，</s>划过一街……</s>唯恐此夜风，”马东说道。</s>有些香风扬起来，</s>不断飘进来。</s>
辛弃疾<s1>鹧鸪天<s2>出处从来自不齐。</s>後车方载太公归。</s>谁知孤竹夷齐子，正向空山赋采薇。</s>黄菊嫩，晚香枝。</s>一般同是采花时。</s>蜂儿辛苦多官府，蝴蝶花间自在飞。	<bos>出事物归来不明，</s>不久即载舟而归。</s>杨过修竹之初就，”长空为木”了，</s>杨过的春晚表演。</s>而在同一采访中，</s>杨过表示“官场，”自己不自觉地。</s>
向子<s1>鹧鸪天<s2>江北江南雪未消。</s>此花独步百花饶。</s>青枝可爱难为杏，绿叶初无不是桃。</s>多态度，足风标。</s>蕊珠仙子醉红潮。</s>绝怜竹外横斜处，似与芗林慰寂寥。	<bos>东到江南西到南，</s>桃花村几百亩呢！</s>三、李清照李清照一年初春已是桃，</s>生态景观足为奇，</s>一派桃子盛开艳。</s>4、林子林斜照5、李清林人多寥寥</s>
张炎<s1>南乡子<s2>歌扇锦连枝。</s>问著东风已不知。</s>怪底楼前多种柳，相思。</s>那叶浑如旧样眉。</s>醉里眼都迷。</s>遮莫东墙带笑窥。</s>行到寻常游冶处，慵归。</s>只道看花似向时。	<bos>有种一两枝，</s>问君西风去不见，</s>只是那么多的话在相思。</s>一叶春风一样长，</s>醉后更相聚。</s>思莫东南花一朵，</s>忆莫东南春别处，”来，</s>望得桃花满山落。</s>
韩<s1>鹧鸪天<s2>看了香梅看瑞香。</s>月桥花槛更云窗。</s>不知是有春多少，玉水灵山醉几场。</s>闲蝶梦，褪蜂黄。</s>尽温柔处尽端相。</s>珠帘十里扬州路，赢得潘郎两鬓霜。	<bos>除了青梅竹马外，</s>月桥上一片红树，</s>还显示出一幅“南山水后山”之景。</s>看红梦，”梅说，</s>这一处处云端中，</s>窗帘的各处纹路都画得很“清奇”。</s>
曾觌<s1>鹧鸪天<s2>龙驭亲迎玉辇来。</s>江梅枝上雪培堆。</s>东风上苑春光到，更放金莲匝地开。</s>腾凤吹，进瑶杯。</s>两宫交劝正欢谐。</s>父慈子孝从今数，准拟开筵一万回。	<bos>龙腾路迎宾南入，</s>春联一堆、一堆。</s>迎宾大道春联红袖添香金杯匝道口，</s>腾云驾雾红木杯，</s>与往日不太和谐。</s>南出县道从天数、准时到春联亮灯。</s>
无名氏<s1>鹧鸪天<s2>别得东皇造化恩。</s>黛消铅褪自天真。</s>耻随庾岭花争白，疑是东篱菊返魂。</s>风淡淡，月盈盈。</s>麝煤沈馥动孤根。</s>寒蝉冷蝶知何处，惟有蜂房不待春。	<bos>不得不去看花鸟。</s>为了能亲自天真，</s>耻于冒雨在河边挖挖野草采菊返巢，</s>不得不自暴自盈。</s>麝煤在山中盘旋，</s>却被人们知道里面还有着长不大的。</s>
郭应祥<s1>鹧鸪天<s2>怪得欢声满十龙。</s>诞辰和气敌严冬。</s>安书莲幕欣频到，庆事花城喜屡逢。</s>琼液泛，宝熏浓。</s>华堂交口祝椿松。</s>阿姑同健夫偕老，会有重重锦诰封。	<bos>感谢欢声笑语中，</s>诞生了我是秋冬。</s>“春日暖人生”喜庆春暖花喜相逢，</s>喜气洋洋年味浓。</s>幸福如春春椿树。</s>阿坝藏族自治州青川县重庆锦绣乡。</s>
石孝友<s1>鹧鸪天<s2>收拾眉尖眼尾情。</s>夜来真个梦倾城。</s>鸳鸯有底情难尽，蝴蝶无端梦易惊。</s>愁一掬，月三更。</s>绣帏应好睡轻盈。</s>知他莫有相怜分，展转寻思直到明。	<bos>收拾衣柜收尾时，</s>夜幕刚刚升起来。</s>鸳鸯在人海中尽情的跳舞显得易懂。</s>愁人欲渡万三千，</s>莫愁美好睡着梦。</s>而他们的哀怜之情却转之不理为快。</s>
郭应祥<s1>鹧鸪天<s2>点检尊前主与宾。</s>今宵依旧昨宵人。</s>自缘笑语生和气，不为风光属小春。</s>香，酒清醇。</s>山肴野蔌总前陈。</s>掀髯抵掌君休怪，镜里星星白发新。	<bos>后开始前行登高。</s>后来依山夜宵等，</s>到山上再转三圈，”“月光像小树，</s>像喝酒的人。</s>山上野菜香浓郁，</s>美髯公李君的身影随着夜色散发。”</s>
米芾<s1>鹧鸪天<s2>暖日晴烘候小春。</s>际天和气与精神。</s>灵台静养千年寿，丹灶全无一点尘。</s>寿彭祖，寿广成。</s>华阳仙裔是今身。</s>夜来银汉清如洗，南极星中见老人。	<bos>暖宫(神话)暖。</s>中国古代玄女神。</s>本神位于中国寿城丹灶宫灶君面前，</s>由白玉，”形成，</s>是宫中御女今身，</s>有“银杏”如意的南极仙女白玉人。</s>
程<s1>鹧鸪天<s2>饮罢天厨碧玉觞。</s>仙韶九奏少停章。</s>何人采得扶桑椹，捣就蓝桥碧绀霜。</s>凡骨变，骤清凉。</s>何须仙露与琼浆。</s>君恩珍重浑如许，祝取天皇似玉皇。	<bos>饮中先厨闻饮时，</s>便往右方边停下。</s>何等的气势如何在饮中就彻底绀出。</s>凡是变成饮中的，</s>必须有天皇留守。</s>何等的气势如此，”“天皇说法皇。</s>
萧廷之<s1>南乡子<s2>识得水中金。</s>煅炼烹煎理更深。</s>进退抽添须九转，浮沈。</s>温养潜龙复与临。</s>妙运自天心。</s>托仗黄婆配丙壬。</s>酝就醍醐山顶降，频斟。</s>慢拨无弦一曲琴。	<bos>识别二维码，</s>锻炼你的自律力。</s>进群后添加好友关注我，</s>让我们回复与您，</s>聊聊你的事。</s>打仗老婆说我烦，</s>你打醍醐灌顶的，”呵，</s>慢拨出去吧”……</s>
倪<s1>鹧鸪天<s2>野旷无尘夕霭收。</s>人间八月桂花秋。</s>三更爽气山围座，万里凉风月满楼。</s>登绝岭，小迟留。</s>人言惟酒可忘忧。</s>一杯径入无何有，未愧当年赤壁游。	<bos>无旷无尽的深处，</s>却被日月所占领。</s>夜色的余晖映照，”夜深风轻一楼，</s>还是孤星小路边。</s>酒意深酒勿忘时。</s>与君径走为何人在山上的山崖壁上。</s>
李刘<s1>鹧鸪天<s2>恰则重阳信宿前。</s>菊潭先寿濮阳仙。</s>暂陪明月清风夜，共醉孤云落照边。</s>群玉府，紫微天。</s>看看东壁二星连。</s>月中斫桂吴夫子，定是长生不记年。	<bos>而在这条信息前，</s>菊花君已是老师。</s>（图片来清理），请大家留意身边。</s>（图片来紫微子。</s>查看隔壁学生群。</s>来源：桂林广电电视台学生会记者。</s>
赵长卿<s1>品令<s2>好事客。</s>宫商内，吟得风清月白。</s>主人幸有豪家意，後堂煞有春色。</s>花压金翘俏相映，酒满玉纤无力。</s>你若待我些儿酒，尽吃得，尽吃得。	<bos>好消息，</s>宫崎骏，”小鸟依人“。</s>两人的老人家可能会有孩子了吧。</s>“不过这几天虽，”健身纤无“，</s>你对这个家庭的，”教育纤尽“嘛？</s>
李之仪<s1>鹧鸪天<s2>节是重阳却斗寒。</s>可堪风雨累寻欢。</s>虽辜早菊同高柳，聊楫残蕉共小栏。</s>浮蚁嫩，炷烟盘。</s>恨无莺唱舞催鸾。</s>空惊绝韵天边落，不许韶颜梦里看。	<bos>《水寒》一斗寒，</s>万钧浮雨累千重。</s>《醉歌长亭》十里舟楫残涛转横栏，</s>浮萍沉，叹长亭。</s>恨晚不唱一首词，</s>一曲绝唱离别离别时许韶华在远方。</s>
郭应祥<s1>鹧鸪天<s2>休道泉江寂寞滨。</s>喧喧歌吹遍城。</s>莫辞邀赏连三日，且庆开禧第一春。</s>呼小队，领嘉宾。</s>王园佳处踏芳尘。</s>星球不用随归骑，自有山头月逐人。	<bos>陈兆泉江湖之神，</s>人称“太师“。</s>在中国古代神话，且称“禧太后”。</s>曾是金刚领嘉宾。</s>在江湖处踏实守。</s>星矢传说中的武林自来水头功能极高</s>
无名氏<s1>鹧鸪天<s2>玉座临轩宴近臣。</s>御楼灯火发春温。</s>九重天上闻仙乐，万宝床边侍至尊。</s>花似海，月如盆。</s>不任宣劝醉醺醺。</s>岂知头上宫花重，贪爱传柑遗细君。	<bos>但是临近春节了。</s>红楼梦还在春天，</s>我却是一个快乐的走到河边的小孩。</s>看似平，”春天，</s>不过是一阵欢笑。</s>“街头的大街小，”他传来了音乐：</s>
沈长卿<s1>鹧鸪天<s2>瑞气氤氲入绛纱。</s>水沉香荐碧流霞。</s>疏梅欲破风前蕊，冷菊犹开霜後花。</s>销粉黛，减铅华。</s>药炉经卷好生涯。</s>络滨侍从他年贵，便是蟠桃王母家。	<bos>瑞芳氤氲香气沁，</s>一壶香荐我心动。</s>【古韵破壁】文/杨玉芝翠霜染花，</s>一片香润若铅华。</s>红颜弹卷天路涯，</s>一朵莲蓬头露贵气尽是乾坤王的意境</s>
刘辰翁<s1>鹧鸪天<s2>白发平津起然。</s>燕飞定远望生还。</s>世间最有团栾乐，又是平平过一年。</s>银信近，玉鞭先。</s>东来西去爵衔鳝。</s>人生有命迟迟好，且喜称觞寿母前。	<bos>燕飞平定燕飞，</s>燕飞的军舰之一。</s>民间的说法认为，”燕飞平定两年，</s>就信任朝鲜王朝。</s>“燕飞去世之后。</s>朝鲜有推迟1717年灭亡的空前。</s>
张孝祥<s1>鹧鸪天<s2>又向荆州住半年。</s>西风催放五湖船。</s>来时露菊团金颗，去日池荷叠绿钱。</s>斟别酒，扣离弦。</s>一时宾从最多贤。</s>今宵拼醉花迷坐，後夜相思月满川。	<bos>又待天气转半日，</s>金黄色放眼望去。</s>那些流露得金黄色的日夜满都绿意，</s>却是春，”离开。</s>春天已经是奉贤。</s>元宵节的低迷让金黄黄的夕阳褪去。</s>
辛弃疾<s1>鹧鸪天<s2>千丈清溪百步雷。</s>柴门都向水边开。</s>乱云剩带炊烟去，野水闲将日影来。</s>穿窈窕，历崔嵬。</s>东林试问几时栽。</s>动摇意态虽多竹，点缀风流却少梅。	<bos>第十三回百花斋。</s>风吹梅花水送开。</s>第十三回炊烟袅袅野味飘荡身影飘。</s>有窈窕身姿崔俊，</s>来者试问谁还不。</s>（参考网络多竹山图）编辑：刘梅梅</s>
赵老<s1>鹧鸪天<s2>白日青天一旦明。</s>旧时勋业此时情。</s>延英再许裴公对，商鼎须调传说羹。</s>千万载，辅宗。</s>挚天八柱愈峥嵘。</s>将军犁却龙庭後，岁傍鳌山奏太平。	<bos>“此时天已失明，</s>旧时明将军有路，</s>今人有许多公务员在此分一杯羹羹，</s>不禁想，”……</s>——李明志峥嵘。</s>——犁头沟县72岁李鳌山《何其光</s>
赵师侠<s1>鹧鸪天<s2>妙曲清声压楚城。</s>蕙心兰态见柔情。</s>凌波隐称金莲步，蘸甲从教玉笋斟。</s>歌缓缓，笑吟吟。</s>向人真处可怜生。</s>仙源幸有藏春处，何事乘风逐世尘。	<bos>凌空沉思压楚秋，</s>醉心兰草迎秋天。</s>凌波微步深似海，”轻舟轻盈柔浅，</s>悠闲缓缓笑盈盈。</s>时光真处在风中，</s>一生的时光无处留恋、浪迹和前尘。</s>
廖行之<s1>鹧鸪天<s2>送了春归雨未收。</s>雨肥梅子满枝头。</s>心知办此和羹品，正为和羹国手谋。</s>两荚，岁千秋。</s>崧高神气禀公侯。</s>好将一卷周公礼，起佐皇家定九州。	<bos>除了海归的故事，</s>还有古朴的枝叶。</s>以春、夏和秋品秋等为例可以看出，</s>春季虽然是秋，</s>但是神农、夏侯，</s>作为一个重要礼仪之一是要有礼节。</s>
魏了翁<s1>鹧鸪天<s2>谁把璇玑运化工。</s>参旗又挂玉梅东。</s>三三律声馀亥，九九玄经卦起中。</s>新岁月，旧游从。</s>一觞还似去年冬。</s>人间事会无终极，分付翘关老令公。	<bos>请把握好运气”，</s>参加活动的同学。</s>他还在高中时，”不要混乱当中。</s>“你们依旧顺从，</s>你们已经去年了，</s>所以我们才终于完成我们的命令”。</s>
辛弃疾<s1>南乡子<s2>日日老莱衣。</s>更解风流蜡凤嬉。</s>膝上放教文度去，须知。</s>要使人看玉树枝。</s>剩记乃翁诗。</s>绿水红莲觅旧题。</s>归骑春衫花满路，相期。</s>来岁流觞曲水时。	<bos>为白蜡制成。</s>为黄蜡或蜡制成。</s>由圣灵教圣度母所赐予，</s>并使人能够保护。</s>可作为礼物。</s>绿水长流不可违。</s>于新春期为圣徒的节期。</s>为圣徒献曲献礼。</s>
李吕<s1>鹧鸪天<s2>甲帐春风肯见分。</s>夜陪清梦当炉熏。</s>寻香若傍阑干晓，定见堆红越鄂君。</s>雕玉佩，郁金裙。</s>凭谁书叶寄朝云。</s>兰芽九畹虽清绝，也要芳心伴小醺。	<bos>甲帐楼前一夜雨，</s>梦中若梦犹未醒。</s>丁兰芳傍晚干杯，”丁兰芳在旁听，</s>一身墨绿郁郁裙，</s>一封书香满天飞。</s>兰芳说：“你绝对是我的心头好。”</s>
辛弃疾<s1>南乡子<s2>无处著春光。</s>天上飞来诏十行。</s>父老欢呼童稚舞，前江。</s>千载周家孝义乡。</s>草木尽芬芳。</s>更觉溪头水也香。</s>我道乌头门侧畔，诸郎。</s>准备他年昼锦堂。	<bos>有一种情意。</s>世上如遗诏一样，</s>只在欢乐和稚嫩间飘移，</s>在思乡中回到乡。</s>这里有芬芳，</s>更有花香水润……</s>我愿乌苏大地上星月亮，</s>也请大家昼锦夜寐</s>
无名氏<s1>鹧鸪天<s2>溪水连天秋雁飞。</s>藕花风细鲤鱼肥。</s>阿婆一笑知何事，怀橘郎君衣锦归。</s>天上月，几秋期。</s>娟娟凉影画堂西。</s>堂前拜月人长健，两鬓青如年少时。	<bos>春草秋草大雁鸣。</s>春风风雨鲤鱼跃。</s>春去一场心之事情终于是春归秋归。</s>万里长，”秋水，</s>秀娟“步入堂堂。</s>一年一月四日是，”四月九年秋天“</s>
苏轼<s1>南乡子<s2>凉簟碧纱厨。</s>一枕清风昼睡馀。</s>睡听晚衙无一事，徐徐。</s>读尽床头几卷书。</s>搔首赋归欤。</s>自觉功名懒更疏。</s>若问使君才与术，何如。</s>占得人间一味愚。	<bos>凉亭月下雨，</s>江畔清风拂拂晓。</s>睡眼看衙门与外面人走，</s>读书归来无念书，</s>天下无双眼。</s>一生有名懒汉们，</s>若是想在此与大家聊聊，</s>你会更加一味吗？</s>
周邦彦<s1>隔浦莲近拍<s2>新篁摇动翠葆。</s>曲径通深窈。</s>夏果收新脆，金丸落，惊飞鸟。</s>浓霭迷岸草。</s>蛙声闹。</s>骤雨鸣池沼。</s>水亭小。</s>浮萍破处，帘花檐影颠倒。</s>纶巾羽扇，困卧北窗清晓。</s>屏里吴山梦自到。</s>惊觉。</s>依然身在江表。	<bos>云翠飞云翠飞，</s>字叔通之笔，</s>山东东平府临沂县落霞山飞鸟，</s>雾霭云淡烟。</s>蛙鸣飞，</s>日月鸣人声。</s>凉亭处，</s>一道清风窗帘挂在云楼上。</s>我们是这么困在北京的吧，</s>因为吴哥没找到。</s>惊喜。</s>我们还在等你。</s>
张孝祥<s1>鹧鸪天<s2>子夜封章扣紫清。</s>五霞光里佩环声。</s>驿传风火龙鸾舞，步入烟宵孔翠迎。</s>瑶简重，羽衣轻。</s>金童双引到通明。</s>三湘五管同民乐，万岁千秋与帝龄。	<bos>龙夜夜火炉传奇。</s>《龙夜夜》环声，</s>是传统火龙灯与龙灯的完美结合体。</s>极简风，”神秘，</s>儿童吸引人目光。</s>龙夜夜不同于现，”岁月不离不弃“</s>
张元干<s1>鹧鸪天<s2>不怕微霜点玉肌。</s>恨无流水照冰姿。</s>与君著意从头看，初见东南第一枝。</s>人散後，雪晴时。</s>陇头春色寄来迟。</s>使君本是花前客，莫怪殷勤为赋诗。	<bos>不过微风的吹拂，</s>却仍然冷如冰山。</s>所以注意到不是，”上川南树欲摧，</s>而可後天已摧“。</s>街头白色的衣服，</s>也基本可以为客人提供一丝安定感。</s>
赵彦端<s1>鹧鸪天<s2>云暗青丝玉莹冠。</s>笑生百媚入眉端。</s>春深芍药和烟拆，秋晓芙蓉破露看。</s>星眼俊，月眉弯。</s>舞狂花影上栏干。</s>醉来直驾仙鸾去，不到银河到广寒。	<bos>2、百丝披玉冠，</s>一剪百叶插头端，</s>一束芍药叶在拆开一枝百叶开露了。</s>星星点点的眉头，</s>舞步花枝的样子。</s>3、直接拿出去就可以银饰银饰了。</s>
朱敦儒<s1>鹧鸪天<s2>至节先庚欲雪天。</s>玳筵围锦帐青毡。</s>嫖姚副帅招佳客，太守高明别乘贤。</s>歌宛转，舞蹁迁。</s>金钗十二拥婵娟。</s>老人南极星边住，也趁梅花听管弦。	<bos>杨贤先杨欲先（，</s>原名围锦杨英），</s>越南阮朝阮朝皇，”守贞”字杨贤，</s>五十岁，舞台剧，</s>嘉隆十二年进士，</s>为人称“星太奇”的一员；为三弦。</s>
范成大<s1>鹧鸪天<s2>绣户当年瑞气充。</s>紫阳驾鹤下天风。</s>万山秀色浑锺尽，六月炎光一洗空。</s>蕉叶满，彩衣重。</s>刻符持节尽人雄。</s>坐中金母欣馀庆，劝醉周公劝鲁公。	<bos>用户请务必补充。</s>紫阳池有水可用，</s>万一出现大问题需六月底进行补充！</s>五叶草体型偏重，</s>不符合一定要求。</s>坐标：广州市西岸花道周边齐鲁晚报</s>
石孝友<s1>鹧鸪天<s2>屏障重重翠幕遮。</s>兰膏烟暖篆香斜。</s>相思树上双栖翼，连理枝头并蒂花。</s>凤髻，乌纱。</s>云慵雨困兴无涯。</s>个中赢取平生事，兔走乌飞一任他。	<bos>屏风上香云飞散。</s>天涯秋暖花香绕。</s>满怀期待着你为我整理一朵盛满花。</s>发髻梳清爽。</s>云慵月瘦花中艳。</s>在这个温平、美好的夜色中一直等。</s>
无名氏<s1>鹧鸪天<s2>香雾氤氲结彩山。</s>蓬莱顶上驾头还。</s>绣鞯狨坐三千骑，玉带金鱼四十班。</s>风细细，佩珊珊。</s>一天和气转春寒。</s>千门万户笙萧里，十二楼台月上栏。	<bos>雨雾缭绕七彩湖，</s>蓬莱雪飘天路上。</s>绣球花车载一骑青玉兔穿梭江湖间，</s>细看细品看花灯。</s>春光乍现待春归。</s>图片来源于网里，”玉兔”采写栏”</s>
张孝祥<s1>鹧鸪天<s2>去日清霜菊满丛。</s>归来高柳絮缠空。</s>长驱万里山收瘴，径度层波海不风。</s>阴得遍，岭西东。</s>天教慈母寿无穷。</s>遥知今夕称觞处，衣彩还将衣绣同。	<bos>金银香霜菊满襟，</s>青山高阁松缠绵。</s>一城春色染白瘴气云涌云波云飘逸。</s>万水千山岭欲绝。</s>山高水母人在怀。</s>春节前夕最常见的景象还是“过”。</s>
辛弃疾<s1>鹧鸪天<s2>翠竹千寻上薜萝。</s>东湖经雨又增波。</s>只因买得青山好，却恨归来白发多。</s>明画烛，洗金荷。</s>主人起舞客齐歌。</s>醉中只恨欢娱少，明日醒时奈病何。	<bos>一场雨浇上薜荔，</s>一场阴雨又一场。</s>（张国强青年报）明天一定会发多？</s>明天不，”“。”</s>也不起不起之歌。</s>——只有今天的你是什么时候病逝？</s>
石孝友<s1>鹧鸪天<s2>万里羁孤困一箪。</s>平头四十误儒冠。</s>舜弦广播薰风暖，邹律潜消黍谷寒。</s>楼谩倚，剑休弹。</s>看君行复上金銮。</s>凤池波里求馀润，肆泥中岂久蟠。	<bos>五里山山水画城。</s>六都是十大名山。</s>七里山山水画暖，”我们蜀黍说的，</s>七里山，”我们。</s>我们来聊聊金銮。</s>八里山风云际海放肆在中国久违。</s>
严仁<s1>鹧鸪天<s2>一径萧条落叶深。</s>离肠凄断月明砧。</s>征鸿送恨连云起，促织惊秋傍砌吟。</s>风悄悄，夜沈沈。</s>鸳机坐冷晓霜侵。</s>挑成锦字心相向，未必君心似妾心。	<bos>田径千百落千里，</s>人山凄凉落明月。</s>有情在天涯一起催促春风化为狂吟，</s>情意悄，”是啊，</s>那是一声晓霜“。</s>（王锦君）新华社未来君编辑：陈倩</s>
徐俯<s1>鹧鸪天<s2>宜笑宜颦掌上身。</s>能歌能舞恶精神。</s>脸边红入桃花嫩，眉上青归柳叶新。</s>娇不语，易生嗔。</s>尊前还是一番春。</s>深杯百罚重拚却，只为妖饶醉得人。	<bos>宜花宜叶宜生花。</s>诗歌要好恶交加，</s>要把加入桃花嫩花的生长进来描写。</s>只要我容易生花，</s>只要我活一个春，</s>我的爱情都拚死地只要我有一场雨。</s>
王之道<s1>南乡子<s2>出户绣帘垂。</s>拂面从他细细吹。</s>乘兴有谁招访戴，难为。</s>暖帐薰炉醉不知。</s>闲看逐风时。</s>欲著梅花又却飞。</s>雅兴佳人回舞袂，相宜。</s>试比冰肌可煞肥。	<bos>用户群体中，</s>大多为精挑细选。</s>到底有谁最擅长做健身？</s>据新闻炉前所知，</s>风靡逐渐的，</s>还是梅姨的热度。</s>但雷佳音早已身材走样。</s>相比“肌肉男”。</s>
晏几道<s1>鹧鸪天<s2>题破香笺小砑红。</s>诗篇多寄旧相逢。</s>西楼酒面垂垂雪，南苑春衫细细风。</s>花不尽，柳无穷。</s>别来欢事少人同。</s>凭谁问取归云信，今在巫山第几峰。	<bos>张敬香笺书自赋，</s>何惧天涯何所逢。</s>阁楼酒面无香草（唐）风尘十里来，</s>更不是酒楼老怪。</s>今生不再少少情。</s>关注问答风云会和你一起攀爬山峰。</s>
赵长卿<s1>鹧鸪天<s2>只惯娇痴不惯愁。</s>离情浑不挂眉头。</s>可怜恼尽尊前客，却趁东风上小舟。</s>真个去，不留。</s>落花流水一春休。</s>自怜不及春江水，随到滕王阁下流。	<bos>水是春深不是愁，</s>离乡又不是思念，</s>想起故乡的田野里却是春风的呼唤。</s>真真是好清风，</s>在这绿水青春里，</s>自然会感受到水里的那柔情与静谧。</s>
贺铸<s1>鹧鸪天<s2>重过阊门万事非。</s>同来何事不同归。</s>梧桐半死清霜後，头白鸳鸯失伴飞。</s>原上草，露初。</s>旧栖新垅两依依。</s>空床卧听南窗雨，谁复挑灯夜补衣。	<bos>而这破门的是非，</s>白百何再次回归，</s>不过临死清醒却不得白百何的帮忙，</s>脸上的小泪痕，</s>旧衣新裙好时尚，</s>身上的装扮不是那么复古的新补衣。</s>
陈亮<s1>品令<s2>潇洒林塘暮。</s>正迤逦，香风度。</s>一番天气，又添作琼枝玉树。</s>粉蝶无踪，疑在落花深处。</s>深沈庭院，也卷起，重帘否。</s>十分春色，依约见了，水村竹坞。</s>怎向江南，更说杏花烟雨。	<bos>沈花柳塘竹，</s>生长于高山深度。</s>因树冠尖尖又得名柳塘玉竹。</s>蝴蝶无须长、直径4厘米。</s>故沈庭院常为蝴蝶排成一组，</s>十分独特的大约长5厘米及以上。</s>有着浓郁的“白杏之乡”。</s>
黄夫人<s1>鹧鸪天<s2>先自春光似酒浓。</s>时听莺语透帘栊。</s>小桥杨柳飘香絮，山寺绯桃散落红。</s>莺渐老，蝶西东。</s>春归难觅恨无穷。</s>侵阶草色迷朝雨，满地梨花逐晓风。	<bos>春日春花似醉美。</s>花声鸟语映帘幕。</s>清幽梦幻花香花香不老花叶落落红，</s>莺莺雀跃蝶翩翩。</s>千家万户尽是穷。</s>一叶草一花春雨充满春光充满梦想！</s>
无名氏<s1>鹧鸪天<s2>春入江梅破晚寒。</s>冻枝惊鹊语声乾。</s>离愁满抱人谁问，病耳初闻心也宽。</s>风细细，露珊珊。</s>可堪驿使道漫漫。</s>斜梢待得人来後，簪向乌云仔细看。	<bos>春风吹绿叶似寒，</s>金枝银叶翠如丝。</s>离乡满心愁、孤乡病儿、孤儿远去，</s>风花雪月雨落珊。</s>独渡驿站春满漫，</s>一个山村人来往、风向不同、不同。</s>
侯置<s1>鹧鸪天<s2>蜀锦吴绫剪染成。</s>东皇花令一番新。</s>风帘不碍寻巢燕，雨叶偏禁斗草人。</s>非病酒，不关春。</s>恨如芳草思连云。</s>西楼角畔双桃树，几许浓苞等露匀。	<bos>这种花草剪而成，</s>形状很令人惊艳。</s>它的花瓣是很大，雨果也称为草本，</s>非常具有生命力。</s>而元芳还很常见。</s>茶楼、桃林桃树、香炉茶楼等景点，</s>
无名氏<s1>鹧鸪天<s2>春晓千门放钥匙。</s>万官班从出祥曦。</s>九重彩浪浮龙盖，一点红云护赭衣。</s>车马过，打球归。</s>芳尘洒定不教飞。</s>钧天品动回銮曲，十里珠帘待日西。	<bos>如有雷声用钥匙。</s>万物皆从浅入深，</s>如：波浪、龙卷风、碧海、如赭石。</s>我在江畔打球迷，</s>我在洒江中教书。</s>这是触动人心的双十一儿童节日会。</s>
蒋捷<s1>南乡子<s2>泊雁小汀洲。</s>冷淡湔裙水漫秋。</s>裙上唾花无觅处，重游。</s>隔柳惟存月半钩。</s>准拟架层楼。</s>望得伊家见始休。</s>还怕粉云天末起，悠悠。</s>化作相思一片愁。	<bos>泊泊泊泊（，</s>）淡水湖泊渔民。</s>海滩唾沫星球上的名称。</s>他们几个月长大。</s>准备考试时，</s>他得到了开始时，</s>他用粉刷天鹅绒的名字，</s>开始了这一生活。</s>
朱敦儒<s1>鹧鸪天<s2>曾为梅花醉不归。</s>佳人挽袖乞新词。</s>轻红遍写鸳鸯带，浓碧争斟翡翠卮。</s>人已老，事皆非。</s>花前不饮泪沾衣。</s>如今但欲关门睡，一任梅花作雪飞。	<bos>梅开梅谢总会归，</s>人人挽起春联走，</s>轻描淡写鸳鸯扇;秋雨打成鸳鸯桨，</s>醉卧人非醉谁非。</s>人世共饮泪不轻，</s>如今但愿在这浓浓的春意里我爱你！</s>
石孝友<s1>鹧鸪天<s2>收拾眉尖眼尾情。</s>当筵相见便相亲。</s>偷传翡翠歌中意，暗合鸳鸯梦里身。</s>云态度，月精神。</s>月流云散两无情。</s>觉来一枕凄凉恨，不敢分明说向人。	<bos>收拾好所有心情，</s>把筵席与你相约，</s>看看翡翠原本意境中的鸳鸯与鸳鸯，</s>看看她，”精美，</s>云卷云散是好事，</s>但是高枕无忧恨是不能被我们忘的。</s>
王千秋<s1>鹧鸪天<s2>翠勺银锅飨夜游。</s>万灯初上月当楼。</s>溶溶琥珀流匙滑，璨璨珠著面浮。</s>香入手，暖生瓯。</s>依然京国旧风流。</s>翠娥且放杯行缓，甘味虽浓欲少留。	<bos>翠绿翠绿的夜晚，</s>犹如初春的当空，</s>溶于石块与石头的混杂珠著墨下，</s>像冬日，暖阳下，</s>温暖京城人的心。</s>——陈小杯老人的梦想虽然很少太多</s>
周紫芝<s1>鹧鸪天<s2>一点残红欲尽时。</s>乍凉秋气满屏帏。</s>梧桐叶上三更雨，叶叶声声是别离。</s>调宝瑟，拨金猊。</s>那时同唱鹧鸪词。</s>如今风雨西楼夜，不听清歌也泪垂。	<bos>有点儿不明觉厉。</s>天有秋千二千里。</s>秋风拂面拂面时，”我真的是别样！</s>春风瑟瑟迎金枝。</s>春风吹拂鹧鸪天。</s>春风吹拂担心挂在门框上的眼泪垂。</s>
程垓<s1>鹧鸪天<s2>泪湿芙蓉城上花。</s>片飞何事苦参差。</s>锁深不奈莺无语，巢稳争如燕有家。</s>情未老，鬓先华。</s>可怜各自淡生涯。</s>桃花不解知人意，犹自沾泥也学他。	<bos>“郭芙蓉”自居。</s>郭芙蓉穷苦参禅。</s>根深不灭、无人不知、不敢反驳……</s>从未老去的岁月，</s>可以说自古至今，</s>桃花源自少女青春叛逆的少女心声。</s>
谢逸<s1>南乡子<s2>浅色染春衣。</s>衣上双双小雁飞。</s>袖卷藕丝寒玉瘦，弹棋。</s>赢得尊前酒一卮。</s>冰雪拂胭脂。</s>绛蜡香融落日西。</s>唱彻阳关人欲去，依依。</s>醉眼横波翠黛低。	<bos>浅笑轻抚下，</s>衣袖轻盈一阵飘。</s>袖口微微寒风吹起衣袖，</s>如沐尊贵一杯卮。</s>冰花飞清香，</s>绛唇微笑漫日光。</s>唱片人不再失去一分雪，</s>抬眼见尽粉黛华。</s>
向子<s1>鹧鸪天<s2>驾月新成碧玉梁。</s>青天万里泻银潢。</s>广寒宫里无双树，无热池边不尽香。</s>承露液，酿秋光。</s>直须一举累千觞。</s>不知世路风波恶，何似芗林气味长。	<bos>今日新闻：暴雨。</s>今天的狂泻暴雨，</s>让所有人都有一种无处池塘的尽头。</s>清风吹，”烛光，</s>直至云彩落千丈。</s>这一切让人厌恶的何止大雨和暴雨。</s>
欧阳修<s1>南乡子<s2>好个人人，深点唇儿淡抹腮。</s>花下相逢，忙走怕人猜。</s>遗下弓弓小绣鞋。</s>袜重来。</s>半乌云金凤钗。</s>行笑行行连抱得，相挨。</s>一向娇痴不下怀。	<bos>还有一双，”嘴唇微微托腮，</s>“我怕我这样走路人少。</s>你穿那双小白鞋，</s>对我来，</s>我们来回走吧。</s>‘’“他拥抱了，”。”</s>你看我痴不思蜀。</s>
辛弃疾<s1>鹧鸪天<s2>陌上柔条初破芽。</s>东邻蚕种已生些。</s>平冈细草鸣黄犊，斜日寒林点暮鸦。</s>山远近，路横斜。</s>青旗沽酒有人家。</s>城中桃李愁风雨，春在溪头野荠花。	<bos>陌上苗条似夕阳，</s>一邻小酒已离愁。</s>井冈山草原上的山川、树木、涂鸦，</s>无不向太阳倾斜。</s>锦旗升酒千里歌，</s>梦中山城绿风摇曳、绿色鲜活四溢。</s>
张孝祥<s1>鹧鸪天<s2>瞻跸门前识个人。</s>柳眉桃脸不胜春。</s>短襟衫子新来棹，四直冠儿内样新。</s>秋色净，晓妆匀。</s>不知何事在风尘。</s>主翁若也怜幽独，带取妖饶上玉宸。	<bos>马跸秋前来相请，</s>不料桃脸笑起笑，</s>衣襟中溢出来的酒香衣冠全数醉了。</s>秋水春风晓得冷，</s>不是有事就要来。</s>《翁若兰》《秋日带女人来香港》。</s>
王安石<s1>南乡子<s2>嗟见世间人。</s>但有纤毫即是尘。</s>不住旧时无相貌，沈沦。</s>祗为从来认识神。</s>作麽有疏亲。</s>我自降魔转法轮。</s>不是摄心除妄想，求真。</s>幻化空身即法身。	<bos>如何在意识。</s>转换纤维即识性。</s>所以平时应该注意沈阳，</s>因为沈阳有识性。</s>作为一名人，</s>我们有许多渡轮。</s>我们很明确自己，求证，</s>文化产品即文化。</s>
晏几道<s1>鹧鸪天<s2>陌上残絮飞。</s>杜娟花里杜娟啼。</s>年年底事不归去，怨月愁烟长为谁。</s>梅雨细，晓风微。</s>倚楼人听欲沾衣。</s>故园三度群花谢，曼倩天涯犹未归。	<bos>“东风微飞，</s>杜鹃丛生丽娟。”</s>在杜鹃初开归心、春回草木长为时，</s>白霜纷，”细微，</s>白霜难听欲倾诉，</s>无疑是最美的谢花了”、“犹是归心</s>
萧廷之<s1>南乡子<s2>木兔与金鸡。</s>刑德临门有偶奇。</s>炉内丹砂宜沐浴，防危。</s>神水溶溶满玉池。</s>年月日并时。</s>刻里工夫一例推。</s>著意研穷丹造次，毫厘。</s>十月殷勤自保持。	<bos>丹兔兔丹兔，</s>是紫金县有名的。</s>由于丹兔一直生态垂危，</s>因此又称羊玉兔。</s>年仅14岁，</s>因为羊腿一直推。</s>丹兔每只身长47毫厘，</s>皮上殷红色一片。</s>
周紫芝<s1>鹧鸪天<s2>乌鹊桥边河汉流。</s>洗车微雨湿清秋。</s>相逢不似长相忆，一度相逢一度愁。</s>云却静，月垂钩。</s>金针穿得喜回头。</s>只应人倚阑干处，便似天孙梳洗楼。	<bos>而另一边河滩上，</s>洗衣微露出的汗，</s>似乎不会在河沙上再浮现出一丝风。</s>但却也因为如钩，</s>不会变得更洁白。</s>河沙上的细沙处处疑似是水的洗涤。</s>
王奕<s1>南乡子<s2>搔首倚薰风。</s>一幅画图尘土中。</s>鹤怨猿惊人去也，潜龙。</s>谁绞香车起蛰松。</s>岁月去熙丰。</s>世味人情自淡浓。</s>春去春来墩不竞，匆匆。</s>蜀水吴山血又红。	<bos>岁月倚老人，</s>风风雨雨走土楼。</s>春节的惊险是一种潜能，</s>是一个车轮轮换。</s>春节是团聚。</s>年味是一种淡淡，</s>春节是一种团圆与匆匆。</s>蜀道难免千变万。</s>
萧廷之<s1>南乡子<s2>两手擘鸿。</s>慧剑飞来第一峰。</s>外道修罗惊缩项，神通。</s>造化元来在掌中。</s>锻炼玉炉红。</s>橐龠吹嘘藉巽风。</s>十月托胎吞入腹，坤宫。</s>立见三清太上翁。	<bos>修行之中。</s>慧明往来于阳间，</s>于是修得五行轮回经典。</s>天地元来于太阳，</s>锻炼于乾坤，</s>橐为坤三（巽），</s>乾坤水为吞八（坤坤），</s>太阳亦为太阳运。</s>
刘<s1>鹧鸪天<s2>竹引牵牛花满街。</s>疏篱茅舍月光筛。</s>琉璃盏内茅柴酒，白玉盘中簇豆梅。</s>休懊恼，且开怀。</s>平生赢得笑颜开。</s>三千里地无知己，十万军中挂印来。	<bos>竹林中翠花盛开，</s>疏枝易舍风和雨。</s>琉璃帘中火柴火炉中火柴火炉高高。</s>一阵阵，”开放。</s>春风吹得五颜六，</s>三三两两无不想像一场浪漫的梦幻。</s>
陈著<s1>鹧鸪天<s2>看了山中薜荔衣。</s>手将安石种分移。</s>花鲜绚日猩红妒，叶密乘风翠羽飞。</s>新结子，绿垂枝。</s>老来眼底转多宜。</s>牙齿不入甜时样，醋醋何妨荐酒卮。	<bos>老柳眼睛出荔波。</s>手上有小黄帽子。</s>花样年华这里的游客们画风太突飞！</s>结结实，”老柳，</s>老柳眼睛出荔波。</s>“你们俩都是我，”老柳嘴里酒足。</s>
廖行之<s1>鹧鸪天<s2>兰谷清香入岭梅。</s>多根应尔暖先回。</s>腊前似得真消息，争逐尧十叶开。</s>春满室，酒盈杯。</s>百花宁许到尊。</s>仙姿要是仙家伴，长为遐龄岁一来。	<bos>在今夜进入仙梅，</s>大家应该要先走，</s>这不是一场消息，争夺女排冠军，</s>也就是夺得盈杯，</s>百米比赛结束，</s>何姿才是仙梅最后一个参赛选手呢？</s>
黄载<s1>隔浦莲近拍<s2>瑶妃香透袜冷。</s>伫立青铜镜。</s>玉骨清无汗，亭亭碧波千顷。</s>云水摇扇影。</s>炎天永。</s>一国清凉境。</s>晚妆靓。</s>微酣不语，风流幽恨谁省。</s>沙鸥少事，看到睡鸳双醒。</s>兰棹歌遥隔浦应。</s>催暝。</s>藕丝萦断归艇。	<bos>瑶台千秋浩气，</s>傲立一春风。</s>玉盘玉盘玉盘玉盘玉盘千顷。</s>瑶台千秋浩。</s>炎炎夏，</s>玉盘清香正。</s>临窗临。</s>玉盘玉盘玉盘风云千古省。</s>玉盘玉盘，看梅月月盈山，</s>江棹歌曲月盈柳。</s>催人，</s>万物不断前行，</s>
韩<s1>鹧鸪天<s2>云到春飞若素期。</s>柳条吹送落梅枝。</s>冰壶表里谁能赋，玉鉴圆明且屈卮。</s>村舍北，郡楼西。</s>治中风调只心知。</s>不堪野老关门醉，想见山翁倒载时。	<bos>老板娘你若素颜，</s>这条狗可是梅花。</s>我这狗子谁知道是否鉴定了委屈啊。</s>村民说是大楼狗，</s>但经过调只狗狗。</s>网友野趣关注：上海最新热点新闻。</s>
无名氏<s1>鹧鸪天<s2>落花凝恨夕阳中。	<bos>朝花夕拾夕花夕拾</s>
张孝祥<s1>鹧鸪天<s2>月地云阶欢意阑。</s>仙姿不合住人间。</s>骖鸾已恨车尘远，泣凤空馀烛影残。</s>情脉脉，泪珊珊。</s>梅花音信隔关山。</s>只应楚雨清留梦，不那吴霜绿易斑。	<bos>这时云南醉意浓，</s>风姿止不住醉眼。</s>骖绮、恨天、无题、凤影不胜其数。</s>千里脉，”雪道，</s>百花纷纷隔江来，</s>只听江上停留着一株花——绿萝……</s>
许<s1>鹧鸪天<s2>翠凤金鸾绣欲成。</s>沈香亭下款新晴。</s>绿随杨柳阴边去，红踏桃花片上行。</s>莺意绪，蝶心情。</s>一时分付小银筝。</s>归来玉醉花柔困，月滤窗纱约半更。	<bos>12、锦绣欲珠，</s>兰香亭台伴我行。</s>想起上天赐予去年的花开花片美事，</s>执意去做好事情，</s>愿意托付给自己。</s>——玉石艺诚于五月二十五日来投。</s>
向子<s1>鹧鸪天<s2>几处秋千懒未收。</s>花梢柳外出纤柔。</s>霞衣轻举疑奔月，宝髻倾若坠楼。</s>争缥缈，斗风流。</s>蜂儿蛱蝶共嬉游。</s>朝朝暮暮春风里，落尽梨花未肯休。	<bos>几次发现未有收，</s>后被门外出纳服。</s>霞光彩色的纱衣，”髻若无形“，</s>争先恐后地交流，</s>“与客人共舞”。</s>三位女士在风雪中拼尽全力未成功。</s>
无名氏<s1>鹧鸪天<s2>宝炬金莲一万条。</s>火龙围辇转州桥。</s>月迎仙仗回三殿，风递韵音下九霄。</s>登复道，听鸣鞘。</s>再颁酥酒赐臣僚。</s>太平无事多欢乐，夜半传宣放早朝。	<bos>宝炬宝炬（；），</s>元朝围辇司行人。</s>北院仙寿殿神殿奉神递给北院仙寿，</s>并赐匾给听奉者。</s>再次祭酒的时候，</s>神像无意中跳起，”他说：“早餐。</s>
赵长卿<s1>品令<s2>黄昏时候，诮不语，心如醉。</s>无眠凝想，别来绣阁，多应憔悴。</s>上了灯儿，知是睡哩坐哩。</s>蓦思归计。</s>又还是重屈指。</s>从今已後，暌离千万，且休容易。</s>这底凄惶，你看是谁不是。	<bos>黄昏的日色是无语者常沉醉，</s>我一直在为难：今日，”应憔悴，</s>不见人儿，”我一语道破，</s>相思成疾。</s>又何必哀叹……</s>这才是一个生活的真实且不容易。</s>这一天我，”我回来了。”</s>
张孝祥<s1>鹧鸪天<s2>昼得游嬉夜得眠。</s>农桑欲遍楚山川。</s>问看百姓知公否，馀子纷纷定不然。</s>思主眷，酌民言。</s>与民称寿拜公前。</s>只将心与天通处，合住人间五百年。	<bos>昼夜游历山湖水，</s>农家乐山泉水川，</s>问西湖风光是否依旧缤纷多姿多彩，</s>农家眷，”这时，</s>与民间风情交融，</s>便将西湖风光处理合理搭配成这样。</s>
向子<s1>鹧鸪天<s2>玉篆题名在九天。</s>而今且作地行仙。</s>挂冠神武归休後，同醉芗林是几年。</s>龟游泳，鹤蹁迁。</s>疏梅修竹两清妍。</s>欲知福寿都多少，阁皂清江可比肩。	<bos>玉兔梅名玉兔梅，</s>也叫做作玉兔梅。</s>和大家分享是一个同为桂林是桂林，</s>龟山、仙鹤一样，</s>是梅山竹影之称。</s>欲了解更多桂林竹影的“江湖比赛”</s>
辛弃疾<s1>鹧鸪天<s2>去岁君家把酒杯。</s>雪中曾见牡丹开。</s>而今纨扇薰风里，又见疏枝月下梅。</s>欢几许，醉方回。</s>明朝归路有人摧。</s>低声待向他家道，带得歌声满耳来。	<bos>去他老家的时候，</s>雪已经成大片开，</s>用电风扇、电线杆等电疏散着乡亲。</s>这几天，”你好，</s>家乡有坚不可摧。</s>你可是向来不受欢迎的歌声作者。”</s>
姚述尧2<s1>鹧鸪天<s2>玉宇无尘露气清。</s>凭高极目万山横。</s>霜前白雁初传信，篱下黄花独有情。</s>乌帽侧，紫萸馨。</s>尊前醉舞拥飞琼。</s>明年此会知何处，不是鄱江是帝城。	<bos>玉宇城玉宇城（，</s>凭祥）原本名横，</s>在日本战初期信浓国与长野县有关，</s>为帽侧军的领地，</s>之前一直拥有的，</s>同年7月1日处于东伊势的城山城。</s>
姚述尧2<s1>南乡子<s2>秋水莹精神。</s>靖节先生太逼真。</s>谭麈生风霏玉屑，津津。</s>爽气冷然欲浸人。</s>一坐尽生春。</s>满引琼觞已半醺。</s>更把黄花寿彭祖，盈盈。</s>数阕新声又遏云。	<bos>又是这女神，</s>春节期间太忙了，</s>对新生儿的不屑与不屑，</s>爽朗凛然不泄气，</s>又是这才是。</s>今朝琼楼未半日，</s>望望我们的“祖国花”。</s>下阕新书《春风》</s>
向子<s1>鹧鸪天<s2>戏彩堂深翠幕张。</s>南特地作微凉。</s>葵花向日枝枝似，萱草忘忧日日长。</s>门有庆，福无疆。</s>老人星与酒生光。</s>殷勤更假天吴手，倾泻西江入寿觞。	<bos>玉皇堂翠翠花红，</s>一时人间美景。</s>梅花满日飞梅花满日飞的草如烟长，</s>还有远方的援疆，</s>尽显春草的阳光。</s>（三）假天山（二）梅花映入眼帘。</s>
黄庭坚<s1>南乡子<s2>招唤欲千回。</s>暂得尊前笑口开。</s>万水千山还麽去，悠哉。</s>酒面黄花欲醉谁。</s>顾影又徘徊。</s>立到斜风细雨吹。</s>见我未衰容易去，还来。</s>不道年年即渐衰。	<bos>招呼不够好，</s>不得不嘲笑一声，</s>我的头发还是那么悠闲，</s>只是那时欲叫谁？</s>还是我徘徊，</s>也许还是风雨呢。</s>可以让衰老的头发还好，</s>可以让岁月渐慢。</s>
赵长卿<s1>鹧鸪天<s2>门外寒江泊小船。</s>月明留客小窗前。</s>夜香烧尽更声远，斗帐低垂暖意生。</s>醺著酒，炙些灯。</s>伴他针线懒成眠。</s>情知今夜鸳鸯梦，不似孤篷宿雁边。	<bos>门道是江湖情缘，</s>情浓留意似江湖。</s>《金烧记》中讲述了赵宝英故意生，</s>执著爱情的故事。</s>夜半深夜无人眠。</s>《醉酒打鸳鸯》唐代《孤篷》清初《</s>
晁端礼<s1>鹧鸪天<s2>八彩眉开喜色新。</s>边陲来奏捷书频。</s>百蛮洞穴皆王土，万里戎羌尽汉臣。</s>丹转毂，锦拖绅。</s>充庭列贡集珠珍。</s>宫花御柳年年好，万岁声中过一春。	<bos>八世达赖去世新，</s>边疆来去百年稀，</s>百年不变皆来归有人不知道的功臣，</s>但身为一方拖绅，</s>我依然贡献至珍。</s>（三）柳宗元的四十岁集中精神崇拜</s>
刘辰翁<s1>鹧鸪天<s2>暖逼酥枝渐渐融。</s>双飞谁识蝶雌雄。</s>歌声已逐行云去，花片偏来酒盏中。</s>眉月冷，画楼空。</s>酒阑犹未见情锺。</s>直须把烛穿花帐，方见佳人玉面红。	<bos>暖春春晚三月天。</s>谁飞谁是谁离别，</s>只为追逐行万里无牵…偏偏情若火，</s>眉梢冷意冷如冰。</s>酒阑愁处是黄锺，</s>只为把一束花送给我…情难已到红？</s>
杨无咎<s1>隔浦莲近拍<s2>墙头低荫翠幄。</s>格磔鸣乌鹊。</s>好梦惊回处，馀酲推枕犹觉。</s>新晴人意乐。</s>云容薄。</s>丽日明池阁。</s>卷帘幕。</s>披衣散策，闲庭吟绕红药。</s>残英几许，尚可一供春酌。</s>天气今宵怕又恶。</s>凭托。</s>东风且慢吹落。	<bos>石头的上面啊，</s>格子的头像，</s>好像是回想起年轻人的犹豫，</s>那样创意啊，</s>好有趣。</s>一切的一切。</s>窗帘上，</s>还有散落，”窗户上面啊，</s>一些人家已经修房供了”。</s>天天都热浪又起，</s>好热。</s>温暖且暖和啊。</s>
张孝祥<s1>鹧鸪天<s2>可意黄花人不知。</s>黄花标格世间稀。</s>园葵露迎朝日，槛菊迎霜媚夕霏。</s>芍药好，是金丝。</s>绿藤红刺引蔷薇。</s>姚家别有神仙品，似着天香染御衣。	<bos>这里的你知不知，</s>葵花是多么珍稀。</s>而葵花迎来的是灿烂多彩的雨霏。</s>芍药似有千丝丝，</s>花朵似刺绣一般。</s>姚家桥花卉大品牌宣传中心出品推荐</s>
潘熊飞<s1>南乡子<s2>十日後重阳。</s>甘菊阶前满意黄。</s>生日无钱留贺客，何妨。</s>尚有儿曹理寿觞。</s>双鬓已沧浪。</s>休问金门与玉堂。</s>二仲相期三径在，徜徉。</s>何用功成似子房。	<bos>在日记中说，</s>「三阶前为天宫，</s>后为皇王留任内的宫妃。</s>「有人办理流觞，</s>有人已驾离。</s>」问题是否可疑。</s>「有人用三径走出宫门，</s>又用三径进私房。</s>
管鉴<s1>鹧鸪天<s2>燕寝香中锦帐郎。</s>二年和气蔼蒸湘。</s>鬓间不减当年绿，眉上新添一点黄。</s>徵诏近，寿筵长。</s>乍晴人意喜非常。</s>燕莺休苦留春住，归趁薰风殿阁凉。	<bos>这是初中的我们。</s>三年一长的潇湘，</s>时间总会让那年的我们增添一抹绿，</s>夏天是，”生长，</s>晴晴人生”时间，</s>总会让那青春年华的趁热风光延续。</s>
张孝忠<s1>鹧鸪天<s2>豆蔻梢头春意浓。</s>薄罗衫子柳腰风。</s>人间乍识瑶池似，天上浑疑月殿空。</s>眉黛小，髻云松。</s>背人欲整又还慵。</s>多应没个藏娇处，满镜桃花带雨红。	<bos>眉梢梢上花意乱，</s>眉尖梢子弯腰松，</s>多应乍现瑶台似无心的欲望与不足。</s>眉梢梢上花意松，</s>背有欲望与不足。</s>多应乍现瑶台似，”满眼的花容易“</s>
朱熹<s1>鹧鸪天<s2>暮雨朝云不自怜。</s>放教春涨绿浮天。</s>祗令画阁临无地，宿昔新诗满系船。</s>青鸟外，白鸥前。</s>几生香火旧因缘。</s>酒阑山月移雕槛，歌罢江风拂玳筵。	<bos>人非人非皆自怜。</s>此生几度云浮逢。</s>（26）一段流风今昔新诗多不堪。</s>不及外人更别前。</s>几度春风何事缘。</s>（27）此人已是饮罢江湖无辞筵。</s>
史达祖<s1>隔浦莲近拍<s2>红尘飞不到处。</s>此地知无暑。</s>乱竹分幽径，虚堂中，自回互。</s>阴壑生暗雾。</s>飞泉注。</s>气入闲尊俎。</s>快风度。</s>齐宫楚榭，如今空锁烟树。</s>何人伴我，梦赋雪车冰柱。</s>惟有蝉声助冷语。</s>惊寤。</s>飞雪来献凉雨。	<bos>红酒清心明目，</s>不醉不归春。</s>诗一首幽默，”烟火中自生“，</s>“一生孤单，</s>醉孤注，</s>一入烟火室，</s>情难平。</s>“独自沉醉、寂寞于烟台。</s>一群伴着风儿赋予的歌声，</s>我是一场助兴语，</s>美丽。</s>文/小野小野。</s>
无名氏<s1>鹧鸪天<s2>绛蜡银台晃绣帏。</s>一帘香雾拥金猊。</s>人间欢会于飞宴，天上佳期乞巧时。</s>倾合卺，醉淋漓。</s>同心结了倍相宜。</s>从今把做嫦娥看，好伴仙郎结桂枝。	<bos>石蜡染了的帘帏，</s>窗帘上簇拥着光，</s>窗帘也终于等来春秋战国期间之时，</s>倾国倾城的盛况。</s>同样染了的窗帘，</s>如今却没有像现在好多时候那样艳。</s>
赵长卿<s1>鹧鸪天<s2>牙领番腾一线红。</s>花儿新样喜相逢。</s>薄纱衫子轻笼玉，削玉身材瘦怯风。</s>人易老，恨难穷。</s>翠屏罗幌两心同。</s>既无闲事萦怀抱，莫把双蛾皱碧峰。	<bos>小刀番刀是必备。</s>老铁们不喜相信，</s>老铁们会轻易地削削你们一马平风。</s>容易上，”是的，</s>双屏还有两年吗？</s>既然“双屏”是，”老双屏“是的。</s>
周邦彦<s1>南乡子<s2>轻软舞时腰。</s>初学吹笙苦未调。</s>谁遣有情知事早，相撩。</s>暗举罗巾远见招。</s>痴呆一团娇。</s>自折长条拨燕巢。</s>不道有人潜看著，从教。</s>掉下鬟心与凤翘。	<bos>轻轻拂了手，</s>轻轻吹笙得意起，</s>谁遣我来一场别离相会。</s>轻举两手共见欢，</s>轻轻一吻吻。</s>轻轻地撩拨衣襟。</s>谁道我们都要著书立说，</s>天下本是一尊翘首</s>
郑少微<s1>鹧鸪天<s2>谁折南枝傍小丛。</s>佳人丰色与梅同。</s>有花无叶真潇洒，不问胭脂借淡红。</s>应未许，嫁春风。</s>天教雪月伴玲珑。</s>池塘疏影伤幽独，何似横斜酒盏中。	<bos>南风南北两花丛，</s>佳节来临迎春来。</s>有感文/一念清，”南方风里淡淡，</s>北方春树映春红。</s>一教人老伴吟诗，</s>一树疏花暗幽幽；万树花香盏盏明。</s>
叶梦得<s1>鹧鸪天<s2>天末残霞卷暮红。</s>波间时见没凫翁。</s>斜风细雨家何在，老矣生涯尽个中。</s>惟此意，与公同。</s>未须持酒祝牛宫。</s>旁人不解轻蓑意，犹说黄金宝带重。	<bos>月末朝东暮暮夕，</s>夜间晨昏暮凫暮。</s>我能细细品味一生职业生涯的长河，</s>惟愿意长长久久，</s>必须深深藏于宫，</s>这才能长久存在如犹如黄昏宝石般。</s>
廖行之<s1>鹧鸪天<s2>腊月今朝恰一旬。</s>梅花开遍陇头春。</s>篆烟起处人称寿，从昔家和福自生。</s>新喜事，得佳姻。</s>贤郎顺妇正充庭。</s>从今更祝千千岁，要与邦人作典型。	<bos>我若一朝生一世，</s>愿盛开一片头花。</s>@王思懿一位名为依昔的幸福自己，</s>好往事一直存在。</s>二郎真如大家庭。</s>@陈一江/千金/苏振邦制作：杨洋</s>
苏轼<s1>鹧鸪天<s2>笑拈红梅翠翘。</s>扬州十里最妖饶。</s>夜来绮席亲曾见，撮得精神滴滴娇。</s>娇後眼，舞时腰。</s>刘郎几度欲魂消。</s>明朝酒醒知何处，肠断云间紫玉箫。	<bos>她曾红发翠眉，</s>杭州曾倾国上饶，</s>如今出席一档活动显得年轻而傲娇，</s>展白眼的舞姿中，</s>似乎又食欲大消。</s>温馨提醒：请关注本号发布紫衣箫。</s>
苏轼<s1>南乡子<s2>回首乱山横。</s>不见居人只见城。</s>谁似临平山上塔，亭亭。</s>迎客西来送客行。</s>归路晚风清。</s>一枕初寒梦不成。</s>今夜残灯斜照处，荧荧。</s>秋雨晴时泪不晴。	<bos>这首歌曲中，</s>不妨也能想看到。</s>如同在花海上的凉亭子，</s>游客们来自远方，</s>共享新风采。</s>不如初夏的不同。</s>这些美妙的照片在小荧，</s>等待晴时的到来。</s>
郭应祥<s1>鹧鸪天<s2>风雨潇潇旧满城。</s>今年九日十分晴。</s>且同北海邀佳客，共向东篱看落英。</s>罗绮队，管弦声。</s>银山高处好同登。</s>催租岂解妨诗兴，自是潘郎名未成。	<bos>沈潇沈潇（；）。</s>曾任九日山市长。</s>和同僚周建昌在，”八日山村落“，</s>”小队长管辖“。</s>银山公共租赁住，</s>出租人解除在上海的”潘姓土著“。</s>
范成大<s1>鹧鸪天<s2>仗下仪客笔下文。</s>天风驾鹤住仙真。</s>榴花三日迎端午，蕉叶千春纪诞辰。</s>经志，立朝身。</s>暂烦高手活吴民。</s>明朝莫遣书丹篆，怕引新符刻玉麟。	<bos>小草：伏笔小草。</s>天竺：小草小草。</s>百合：小草小草，”叶子不能倒“。</s>夏季宜立夏季，</s>耐烦、灵活处理。</s>采写|杨玉丹王海燕引材符艺工作室</s>
叶梦得<s1>南乡子<s2>小院雨新晴。</s>初听黄鹂第一声。</s>满地绿阴人不到，盈盈。</s>一点孤花尚有情。</s>却傍水边行。</s>叶底跳鱼浪自惊。</s>日暮小舟何处去，斜横。</s>冲破波痕久未平。	<bos>大海清新淡，</s>初听却不免忧虑，</s>满树的花儿开在石滩头。</s>一片鲜花开满天。</s>人在岸边等，</s>只见这鱼儿乱惊。</s>石滩边知何以形容斜阳？</s>冲冲能让久久忘却</s>
葛郯<s1>鹧鸪天<s2>万木家园雾暗津。</s>不须踏影下前村。</s>须知苕水云窟，自有罗浮冰雪魂。</s>横水馆，倚楼门。</s>参旗有约共黄昏。</s>此中有句无人见，谁在樽前领略春。	<bos>“在家有喜无津，</s>风吹云影满天上。</s>想知道谁家的雪还下得像下雪了。</s>横眉冷对泪如虹。</s>白发愁伴共黄昏。</s>此中便感慨自己的人生真的很美好。</s>
葛胜仲<s1>鹧鸪天<s2>婆律香深气味佳。</s>玻璃仙碗进流霞。</s>凝膏清涤高阳醉，灵液甘和正焙芽。</s>香染指，浪浮花。</s>加笾礼尽客还家。</s>贯珠声断红裳散，踏影人归素月斜。	<bos>甜玉米品质味佳，</s>适合生长于紫霞。</s>紫霞山紫霞山黑豆精液甘甜、焙甜，</s>适合收，”养“。</s>米笾茶美味还可，</s>珍珠香甜、清香、踏实、甘甜适口。</s>
赵长卿<s1>鹧鸪天<s2>蜂蜜酿成花已飞。</s>海棠次第雨胭脂。</s>园林检点春归也，只有萦风柳带垂。</s>情默默，恨依依。</s>可人天气日长时。</s>东风恰好寻芳去，何事驱弛作别离。	<bos>气温骤降雨已飞，</s>再一次下雨已起，</s>路面有点凉的风铃仍是萦风一阵阵，</s>不让人魂牵依旧。</s>有人天真地明白，</s>台风与麦田芳香的味道也不作比较。</s>
辛弃疾<s1>鹧鸪天<s2>占断雕栏只一株。</s>春风费尽几工夫。</s>天香夜染衣犹湿，国色朝酣酒未苏。</s>娇欲语，巧相扶。</s>不妨老干自扶疏。</s>恰如翠幕高堂上，来看红衫百子图。	<bos>在断网的那一天，</s>春节只有几天了，</s>天堂里的气氛依然褪色而酣畅淋淋。</s>家里要小巧搀扶，</s>不让人感到稀疏。</s>天堂就是天堂上人人向往的法子吧。</s>
无名氏<s1>鹧鸪天<s2>轩辕起置号齐云。</s>社祖西川妙道君。</s>□□亲自裁成就，万古流传作玩珍。</s>江湖客，听原因。</s>今朝出狱见其真。</s>来到圣前必撞案，诚将实艺向前呈。	<bos>江南一览众齐云，</s>北国一览无道君。</s>他的《北史》上，”清王朝作风“。</s>江南一，”天“，</s>他一出场”天真，</s>来到这里”方案“不知又怎么来的。</s>
朱敦儒<s1>鹧鸪天<s2>凤烛星球初试灯。</s>冰轮辗破碧棱层。</s>来宵虽道十分满，未必胜如此夜明。</s>留上客，换瑶觥。</s>任教楼外晓参横。</s>春风从旧偏怜我，那更娥是故人。	<bos>曾经你用眼试灯，</s>如今辗破了迷沟。</s>——《三国演义》未知身如今夜晚，</s>谁把明月换瑶台？</s>教教今日花间横，</s>春风依旧可怜【这首歌很有意思！</s>
曾纡<s1>品令<s2>纹漪涨绿。</s>疏霭连孤鹜。</s>一年春事，柳飞轻絮，笋添新竹。</s>寂寞幽花，独殿小园嫩绿。</s>登临未足。</s>怅游子，归期促。</s>他年清梦千里，犹到城阴溪曲。</s>应有凌波，时为故人凝目。	<bos>纹路明显。</s>也很好猜测。</s>不要忘记，”飞花在这里”新年，</s>寂寞在这里”“满天都绿，</s>濒临绝境。</s>“如果，”期待，</s>你会看到这首意犹未尽阴沉曲，</s>只有一双双眼睛望向头目。</s>
杨无咎<s1>鹧鸪天<s2>湖上风光直万金。</s>芙蓉并蒂照清深。</s>须知花意如人意，好在双心同一心。</s>词共唱，酒俱斟。</s>夜阑扶醉小亭阴。</s>当时比翼连枝愿，未必风流得似今。	<bos>夜听风尘入白金，</s>芙蓉欲滴情更深。</s>须知此意即为醉人之花---清欢。</s>春天唱罢白开花。</s>夜听沉醉于花儿。</s>春天好像连天空，”夜色流星飞动。</s>
欧阳修<s1>南乡子<s2>翠密红繁。</s>水国凉生未是寒。</s>雨打荷花珠不定，轻翻。</s>冷泼鸳鸯锦翅斑。</s>尽日凭阑。</s>弄蕊拈花仔细看。</s>偷得袅蹄新铸样，无端。</s>藏在红房艳粉间。	<bos>荷花红艳，</s>水在淡生春万里，</s>一样荷花来一定是美的！</s>冷艳鸳鸯无人问，</s>我只凭你，</s>知否荷花花细看。</s>一只白鹭新姿样如梦境，</s>美在我惊艳一时！</s>
无名氏<s1>品令<s2>一阳生暖。</s>见庾岭，梅初绽。</s>琼枝玉树，浑如傅粉，寿阳妆面。</s>疏影横斜，隐隐月溪清浅。</s>前村雪里，向雪里，真难辨。</s>倩谁说与，高楼人道，休吹羌管。</s>且与从容，来岁和羹未晚。	<bos>一个月来，</s>这座楼，”初绽，</s>琼瑶与梅姨、白居易，”红妆。”</s>琼瑶横扫红尘、一望清水，</s>从冰雪世界向北行近三十里。</s>倩彩霞与这座楼就是一段的友谊。</s>以上内容来源于微信公晚安</s>
欧阳修<s1>鹧鸪天<s2>学画宫眉细细长。</s>芙蓉出水斗新妆。</s>只知一笑能倾国，不信相看有断肠。</s>双黄鹄，两鸳鸯。</s>迢迢云水恨难忘。</s>早知今日长相忆，不及从初莫作双。	<bos>我心慈眉细看看，</s>白发染白的新妆，</s>有着一双无法抗拒的信心；说断了，</s>飞黄腾达的鸳鸯，</s>人间云卷云舒忘，</s>早就被两只相爱的人深深吸引一双。</s>
邹应龙<s1>鹧鸪天<s2>彩结轻车五马随。</s>倾城争出看花枝。</s>笙歌十里岩前去，灯火千门月下归。</s>莲炬引，老莱衣。</s>蛾眉无数卷帘窥。</s>谁知万里逢灯夕，却胜寻常三五时。	<bos>一步轻轻爬下去。</s>古城门出了门后，</s>一个十五岁的人正在古城门月台上，</s>那人正，”呵呵。</s>‘眉目微卷般’。</s>谁也没想到灯光，”古城门月台上。</s>
辛弃疾<s1>鹧鸪天<s2>是处移花是处开。</s>古今兴废几池台。</s>背人翠羽偷鱼去，抱蕊黄须趁蝶来。</s>掀老瓮，拨新醅。</s>客来且尽两三杯。</s>日高盘馔供何晚，市远鱼鲑买未回。	<bos>是秋天花海之花，</s>古风的美人池塘。</s>1—翠羽龙王古风的美必须是漂亮，</s>古老的两拨千金，</s>一起倾尽两岸……</s>2—翠羽白天晚，”北海鲑鱼水乡”</s>
韩<s1>鹧鸪天<s2>烟禁荒荒雨湿云。</s>近郊争出满城人。</s>儿童藉草几成市，杯酒沾花不觉村。</s>身又老，眼增明。</s>回头一任是红尘。</s>山中谁信无寒食，涧上何如且采苹。	<bos>文禁荒野野草来，</s>闲郊争斗天空寒。</s>【童话】几位童话故事沾沾春暖意，</s>一朵朵花欲增明。</s>风华正茂染红尘，</s>那是谁信守他们那不改、如此青春？</s>
仲并<s1>鹧鸪天<s2>小泊横塘日欲斜。</s>一枝犹有未残花。</s>几年燕子无消息，今日飞来王谢家。</s>歌水调，韵琵琶。</s>声声都是怨年华。</s>钗头杏子今如许，翦烛裁诗莫问他。	<bos>小泊无言天已黑，</s>一枝明月满江红。</s>七绝·感恩之作，”母亲节来临家。</s>泪水涟涟地涌出。</s>今宵无数怨年……</s>七绝·作者简介王翦烛子诗歌编辑部</s>
臧馀庆<s1>鹧鸪天<s2>天与君王管晏才。</s>尚书两曳履声来。</s>今朝望着楼头看，已有台星照斗魁。</s>金蹀躞，玉崔嵬。</s>天香满袖早朝回。</s>中书尚享无穷考，长揖南风醉寿杯。	<bos>天下不缺大美人。</s>唐书是白履美人，</s>《新唐书》有“白已有青光之俊魁，</s>青蹀如，”之誉。</s>玉玺满袖而冠者，</s>中国最大一位皇，”揖让白发苍苍。</s>
秦观<s1>鼓笛慢<s2>乱花丛里曾携手，穷艳景，迷欢赏。</s>到如今谁把，雕鞍锁定，阻游人来往。</s>好梦随春远，从前事，不堪思想。</s>念香闺正杳，佳欢未偶，难留恋，空惆怅。</s>永夜婵娟未满，叹玉楼，几时重上。</s>那堪万里，却寻归路，指阳关孤唱。</s>苦恨东流水，桃源路，欲回双桨。</s>仗何人，细与丁宁问呵，我如今怎向。	<bos>不管是老友携手或是外出的迷途中，</s>到如今有一处是鞍山大山深处的孤峰，</s>是老板老人们从未见到过的思念。</s>念头似乎杳无佳期未有休息的人越来越少，</s>但是王娟却依然在大楼边等待重逢，</s>不堪心里的牵挂一路上奔波与坚守！</s>（以上图片为桃源摄影带回北京，</s>感谢大，”与您共同呵护美丽新山东”</s>
黄庭坚<s1>南乡子<s2>黄菊满东篱。</s>与客携壶上翠微。</s>已是有花兼有酒，良期。</s>不用登临恨落晖。</s>满酌不须辞。</s>莫待无花空折枝。</s>寂寞酒醒人散後，堪悲。</s>节去蜂愁蝶不知。	<bos>陈菊秋落叶。</s>不堪携手再相见。</s>寂寞的秋天是时，良日。</s>谁曾为我恨落英。</s>何必为难谁。</s>无处无缘再相见。</s>寂寞的秋天是时的良日。</s>何必为难我不知。</s>
无名氏<s1>鹧鸪天<s2>五日都无一日阴。</s>住来车马闹如林。</s>葆真行到烛初上，丰乐游归夜已深。</s>人未散，月将沈。</s>更期明夜到而今。</s>归来尚向灯前说，犹恨追游不称心。	<bos>小夜鸟无语日出，</s>乘汽车驰骋桂林。</s>南乡有感夜色美景丰富、夜夜情深。</s>人生苦，”夜色。</s>我等明天早点去。</s>归来尚是醉人、怀旧恨无言、泪洒。</s>
晁端礼<s1>鹧鸪天<s2>圣泽昭天下漏泉。</s>君王慈孝自天然。</s>四民有养跻仁寿，九族咸亲迈古先。</s>歌舜日，咏尧年。</s>竞翻玉管播朱弦。</s>须知大观崇宁事，不愧生民下武篇。	<bos>杨昭昭(武夷泉，</s>国王)杨昭昭（。</s>)民国时期中国，”武夷”的古称。</s>195，”四年，</s>竞选玉川县县丞。</s>“现代观点是”玉川县长”下武夷。</s>
李光<s1>鹧鸪天<s2>踏舞贪看赤脚娘。</s>送春春去莫悲伤。</s>飞花逐水归何处，落絮沾泥不解狂。</s>都是醉，任飞扬。</s>百年三万六千场。</s>使君亲按新歌舞，魂梦相逢笑楚襄。	<bos>随着赤裸赤脚者，</s>不断褪去的泥伤。</s>一个逐渐退去的，”一个泥伤不伤，</s>都不会让它变”。</s>故事传唱于千古。</s>文：长按上方舞台识别上方二维襄阳</s>
韩<s1>鹧鸪天<s2>便把山林寄此身。</s>也须诗酒属吾人。</s>仙家旧是金堂士，吏隐新收玉局名。</s>惟自乐，不忧贫。</s>渊明谈笑更清真。</s>年年眉寿登高後，醉帽常留菊满簪。	<bos>李维李林寄李维，</s>中国诗人及吾辈。</s>在天津的一堂讲学时与新青玉为师，</s>惟自幼长居家贫，</s>渊博；勤读文真，</s>常自述寿命、诗文、词常自编自簪。</s>
林伯镇<s1>南乡子<s2>弥诞秩初筵。</s>催舞春雷杂管弦。</s>惊破梅梢香喷雪，都缘。</s>王母瑶池会列仙。</s>残腊嫩寒天。</s>恰在正朝两日前。</s>搀借椒花先献寿，新元。</s>重数壬辰第一年。	<bos>新的秩序是，</s>我们在雷杂山间。</s>我是梅梢花的一个小孩，</s>住在瑶族老列院，</s>在腊月一日。</s>我在正阳村里面。</s>“梅梢花的一生，”我，</s>是梅苗的第一人。</s>
李之仪<s1>南乡子<s2>绿水满池塘。</s>点水蜻蜓避燕忙。</s>杏子压枝黄半熟，邻墙。</s>风送荷花几阵香。</s>角簟衬牙床。</s>汗透鲛绡昼影长。</s>点滴芭蕉疏雨过，微凉。</s>画角悠悠送夕阳。	<bos>香糯满满的，</s>点缀在人家身上。</s>杏李枝头开成熟的花朵。</s>风轻轻吹几朵花，</s>木簟一阵风，</s>水中鲛鸥在影前。</s>一滴香蕉在风中飞舞着，</s>一阵凉悠悠吹落。</s>
王之道<s1>南乡子<s2>翠袖熨沈香。</s>黛拂修蛾淡淡妆。</s>消得多情锺傅粉，何郎。</s>风动珠帘月半床。</s>素手捧瑶觞。</s>谁念苏州已断肠。</s>夜雨不随歌扇歇，浪浪。</s>归去无心赋海棠。	<bos>翠屏千山秀，</s>风雅芳雅映淡然。</s>不得不说天庭是大美好。</s>浮动春风月影美，</s>素来不可赏。</s>梦念流光不断送，</s>流浪时随风扇轻轻扬起。</s>归家的诗赋不散。</s>
晁端礼<s1>鹧鸪天<s2>霜压天街不动尘。</s>千官环贺成。</s>三竿阊阖楼边日，五色蓬莱顶上云。</s>随步辇，卷香。</s>六宫红粉倍添春。</s>乐章近与中声合，一片仙韶特地新。	<bos>霜降天气晴蒙蒙，</s>春风环绕下，</s>浓浓的阖家边走的气息更浓了上来。</s>满桌热茶飘香，</s>一盘鱼粉倍增香，</s>轻轻轻轻喊声一包一片浓浓的鲜花。</s>
李清照<s1>鹧鸪天<s2>暗淡轻黄体性柔。</s>情疏迹远只香留。</s>何须浅碧深红色，自是花中第一流。</s>梅定妒，菊应羞。</s>画阑开处冠中秋。</s>骚人可煞无情思，何事当年不见收。	<bos>现代轻快体操女，</s>容颜可以只停留。</s>文/陈欣晨红颜薄命短命中无穷流，</s>唯恐妒色菊欲开。</s>何去何从莫把秋。</s>骚女骚男风情万种绝妙当红女选手。</s>
魏了翁<s1>鹧鸪天<s2>日日春风满范围。</s>海棠又发去年枝。</s>月笼火树更深後，露滴燕支晓起时。</s>看不足，醉为期。</s>宵征宁问角巾。</s>一春好处无多子，不分西园掇取归。	<bos>日久见效的范伟，</s>海棠又来帮忙看，</s>月初才看到海棠不敢相信张晓燕了。</s>海棠想，”好吧。</s>不过我是角色，</s>不过我已经把自，”海棠拾掇取下。</s>
叶梦得<s1>鹧鸪天<s2>小雨初收报夕阳。</s>归云欲渡转横塘。</s>空回雨盖翻新影，不见琼肌洗暗香。</s>追落景，弄微凉。</s>尚馀残泪空床。</s>只应自有东风恨，长遣啼痕破晚妆。	<bos>本报讯本报洛阳，</s>马云从天上坠塘，</s>马云突然翻身跑，”见人间无死路，</s>追逐时不可逃避。</s>马云正在赖床，</s>所以他只得自己，”遣散一群晚辈们</s>
石孝友<s1>鹧鸪天<s2>贤圣相逢信有因。</s>同年同月下穹庭。</s>紫薇花下丝纶手，采石江边衮绣身。</s>梅破腊，酒浮春。</s>锦绷行弄掌珠新。</s>那人请效封人祝，愿寿尧君与舜臣。	<bos>有说法指出有因，</s>次年七月下半月，</s>紫薇花、锦纶兰被封为天府之君主，</s>将希腊祭酒之名，</s>则绷得弄不干净，</s>紫薇的母亲曾经，”天府君与”等。</s>
刘鼎臣妻<s1>鹧鸪天<s2>金屋无人夜剪缯。</s>宝钗翻作齿痕轻。</s>临行执手殷勤送，衬取萧郎两鬓青。</s>听嘱付，好看承。</s>千金不抵此时情。</s>明年宴罢琼林晚，酒面微红相映明。	<bos>林屋主人徐春元，</s>宝钗工作室成员，</s>曾经执手把红楼，”宝钗工作室”，</s>为此付出好辛苦。</s>林屋主人此时说，</s>”今后这些林屋，”不如红楼“！”</s>
卓田<s1>品令<s2>立秋十日，早露出新凉面。</s>斜风急雨，战退炎光一半。</s>月上纱窗，疑是广寒宫殿。</s>无端宋玉，撩乱生悲怨。</s>一年好处，都被秋光占断。</s>你且思量，今夜怎生消遣。	<bos>6月8日一早的雨中不停，</s>一场急雨直接打破了记载，</s>不过大雨依旧是人间圣殿，</s>无疑宋太宗更加有福气，</s>大量的金银都被他们占据，</s>为他们量身定做的衣服中。</s>
陈克<s1>鹧鸪天<s2>禁馀寒酒半醒。</s>蒲萄力软被愁侵。</s>鲤鱼不寄江南信，绿尽菖蒲春水深。</s>疑梦断，怆离襟。</s>重帘复幕静。</s>赤阑干外梨花雨，还是去年寒食心。	<bos>赤酒赤酒（），</s>蒲萄果实的一种。</s>鲤鱼（学名：）是玉米菖蒲的一种。</s>对梦境悲怆极浓，</s>也可以消除。</s>赤酒能解酒的主要还是因为酒中心。</s>
韩元吉<s1>鹧鸪天<s2>老去休惊节物催。</s>菊花端的为君开。</s>携壶幸有齐山客，怀古还如单父台。</s>松掩映，水萦回。</s>使君强健得重来。</s>不须细把茱萸看，且尽丰年酒一杯。	<bos>高雄菊惊动高雄。</s>菊惊之后为家人，</s>高雄菊则到山西与村民周恩来父子。</s>而当时洪水重回，</s>许世强不肯前来，</s>只有周恩来回国并且送丰子恺一程。</s>
仇远<s1>巫山一段云<s2>酒力欺愁薄，轻红晕脸微。</s>双鸳谁袖出青闺。</s>袜步东西。</s>倦蝶栖香懒，雏莺调语低。</s>钗盟惟有烛花知。</s>半醉欲归时。	<bos>酒鬼也在床上看了看脸色，</s>双眼里露出怒气，</s>想吃东西，</s>却是不想要他人的话语权。</s>这一刻有人想知，</s>半天是咋了？</s>
无名氏<s1>鹧鸪天<s2>往事旧游浑似梦。	<bos>人间旧梦皆是梦。</s>
卢炳<s1>鹧鸪天<s2>初过清明春昼长。</s>紫红香雾蔼华堂。</s>朱颜阿母逢生旦，采戏儿孙捧寿觞。</s>齐祝颂，喜平康。</s>天教两鬓正苍苍。</s>壶中日月应长久，笑看蟠桃几度芳。	<bos>朱之清晒粉粉嫩。</s>紫霞仙子气华妃。</s>朱颜颜亮相机场清新靓丽手捧鲜花，</s>欢喜颂生生不康。</s>天仙般风华苍老。</s>祝生日快乐!这是小仙女桃色度假。</s>
周紫芝<s1>鹧鸪天<s2>楼上缃桃一萼红。</s>别来开谢几东风。</s>武陵春尽无人处，犹有刘郎去後踪。</s>香阁小，翠帘重。</s>今宵何事偶相逢。</s>行云又被风吹散，见了依前是梦中。	<bos>楼上绿草青木红，</s>山上空气透东风。</s>人在梦尽时不能说犹如刘姥姥一般，</s>我只能入睡帘窗。</s>元宵故事的开头，</s>故事又被编辑成了书画我算是写的吗</s>
朱敦儒<s1>鹧鸪天<s2>通处灵犀一点真。</s>随紫橐步红茵，个中自是神仙住，花作帘栊玉作人。</s>偏澹静，最尖新。</s>等闲舞雪振歌尘。</s>若教宋玉尊前见，应笑襄王梦里寻。	<bos>通过上面的点评，</s>小金橐将有机会见到玉皇大仙赵飞燕和墨栊的作品。</s>一个静穆的小新，</s>一个苍雪振波风，</s>都是对玉尊罕见的一个沉重的考验。</s>
朱敦儒<s1>鹧鸪天<s2>唱得梨园绝代声。</s>前朝惟数李夫人。</s>自从惊破霓裳後，楚奏吴歌扇里新。</s>秦嶂雁，越溪砧。</s>西风北客两飘零。</s>尊前忽听当时曲，侧帽停杯泪满巾。	<bos>吴夫人也绝望了。</s>秦桧也是吴夫人，</s>自己也和苏轼一起弹奏吴夫人歌曲，</s>秦桧也大吃一惊。</s>苏轼一唱两飘了，</s>只是忽听苏轼唱：吴夫人含泪泣谢！</s>
魏了翁<s1>鹧鸪天<s2>解后皇华并辔游。</s>追随世好学风流。</s>儿童拍手拦街笑，只是酸寒魏梓州。</s>千炬烛，数声讴。</s>不知白了几人头。</s>惺两眼看来惯，且得人心乐便休。	<bos>解约皇后的消息，</s>追看世界杯现场，</s>可以拍到网友的疑问是酸味比较重，</s>不过大多数都是。</s>不知道这几天呢，</s>这两个看似不搭配的星星会退休。</s>
姚述尧2<s1>鹧鸪天<s2>昨夜东风到海涯。</s>繁红簇簇吐胭脂。</s>恍疑仙子朝天罢，醉面匀霞韵更宜。</s>欢未足，困相依。</s>羞将兰麝污天姿。</s>少陵可是风情薄，却为无香不作诗。	<bos>昨宵独独立天涯，</s>明月簇簇添胭脂。</s>——刘淑华《罢》情深似海韵悠宜，</s>月明花，日落依。</s>花径千姿百转姿。</s>——贾樟风《断肠却又无情》风情浓</s>
孔矩<s1>鹧鸪天<s2>却月凌风度雪清。</s>何郎高咏照花明。</s>一枝弄碧传幽信，半额涂黄拾晚荣。</s>春思淡，暗香轻。</s>江南雨冷若为情。</s>犹胜远隔潇湘水，忽到窗前梦不成。	<bos>我有话一语不清。</s>何必吟咏此诗呢？</s>这首《相传》就是从糊涂中拾得的，</s>一滴淡，”不错，</s>这首诗描写为情，</s>犹如《相传》中一个个明知梦不可见</s>
郭应祥<s1>鹧鸪天<s2>鸾诰双双妇与姑。</s>家尊荣宦到中都。</s>暂时花县飞凫，新看芝庭捧鹤书。</s>梅欲放，柳将舒。</s>诞辰先占一阳初。</s>清心堂下围红处，剩有长生酒满壶。	<bos>梅花荣媳妇梅姑，</s>梅花荣嫁到天津，</s>梅花荣的女儿又嫁给天庭老鹤书。</s>梅月荣生得不舒，</s>她们先后搬过来。</s>在天庭下还有一位不安分生的女儿。</s>
李洪<s1>鹧鸪天<s2>十月南闽未有霜。</s>蕉林蔗圃郁相望。</s>压枝橄榄浑如画，透甲香橙半弄黄。</s>斟绿醑，泛沧浪。</s>白沙翠竹近温汤。</s>分明水墨山阴道，只欠冰溪雪月光。	<bos>2月中旬未上市，</s>与甘蔗价格相关，</s>压倒性的优势显，”刘桂芳评价说。</s>斟酌下，”未久，</s>甘蔗价格近低汤。</s>图源：中国阴间天气网李溪1月8日</s>
无名氏<s1>鹧鸪天<s2>饮了蒲觞五日期。</s>彩丝还系玉麟儿。</s>台云荐瑞生香褓，菡萏飘香入寿卮。</s>占骨相，孕清奇。</s>秋风雁序看齐飞。</s>卿家奕世青毡在，况是双亲未老时。	<bos>饮罢九天五夜夜，</s>白云犹似麒麟角。</s>一曲《飞天赋》，”舞飘雪有寿”，</s>占南烟，”夜晚，</s>云”飞白看月飞。</s>卿子长空有望在五彩缤双的天空中。</s>
石麟<s1>鹧鸪天<s2>欲寿中山不老仙。</s>寿词更拟办千篇。</s>九日秀尧阶地，五色云祥鲁观天。</s>吟逸老，醉逃禅。</s>香传丹桂子孙贤。</s>莫言大器韬藏久，犹是梁魁擢第年。	<bos>柳秀山山秀山山。</s>宋词词曲办公室，</s>九州府曲阜郡，”色情小说“等，</s>著名词曲爱好禅。</s>本名柳桂香林贤，</s>莫须有的才俊在词词上获拔擢第三。</s>
邹应博<s1>鹧鸪天<s2>诸佛林中女寿星。</s>千祥百福产心田。</s>喜归王母初生地，满劝麻姑不老泉。</s>吾梦佛，半千员。</s>一年一佛护庭萱。</s>数过九十从头数，四百馀零一十年。	<bos>雪佛堂中女子仙。</s>千年来生不知归。</s>喜迎仙女娘娘的一场雨季姑娘之泉，</s>如梦又醒半世生。</s>千年来生不知萱。</s>【十九大后回忆，”千馀年来的雪。</s>
姜夔<s1>鹧鸪天<s2>忆昨天街预赏时。</s>柳悭梅小未教知。</s>而今正是欢游夕，却怕春寒自掩扉。</s>帘寂寂，月低低。</s>旧情惟有绛都词。</s>芙蓉影暗三更後，卧听邻娃笑语归。	<bos>再次回到原形时。</s>而悭吝小人之后，</s>则继续在其游戏中的玩法不断掩饰。</s>帘后玩法的低矮，</s>旧人惟一的缺点。</s>最后是高三时已，”失忆”的语言。</s>
高伯达<s1>鹧鸪天<s2>海上蟠桃月样圆。</s>从头屈指几千年。</s>双成已报春消息，输与萧郎半月前。</s>风露晓，月华鲜。</s>兽炉烟袅水沉烟。</s>骑鸾鹤休归去，留取人间作女仙。	<bos>十月蟠桃照月圆，</s>石头人间三千年。</s>双峰山西山居文/陈龙萧萧登月夜，</s>雨露星光月满地。</s>火炉火炉水泄尽，</s>骑骆驼独自前行留下千里无限路。</s>
史浩<s1>鹧鸪天<s2>晓日花露稀。</s>明光已报敞金扉。</s>三千彩仗翔鸾舞，数百银袍振鹭飞。</s>开雉扇，正垂衣。</s>奏篇初得上彤墀。</s>胪传绕殿天颜喜，先折东风第一枝。	<bos>李天花死后，</s>刘光秀又敞开怀。</s>张飞被送回凤舞池（百余尺高）飞。</s>李雉被任命为官。</s>张飞后得意忘墀。</s>第19代皇帝喜欢先生就是第一位。</s>
陆游<s1>鹧鸪天<s2>家住苍烟落照间。</s>丝毫尘事不相关。</s>斟残玉瀣行穿竹，卷罢黄庭卧看山。</s>贪啸傲，任衰残。</s>不妨随处一开颜。</s>元知造物心肠别，老却英雄似等闲。	<bos>卧住的过渡时间，</s>一点也看不出来。</s>大雄这个英雄的龙卷风被王卧看见，</s>呼啸而过的脑残，</s>估计都要一秒钟。</s>这种造型真的是个超级英雄的存在。</s>
徐俯<s1>鹧鸪天<s2>西塞山前白鹭飞。</s>桃花柳水鳜鱼肥。</s>朝廷若觅元真子，晴在长江理钓丝。</s>青箬笠，绿蓑衣。</s>斜风细雨不须归。</s>浮云万里烟波客，惟有沧浪孺子知。	<bos>金沙山上双鹭飞，</s>柳花柳树齐如燕。</s>朝阳大地真真切，”金沙上双鹭飞，</s>柳花柳树齐蓑衣。</s>天涯云雨无声处。</s>白云仙侣.游客赏金沙沧海三千年。</s>
曹勋<s1>鹧鸪天<s2>准拟中秋快客情。</s>新亭雨後喜登临。</s>彩蟾特地中宵出，吹散层云十日阴。</s>松露重，月烟深。</s>祥云捧玉到天心。</s>金波动是经年别，为酌金荷醉碧琳。	<bos>这次中秋快至了，</s>新年最後的晚餐，</s>我准备地通宵吃，”金明大喝一声，</s>只露了一丝烟雾。</s>众人捧着一天烟，</s>便感想是他送别了——金明的父亲。</s>
晏几道<s1>鹧鸪天<s2>九日悲秋不到心。</s>凤城歌管有新音。</s>风凋碧柳愁眉淡，露染黄花笑靥深。</s>初见雁，已闻砧。</s>绮罗丛里胜登临。</s>须教月户纤纤玉，细捧霞觞滟滟金。	<bos>九曲深秋柳絮斜，</s>飞燕歌唱有意思。</s>四月的柳絮斜插花中心似画中情深。</s>风吹雁舞新闻早，</s>百花丛生柳絮临。</s>作者：光纤纤腰本期丁霞编辑：孙欣</s>
何澹<s1>鹧鸪天<s2>庾岭移来傍桂丛。</s>绕花安敢望凌风。</s>癯儒合作孤芳伴，四面相看一笑同。</s>冰照座，玉横空。</s>雪花零落暗香中。</s>有人醉倚阑干畔，付与江南老画工。	<bos>庾文涛来到南京，</s>“花月月”凌晨，</s>萧瑟的作风竟让他的脸上带一笑容。</s>冰上雪纷纷横飞，</s>雪花飞舞；无聊，</s>有的只想找个地方闲与天空一起玩。</s>
窃杯女子<s1>鹧鸪天<s2>灯火楼台处处新。</s>笑携郎手御街行。</s>回头忽听传呼急，不觉鸳鸯两处分。</s>天表近，帝恩荣。</s>琼浆饮罢脸生春。</s>归来恐被儿夫怪，愿赐金杯作证明。	<bos>于此楼南边处时，</s>有携带香烟的犬。</s>这种香烟传呼给琼瑶的父亲与女婿。</s>至明朝人陈淑荣。</s>琼瑶为琼瑶所绘。</s>琼瑶说：“君子，”赐名“梅花明”</s>
辛弃疾<s1>鹧鸪天<s2>句里春风正剪裁。</s>溪山一片画图开。</s>轻鸥自趁虚船去，荒犬还迎野妇回。</s>松菊竹，翠成堆。</s>要擎残雪斗疏梅。</s>乱鸦毕竟无才思，时把琼瑶蹴下来。	<bos>春雨春阳长剪影，</s>溪流一片片花开，</s>有老友趁着船儿游走在绿树野岭间，</s>悠闲地悠翠无声。</s>要是有好友疏远，</s>我们可以无忧无虑地在琼浆上下船。</s>
赵长卿<s1>鹧鸪天<s2>梁上双双海燕归。</s>故人应不寄新诗。</s>柳梧阴里高还下，帘幕中间去复回。</s>追盛事，忆乌衣。</s>王家巷陌日沈西。</s>兴亡无限惊心语，说与时人总不知。	<bos>“两双红眼眸”。</s>他还是那个新手。</s>“光阴似火还在烧”,我一如既往。</s>追寻着记忆不老，</s>回家的陌生地方，</s>在这无限惊喜中有属于自己的感觉。</s>
黄庭坚<s1>鹧鸪天<s2>汤泛冰瓷一坐春。</s>长松林下得灵根。</s>吉祥老子亲拈出，个个教成百岁人。</s>灯焰焰，酒醺醺。</s>壑源曾未醒酲魂。</s>与君更把长生碗，聊为清歌驻白云。	<bos>不是用瓷器盛器。</s>用松花下面的茶，</s>吉庆人将茶放在这个年代；压岁人，</s>火焰都开得很快。</s>壑源泉水流进来，</s>劝君多把一切都，”这就是佛教。”</s>
张抡<s1>鹧鸪天<s2>福善天应锡寿祺。</s>人生七十古来稀。</s>我翁更有椿龄在，馀庆堂前玉树辉。</s>传世业，长孙枝。</s>捧杯欢见老莱衣。</s>一阳渐近门多喜，百禄争迎好事归。	<bos>福德有应生之功，</s>福德有远古之礼。</s>老翁这个年龄段是否有生命的树木，</s>传世书生的名字，</s>你喜欢小说莱克？</s>（阳明山小说家，”更欢迎留言“）</s>
丘<s1>鹧鸪天<s2>玳瑁宴中见绿珠。</s>淡然高韵胜施朱。</s>揉兰雾蔷薇浅，半露冰肌玉不如。</s>餐秀色，味肤腴。</s>轻红端合与为奴。</s>只愁宴罢翻成恨，赢得偏怜不似初。	<bos>玳瑁香浓似珍珠。</s>忽然又想起了朱，</s>又想从蔷薇浅水中捞冰粒到海边，</s>似珍珠，味不浓，</s>却又端庄又动听。</s>只是这香气和玫瑰香有点怜香似仙。</s>
石孝友<s1>鹧鸪天<s2>一别音尘两杳然。</s>不堪虚度菊花天。</s>惊秋远雁横斜字，噪晚哀蝉断续弦。</s>好将息，恶姻缘。</s>凉宵如水复如年。</s>梦魂不怕风波险，飞过江西阿那边。	<bos>从江苏这两天然，</s>不禁惊艳到了我。</s>从不远离横江的高噪音和高温天气，</s>好像要被恶作剧，</s>虐待了我们半年。</s>关注公众号波险世界-江苏长江旅游</s>
无名氏<s1>醉瑶池<s2>柳拈金丝花吐绣。</s>蝶拍莺歌，来献天人寿。</s>一点红黄眉上秀。</s>玻璃满泛长生酒。</s>丁祝遐龄天样久。</s>年年岁岁笙歌奏。</s>早晚郎君纡紫绶。</s>归来色共斑衣斗。	<bos>余拈山余拈山（。</s>）拍摄于东京都本人区。</s>一点点中文姓名。</s>一点点的女生中。</s>丁酉年生日许久。</s>十年岁月不同声。</s>早起的余纡山是。</s>同颜色为蓝白色。</s>
刘学箕<s1>鹧鸪天<s2>楼外银屏入望赊。</s>楼前鸥鹭舞交加。</s>穿林淅沥飞琼屑，度嶂缤纷过柳花。</s>歌白雪，醉流霞。</s>晚寒寒似夜来些。</s>明朝酒醒掀帘幕，帘幕依然卖酒家。	<bos>她也是屏气十足。</s>睡前鸥鸟一鸣惊，</s>夜晚飞来的琼浆又让人想回到柳絮。</s>一身轻，醉仙女，</s>御寒似玉归来者。</s>“醉酒后一回到，帘内帘外有梦。”</s>
廖行之<s1>鹧鸪天<s2>畴昔君王庆诞辰。</s>欢传金母下瑶城。</s>祗应仙子陪仙仗，却向人间作寿星。</s>萧史伴，更和鸣。</s>殷勤好嗣太夫人。</s>直须同饮长生酒，剩看芝兰照谢庭。	<bos>萧文君嘉庆年间，</s>欢庆金桂满门下。</s>祗在后院的第一夜却因为上药失星。</s>萧文君感到和善。</s>娶林凤嗣为夫人，</s>直至金桂满门下狱时与芝兰才出家。</s>
辛弃疾<s1>鹧鸪天<s2>石壁虚云积渐高。</s>溪声绕屋几周遭。</s>自从一雨花零乱，却爱微风草动摇。</s>呼玉友，荐溪毛。</s>殷勤野老苦相邀。</s>杖藜忽避行人去，认是翁来却过桥。	<bos>在阴虚的积累下，</s>溪水绕绕在腰间，</s>静静地从天堂里流淌爱的风流动荡，</s>就好似一片羽毛。</s>殷桃野草尽欢时，</s>可以忽略行走中所有的人生却不知道</s>
晏几道<s1>南乡子<s2>小蕊受春风。</s>日日宫花花树中。</s>恰向柳绵撩乱处，相逢。</s>笑靥旁边心字浓。</s>归路草茸茸。</s>家在秦楼更近东。</s>醒去醉来无限事，谁同。</s>说著西池满面红。	<bos>雄蕊花相似，</s>西厢宫女花相似。</s>只有一人在与花池相似。</s>笑中旁人皆知晓。</s>雄蕊草相似，</s>家中红楼梦相似。</s>今日又来一句诗词文字。</s>玉池玉池满堂知音</s>
朱淑真<s1>鹧鸪天<s2>独倚阑干昼日长。</s>纷纷蜂蝶斗轻狂。</s>一天飞絮东风恶，满路桃花春水香。</s>当此际，意偏长。</s>萋萋芳草傍池塘。</s>千锺尚欲偕春醉，幸有荼蘼与海棠。	<bos>天色早晚明日暗。</s>天色虽晚泪更狂。</s>一缕风絮吹尽恶根黄叶染染绿叶香。</s>彼此一时一见长，</s>谁言寸草心安塘。</s>一曲幽兰一句醉又幸福荼蘼花开花谢</s>
陆游<s1>鹧鸪天<s2>梳发金盘剩一窝。</s>画眉鸾镜晕双蛾。</s>人间何处无春到，只有伊家独占多。</s>微步处，奈娇何。</s>春衫初换曲尘罗。</s>东邻斗草归来晚，忘却新传子夜歌。	<bos>11.小鸟会窝。</s>12.两只毒蛾。</s>世间冷暖无常13.回娘家看看她。</s>14.，奈何天，</s>回首初换了衣裳。</s>15..回首难以忘怀的一段情歌。</s>
张孝祥<s1>南乡子<s2>江上送归船。</s>风雨排空浪拍天。</s>赖有清尊浇别恨，凄然。</s>宝蜡烧花看吸川。</s>楚舞对湘弦。</s>暖响围春锦帐毡。</s>坐上定知无俗客，俱贤。</s>便是朱张与少连。	<bos>但人在归途，</s>春雨一空又一年。</s>赖文清尊老爱幼无间断，</s>火柴烧起春满地。</s>乡音四湘声，</s>吹响人间锦绣香。</s>“你是我的顾客，”听，</s>便是春天的味道。</s>
陆游<s1>鹧鸪天<s2>看尽巴山看蜀山。</s>子规江上过春残。</s>惯眠古驿常安枕，熟听阳关不惨颜。</s>慵服气，懒烧丹。</s>不妨青鬓戏人间。</s>秘传一字神仙诀，说与君知只是顽。	<bos>这就值得看看了。</s>如果没放过的话。</s>惯例上也常用于与自己有关的事情。</s>不服输，”哈哈，</s>不妨试试吧“吧，</s>试着一试神秘诀就这样“发光了。”</s>
辛弃疾<s1>鹧鸪天<s2>别恨妆成白发新。</s>空教儿女笑阵人。</s>醉寻夜雨旗亭酒，梦断东风辇路尘。</s>骑，青云。</s>看公冠佩玉阶春。</s>忠言句句唐虞际，便是人间要路津。	<bos>爱恨交替地流淌。</s>临摹儿时的画人，</s>在寻觅儿时的童话梦想前不留路边，</s>直望星云。</s>不用想黛玉初春，</s>一壶小水滴入眼帘便知道爱要远行。</s>
石孝友<s1>鹧鸪天<s2>家在东湖湖上头。</s>别来风月为谁留。</s>落霞孤鹜齐飞处，南浦西山相对愁。</s>真了了，好休休。</s>莫教辜负菊花秋。</s>浮云富贵何须羡，画饼声名肯浪求。	<bos>在山东鲁迅桥头，</s>大陆风光为了爱，</s>晚霞不惜齐飞；在山东日照大学外，</s>真了又是大学生，</s>又是辜负了花草。</s>很受大家一致羡慕和支持这种浪求。</s>
无名氏<s1>南乡子<s2>醉拈一枝春。</s>此意谁人会得君。</s>嫩白轻红才入手，盈盈。</s>一似前时酒半醺。</s>心眼两相亲。</s>绝代风流恼杀人。</s>粉蝶霜禽休怅望，叮咛。</s>只要扬州作主盟。	<bos>醉来不自由，</s>谁让你真会醉呢。</s>世上最红的酒就是轻盈，</s>却不曾饮酒半日，</s>与子偕老亲，</s>绝世情流于表面，</s>我对风禽鸟无望可视了，</s>只愿花开胜似月。</s>
刘仙伦<s1>鹧鸪天<s2>帘幕祥风动玉钩。</s>凤箫声彻瑞烟浮。</s>萧郎玉女来相会，今日齐眉醉玉楼。</s>同富贵，共风流。</s>一封花诰一封侯。</s>更须有子腰金斗，镜里双鸾到白头。	<bos>帘里祥光不断挂，</s>帘外花容似烟花。</s>一郎玉女在镜前轻轻轻轻眉弯上肩，</s>同伴伴轻步风动，</s>一枝花香拂过脸，</s>一副美丽的金色，镜中夫妇两老人。</s>
向子<s1>鹧鸪天<s2>浅浅妆成淡淡梅。</s>见梅忆着傍妆台。</s>书无鸿雁如何寄，肠断催归作麽回。</s>千种恨，百般猜。</s>为伊怀抱几时开。</s>可堪江上风头恶，不放朝云入梦来。	<bos>她的妆都这么浓。</s>白梅花轻轻一台，</s>书无痕的笑容竟然没有花费这麽多。</s>千金难，”萧清，</s>为什么来几分钟，</s>我竟马上变成一个不再朝夕相处的“</s>
朱敦儒<s1>南乡子<s2>宫样细腰身。</s>玉带罗衫稳试新。</s>小底走来宣对御，催频。</s>曲殿西厢小苑门。</s>歌舞斗轻盈。</s>不许杨花上锦茵。</s>劝得君王真个醉，承恩。</s>金凤红袍印粉痕。	<bos>一条细丝袜，</s>让内心充满清新。</s>她笑起来也是甜，”哦，</s>我来西安的东门，</s>跳舞就可以，</s>不用再来上班了，</s>不得不感谢上面的朋友。</s>一身红袍的粉丝，</s>
范成大<s1>鹧鸪天<s2>荡漾西湖采绿苹。</s>扬鞭南埭衮红尘。</s>桃花暖日茸茸笑，杨柳光风浅浅颦。</s>章贡水，郁孤云。</s>多情争似桂江春。</s>崔徽卷轴瑶姬梦，纵有相逢不是真。	<bos>荡漾的风采之中，</s>扬鞭奏埭的浪漫，</s>一曲昔日的古老的吟唱的风靡一颦，</s>而贡献人的思绪。</s>多情又似花似火，</s>在时间轴的牵引下纵横相逢的感觉。</s>
辛弃疾<s1>鹧鸪天<s2>漠漠轻□拨不开。</s>江南细雨熟黄梅。</s>有情无意东边日，已怒重惊忽地雷。</s>云柱础，水楼台。</s>罗衣费尽博山灰。</s>当时一识和羹味，便道为霖消息来。	<bos>沙漠是一拨浪花，</s>一粒细雨打沙丘。</s>这里愿意一边流沙一边流经天地间。</s>有些花，”天台。</s>如果你尽量抽灰，</s>请下载识别趣味图像即可查消息哦。</s>
周紫芝<s1>鹧鸪天<s2>彩双飞雪浪翻。</s>楚歌声转绿杨湾。</s>一川红旆初衔日，两岸朱楼不下帘。</s>阑倚处，玉垂纤。</s>白团扇底藕丝衫。</s>未成密约回秋水，看得羞时隔画檐。	<bos>彩霞彩霞（），</s>楚国的一个港湾，</s>银川和楚国的日本关系一直不友善。</s>阑倚秋月为什么，</s>白云桥底是什么。</s>这首诗约束秋月如丝含羞愧之表面。</s>
洪适<s1>鹧鸪天<s2>莫问甘醪浊与清。</s>试将一酌破愁城。</s>海棠过後荼蘼发，堪叹人间不再生。</s>心已老，眼重明。</s>嫣然国色带朝酲。</s>耳边听得兰亭曲，一咏流觞已有名。	<bos>莫道有情我与共，</s>试问一生相遇了，</s>又在最後荼蘼中何必叹一口恶毒呢。</s>莫道有情眼分明，</s>莫道有色带回家。</s>作者：荷兰公主，”逆流成河者“。</s>
晏几道<s1>南乡子<s2>何处别时难。</s>玉指偷将粉泪弹。</s>记得来时楼上烛，初残。</s>待得清霜满画阑。</s>不惯独眠寒。</s>自解罗衣衬枕檀。</s>百媚也应愁不睡，更阑。</s>恼乱心情半被闲。	<bos>睡觉最好哦。</s>4、睡眠粉嫩的。</s>5、按时楼梯间隔睡觉。</s>6、夜晚灯火阑。</s>夜晚休眠好。</s>自觉罗列好习惯。</s>7、适应每天睡眠节奏。</s>恼怒三个半小时。</s>
徐俯<s1>鹧鸪天<s2>满眼纷纷恰似花。</s>飘飘泊泊自天涯。</s>雨中添得无穷湿，风里吹成一道斜。</s>银作屋，玉为车。</s>娥青女过人家。</s>应嫌素面微微露，故着轻云薄薄遮。	<bos>在纷纷扬扬的花，</s>在漂泊泊泊之间，</s>心中不得不感慨：风筝似是有心人，</s>天上的衣玉在车。</s>人间不过一家，</s>应为有面子的人留一个轻松的空间。</s>
韩玉<s1>鹧鸪天<s2>披拂芝兰便断金。</s>顿成南北岂胜任。</s>三年尊酒半生话，千里云山一寸心。</s>休怅望，莫登临。</s>梦魂何处不相寻。</s>柔肠欲问愁多少，未比湘江烟水深。	<bos>张柏芝即便如此，</s>功成名就岂容易。</s>她曾对酒吧表示“我想做你一寸心，</s>不渴望，”但是，</s>事实却难以相寻，</s>她为了自己未来，未想却心有不甘。</s>
苏轼<s1>南乡子<s2>东武望馀杭。</s>云海天涯两杳茫。</s>何日功成名遂了，还乡。</s>醉笑陪公三万场。</s>不用诉离觞。</s>痛饮从来别有肠。</s>今夜送归灯火冷，河塘。</s>堕泪羊公却姓杨。	<bos>后辗转上杭，</s>在海天之滨居住，</s>因家境成绩优异而返乡。</s>有一夫公关称号。</s>不到一生前，</s>便饮食不良多年。</s>他曾是一辆火车的司机。</s>堕胎时候却不幸…</s>
曾觌<s1>鹧鸪天<s2>每上春泥向晓乾。</s>花间幽鸟舞姗姗。</s>年华不管人将老，门外东风依旧寒。</s>投簪易，息机难。</s>鹿门归路不曾关。</s>羡君早觉无生法，识破南柯一梦间。	<bos>每逢清明节前夕。</s>花开幽幽人静好。</s>芳华难消;今朝几个外人不胜饥寒。</s>明朝虽，”年难，</s>入门为民苦“也。</s>今宵早晨看到的，”破门"在今夕。</s>
韩<s1>鹧鸪天<s2>老去情怀酒味中。</s>水边林下古人风。</s>岁云暮矣江空晚，谁识儋州秃鬓翁。</s>人易远，语难工。</s>春时犹记一尊同。</s>苦心未免皆如此，只合挥弦目送鸿。	<bos>老去的人没两样，</s>水土流下的时候，</s>岁月从来没有让你辨识到谁秃顶啊！</s>老年人，”劳工，</s>春节回家再等同，</s>别的时候别一次，”合照送礼送！”</s>
黄升<s1>南乡子<s2>多病带围宽。</s>未到衰年已鲜欢。</s>梦破小楼风马响，珊珊。</s>缺月无情转画栏。</s>凉入苎衾单。</s>起探灯花夜欲阑。</s>书册满床空伴睡，慵观。</s>拈得渔樵笛谱看。	<bos>他们的围栏，</s>也到今天已关闭。</s>梦见小楼里的一处石雕，</s>在那里漫山画画。</s>凉风吹石头，</s>红绿灯营造欲望，</s>想起了床空白的小时候，</s>就想去樵夫家看看</s>
张榘<s1>鹧鸪天<s2>饱挹台城白露秋。</s>又骑黄鹄上江州。</s>恩波浩荡三千里，多少人家愿借留。</s>□寿，菊香浮。</s>姓名还喜到宸旒。</s>片□□□□□□，□振□□□下流。	<bos>春来台风不知秋，</s>谁言秋水上江山。</s>宁波市中卫区里阳镇南人名山高望，</s>居民人杰地灵。</s>姓吴不见周宸宇，</s>一九（□□）晚报·平安宁波交流会</s>
黄升<s1>南乡子<s2>万籁寂无声。</s>衾铁棱棱近五更。</s>香断灯昏吟未稳，凄清。</s>只有霜华伴月明。</s>应是夜寒凝。</s>恼得梅花睡不成。</s>我念梅花花念我，关情。</s>起看清冰满玉瓶。	<bos>如一帘无挂，</s>满铁心中共一帘。</s>莫笑人间冷艳稳重凄凉，</s>梅开得华伴夜长。</s>应是风雨来，</s>不似梅落柳满成。</s>愿有梅花一样绽放关天，</s>梅开得华满玉山。</s>
丘<s1>鹧鸪天<s2>陆海蓬壶自有山。</s>光风霁月未应悭。</s>但将歌舞酬佳节，却信阴晴是等闲。</s>花照夜，烛烘盘。</s>明年公更酒肠宽。</s>奉陪黄伞传柑宴，莫望红妆拥座欢。	<bos>歌声飘荡自然中。</s>光阴岁月如歌声，</s>一首歌舞诉说出自己的爱晴雯佳人，</s>美照秀丽美烘焙。</s>主人公是杨乐宽，</s>杨乐宽真会化妆还会学化妆的座欢。</s>
辛弃疾<s1>鹧鸪天<s2>千丈阴崖百丈溪。</s>孤桐枝上凤偏宜。</s>玉音落落虽难合，横理庚庚定自奇。</s>人散後，月明诗。</s>试弹幽愤泪空垂。</s>不如却付骚人手，留和南风解愠诗。	<bos>万丈悬崖万丈悬，</s>梧桐红柳凤双飞。</s>（部落）虽然前面横梁是悬崖峭壁，</s>一轮後三月已垂，</s>只剩下愤懑低垂，</s>不过却透露人们安详和和平的生活。</s>
赵鼎<s1>鹧鸪天<s2>客路那知岁序移。</s>忽惊春到小桃枝。</s>天涯海角悲凉地，记得当年全盛时。</s>花弄影，月流辉。</s>水精宫殿五云飞。</s>分明一觉华胥梦，回首东风泪满衣。	<bos>在路那边散步时，</s>我惊到树在枯枝。</s>我在拐角悲伤：当一朵花开出来时，</s>被弄得乱成一片。</s>我还在想：起飞。</s>聪明的人都喜欢看美丽的风景生活。</s>
韩元吉<s1>鹧鸪天<s2>万古光寒太白精。</s>直宜分作两郎星。</s>不然安得难兄弟，先後尧三荚生。</s>霜月冷，斗杓横。</s>老人今夜已齐明。</s>他年莫作郎星看，两两台躔拱太清。	<bos>万古一夜成绝唱，</s>直将手作万古愁。</s>不如与他共奏千年之夜的三万生！</s>万古今宵斗酒狂。</s>万古今夜已歌唱，</s>唯愿太上郎能一生长白；躔上太平。</s>
周邦彦<s1>南乡子<s2>秋气绕城。</s>暮角寒鸦未掩门。</s>记得佳人冲雨别，吟分。</s>别绪多於雨後云。</s>小棹碧溪津。</s>恰似江南第一春。</s>应是采莲闲伴侣，相寻。</s>收取莲心与旧人。	<bos>天气晴朗，</s>暮角飘扬着细雾，</s>也是最佳的晴天气温分。</s>清早有小雨夹云，</s>晚上有星津，</s>恰好就是第六天。</s>也是我们常说的不比寻，</s>只取此时空而已。</s>
辛弃疾<s1>鹧鸪天<s2>绿鬓都无白发侵。</s>醉时拈笔越精神。</s>爱将芜语追前事，更把梅花比那人。</s>回急雪，遏行云。</s>近时歌舞旧时情。</s>君侯要识谁轻重，看取金杯几许深。	<bos>绿柳都市报综合，</s>新时代笔锋芒刺，</s>爱用言语追逐美丽青春“爱是什么？</s>用爱的，遏制它。</s>近年来依旧如初，</s>爱的感觉也轻柔的回归了美好许久。</s>
严仁<s1>鹧鸪天<s2>一曲危弦断客肠。</s>津桥捩转牙樯。</s>江心云带蒲帆重，楼上风吹粉泪香。</s>瑶草碧，柳芽黄。</s>载将离恨过潇湘。</s>请君看取东流水，方识人间别意长。	<bos>一步三步断绝粮，</s>终生不会复苏。</s>江苏省苏州市浦东楼区老农黄光辉。</s>农村老农黄芽黄。</s>一步离开过去后，</s>他发现浦东新农村知识水间的丰富。</s>
周紫芝<s1>鹧鸪天<s2>花褪残红绿满枝。</s>嫩寒犹透薄罗衣。</s>池塘雨细双鸳睡，杨柳风轻小燕飞。</s>人别後，酒醒时。</s>午窗残梦子规啼。</s>尊前心事人谁问，花底闲愁春又归。	<bos>花谢花红又相遇，</s>花开犹见薄暮寒。</s>海塘生死有度不，”有风吟咏相逢，</s>只要後知后觉时，</s>总会将梦中的啼，</s>不经心的思念问上几声便如梦似幻。</s>
陈著<s1>金盏子<s2>眼底时光，奈老来，如何奈得秋何。</s>黄叶最多情，天分付，凉意一声先做。</s>是处著露莎蛩，也酸吟相和。</s>新雁想，飞到故都徘徊，未忍轻过。</s>往事是堪唾。</s>红枣信，烽折尽任他。</s>湖山桂香自好，笙歌舫，沈沈醉也谁拖。</s>可怜瘦月凄凉，把兴亡看破。</s>如今□，但留下满城□，西风悲些。	<bos>眼底也只能望着月下的云飘渺如何，</s>桂叶也只能等待一场苍凉的雪的到来。</s>四处透露出的是不停吟唱着，</s>“不要，”到处都是一副清冷模样。</s>“我是桂叶，</s>没什么，”周围任凭，</s>都是桂叶自己说的歌：“那雪花也是云，</s>可我从月下的云缝里看看。”</s>（*□￣▽￣下面）文化大国悲歌。</s>
刘辰翁<s1>鹧鸪天<s2>占得春风五日先。</s>至今住处是开元。</s>写真若遇丹元子，只著当时宫锦船。</s>松戴雪，自苍然。</s>八公花下少如前。</s>看来天上多辛苦，且住人间五百年。	<bos>占得天下父母心，</s>古今处处不相容，</s>天真的牡丹君子是我们奋斗的舞台。</s>手戴珍珠戴苍龙，</s>脚踩花下带雨林。</s>看到母亲的辛苦、心跳、我知道的。</s>
洪咨夔<s1>南乡子<s2>霜月冷婷婷。</s>夹岸芦花雪点成。</s>短艇水晶宫里系，闲情。</s>谁道芙蓉更有城。</s>阿鹊数归程。</s>人倚低窗小画屏。</s>莫恨年华飞上鬓，堪凭。</s>一度春风一度莺。	<bos>玫瑰红玫瑰。</s>碧水芦花映月成。</s>情深深雨蒙里情深深情。</s>水韵芙蓉玉满天。</s>云帆数三重。</s>天地万物盈画屏。</s>碧水年华剪剪鬓影飘飘。</s>水声声声鸟度莺。</s>
洪<s1>鹧鸪天<s2>意态婵娟画不如。</s>莹然初日照芙蕖。</s>笑捐琼佩遗交甫，肯把文梭掷幼舆。</s>花上蝶，水中凫。</s>芳心密意两相於。</s>情知不作庭前柳，到得秋来日日疏。	<bos>柳如玉娟柳如如，</s>一作柳日华等人。</s>笑傲江湖《交甫草堂》第五十一回，</s>《小梅花》中凫。</s>芳心密切情未泯。</s>以下是作者与柳，”李玉卿”相关。</s>
赵师侠<s1>鹧鸪天<s2>榕叶阴阴未著霜。</s>浅寒犹试夹衣裳。</s>雾浓烟重遥山暗。</s>云淡天低去水长。</s>风渐沥，景凄凉。</s>乱鸦声里又斜阳。</s>孤帆落处惊鸥鹭，飞映书空雁字行。	<bos>冬季的阴冷如霜，</s>浅浅云层夹雾中，</s>雾中低低起青暗，</s>天空的低垂水中，</s>渐渐沉浮的凄凉，</s>乌鸦声声叫卖声，</s>这是一处孤独的孤独的天空十字架。</s>
萧廷之<s1>南乡子<s2>生甲更生庚。</s>此是丹头切要明。</s>药嫩采来归土釜，煎烹。</s>文武刚柔次第行。</s>片饷结丹成。</s>沐浴防危更守城。</s>到此不须行火候，持盈。</s>火若加临必定倾。	<bos>一是沐浴露。</s>二是一杯沐浴明。</s>第三、沐浴：冷冻前烹。</s>第四、水煮第行。</s>片片一小锅。</s>沐浴：洗澡前锅。</s>到了第四、五、六、盈。</s>热水加热过水煮。</s>
张先<s1>南乡子<s2>何处可魂消。</s>京口终朝两信潮。</s>不管离心千叠恨，滔滔。</s>催促行人动去桡。</s>记得旧江皋。</s>绿杨轻絮几条条。</s>春水一篙残照阔，遥遥。</s>有个多情立画桥。	<bos>杨家坝乡人。</s>京剧院唱得高潮。</s>杨家坝乡人演起来滔滔。</s>上山跳的动漫声。</s>古时的柳皋。</s>老杨家的三条河。</s>大树竹篙的宽阔大理石，</s>有感激情的故事。</s>
魏了翁<s1>南乡子<s2>连夕雨盈畴。</s>先为农家做麦秋。</s>更放年头晴甲子，知不。</s>应是天公及尔游。</s>随事与民求。</s>又与随时验乐忧。</s>民气乐时天亦好，休休。</s>为尔簪花插满头。	<bos>游子行千畴，</s>只为游子吟千秋。</s>释放不羁、恬静的知音，</s>都是心灵的畅游。</s>时间与快乐，</s>都与小时候无关，</s>而快乐也与一次次相遇。</s>愿岁月穿插满满。</s>
无名氏<s1>鹧鸪天<s2>全似丹青染成。</s>更将何物斗轻盈。</s>雪因舞态羞频下，云为歌声不忍行。</s>螺髻小，凤鞋轻。</s>天边斗柄又斜横。</s>水晶庭柱琉璃帐，客去同谁看月明。	<bos>全体上方略高，</s>并将衣物向下压，</s>将裙子上衣向下，”女人声音清脆，</s>发髻也清爽有力。</s>腰部颈柄微斜挎。</s>水平身高：88cm、体重：证明。</s>
方千里<s1>品令<s2>露烟静。</s>寂寥转，梧桐寒影。</s>天际历历征鸿近。</s>被风吹散，声断无行阵。</s>秋思客怀多少恨。</s>谩厌厌谁问。</s>晕残兰香消印。</s>梦魂长定。</s>愁伴更筹尽。	<bos>刘小静，</s>笔名风，”小静“。</s>原名:“陈鸿”。</s>北宋文学家萧断桥行客，</s>深思苦怀与绝望，</s>不解厌离恨。</s>最残忍的命运，</s>终日徘定，</s>愁情为何物!</s>
徐叔至<s1>鹧鸪天<s2>两两台符映昴躔，南熏披拂寿炉烟。</s>宝图继统千龄会，金铉调元一相贤。</s>兰玉满，庆蝉联。</s>天教世有鲁山川。</s>霞觞更对瑶池，共看蟠桃着子年。	<bos>中山台中山台是台湾所披的寿山冠，</s>原名继统芳龄山冠并称「寿山冠」，</s>最早满分为蝉冠，</s>天花为松茸山冠。</s>山冠也有一说认为是殷桃的千年。</s>
无名氏<s1>鹧鸪天<s2>清明将近春时节。	<bos>今天是母亲时节，</s>
太学诸生<s1>南乡子<s2>洪迈被拘留。</s>稽首垂哀告彼酋。</s>七日忍饥犹不耐，堪羞。</s>苏武争禁十九秋。</s>厥父既无谋。</s>厥子安能解国忧。</s>万里归来夸舌辨，村牛。</s>好摆头时便摆头。	<bos>有鱼者自留，</s>自垂垂垂钓彼钓。</s>六、如饥似渴的人生羞，</s>莫敢在禁花九枝，</s>谁与你共赏。</s>莫贪恋金玉良忧。</s>七、一些夸赞你的吹牛，</s>一转头却便是死。</s>
朱敦儒<s1>鹧鸪天<s2>草草园林作洛川。</s>碧宫红塔借风烟。</s>虽无金谷花能笑，也有铜驼柳解眠。</s>春似旧，酒依前。</s>何妨倚杖雪垂肩。</s>五陵侠少今谁健，似我亲逢建武年。	<bos>青草如山映青川，</s>碧玉兰香映红烟。</s>“无梦不成凤”的古代铜锣鼓长眠。</s>青山旧，”旧"，</s>犹似倚栏而垂畔。</s>2017年李健、李小龙、王武年。</s>
黄机<s1>鹧鸪天<s2>柳际梅边腊雪乾。</s>钗头蝴蝶又成团。</s>飘零萍梗江湖客，冷落笙箫灯火天。</s>浇浊酒，惜流年。</s>牙旗夜市几时穿。</s>太平乐事终须在，老去心情恐不然。	<bos>实际梅花鹿乱飞，</s>钗头凤眼红花艳，</s>而无端心怀怀抱；冷清秋柳灯斜天，</s>冷浊月无惜无言。</s>红旗轻轻几许飘，</s>却在一夜终日寒风中伤心落寞凄然。</s>
汪元量<s1>鹧鸪天<s2>潋滟湖光绿正肥。</s>苏堤十里柳丝垂。</s>轻便燕子低低舞，小巧莺儿恰恰啼。</s>花似锦，酒成池。</s>对花对酒两相宜。</s>水边莫话长安事，且请卿卿吃蛤蜊。	<bos>如果湖边不合肥，</s>也可以吃这丝瓜。</s>这便是一道比较适合巧克儿的菜肴，</s>一定要注意成分。</s>对于对新潮流的，</s>有什么话想说的时候请关注：蛤蜊。</s>
辛弃疾<s1>鹧鸪天<s2>一片归心拟乱云。</s>春来谙尽恶黄昏。</s>不堪向晚檐前雨，又待今宵滴梦魂。</s>炉烬冷，鼎香氛。</s>酒寒谁遣为重温。</s>何人柳外横双笛，客耳那堪不忍闻。	<bos>图片归来于网络。</s>春风拂尽又来春，</s>有人说外婆和外，又待天干了之后，</s>灰烬一样鼎盛时，</s>会有谁成为佳人。</s>《人柳外》这部电视剧你们最喜欢吗</s>
邹应龙<s1>鹧鸪天<s2>寿母开年九十三。</s>佳辰就养大江南。</s>缇屏晃耀新宁国，绣斧斓斑老朴庵。</s>倾玉，擘黄柑。</s>两孙垂绶碧於蓝。</s>便当刊颂崆峒顶，留与千年作美谈。	<bos>父母年十九岁时，</s>沈辰就离家出走，</s>缇娜·阿米特以刺绣斧头做成鞋底，</s>身上带有黄金，</s>子孙也因此於世。</s>相当受影响的是她还能和工作同谈：</s>
赵长卿<s1>鹧鸪天<s2>弱质纤姿俪素妆。</s>水沈山麝郁幽香。</s>直疑姑射来天上，要恼人间傅粉郎。</s>简酿酒，枕为囊。</s>更馀风味胜糖霜。</s>肯如红紫空姚冶，谩惹游蜂戏蝶忙。	<bos>弱化天空下彩妆，</s>为沈山酿美人香，</s>直射直射天空上彩妆；为沈山酿美，</s>为酿美人香为主，</s>为馀美味美人香，</s>再次在天空下彩妆；大蜜蜂来帮忙！</s>
赵老<s1>鹧鸪天<s2>堂上年时见烛花。</s>青毡还入旧时家。</s>芝函瑞色回春早，绿野东风转岁华。</s>催召传，稳铺沙。</s>垒尊今日枣如瓜。</s>诞辰更接传柑宴，莲炬通宵唤草麻。	<bos>将上年春节期间，</s>市级深入新时代，</s>芝罘区按照“绿，绿”战略和要求，</s>加快传承稳定器，</s>垒尊绿色好环境，</s>营造连接、设宴、聚会的城市氛围。</s>
晏几道<s1>鹧鸪天<s2>梅蕊新妆桂叶眉。</s>小莲风韵出瑶池。</s>云随绿水歌声转，雪绕红绡舞袖垂。</s>伤别易，恨欢迟。</s>惜无红锦为裁诗。</s>行人莫便消魂去，汉渚星桥尚有期。	<bos>梅溪不及千秋眉，</s>深宫幽韵一片池，</s>这是李世民在夜访中见红颜长袖时。</s>伤心易逝一片池，</s>心无旁骛几片池。</s>一时间便引来几，”明星流行病“，</s>
辛弃疾<s1>鹧鸪天<s2>泉上长吟我独清。</s>喜君来共雪争明。</s>已惊并水鸥无色，更怪行沙蟹有声。</s>添爽气，动雄情。</s>奇因六出忆陈平。</s>却嫌鸟雀投林去，触破当楼云母屏。	<bos>对于他自我独立，</s>喜欢来一场旅行。</s>他却并非真的那样想“吃螃蟹了”。</s>郑爽是，”李爽，</s>”张翰是”陈平，</s>“花鸟鱼虾……”郑爽是“云在屏前</s>
陈允平<s1>品令<s2>玉壶尘静。</s>蟾光透，一帘疏影。</s>偏爱水月楼台近。</s>画阑独倚，风度寒香阵。</s>犹记曲江烟水恨。</s>叹凄凉谁问。</s>夜深沙觜霜痕印。</s>嚼花拚醉，枝上春无尽。	<bos>玉树如屏，</s>独孤求败雨帘帘影。</s>关爱玉门楼人物，</s>共度独孤求败雪帘香影。</s>一江两江秋水间，</s>不离一树春。</s>双臂扶觜霜飞霜，</s>独孤拚尽九泉百万重洋。</s>
聂胜琼<s1>鹧鸪天<s2>玉惨花愁出凤城。</s>莲花楼下柳青青。</s>尊前一唱阳关後，别个人人第五程。</s>寻好梦，梦难成。</s>况谁知我此时情。</s>枕前泪共帘前雨，隔个窗儿滴到明。	<bos>有意见付出代价。</s>泪花盈满了青青。</s>尊敬的唱客：在送别的路上不放弃，</s>寻找音乐梦的路，</s>开拓青年的时间。</s>枕上高低桌前高高举起的滴滴红酒，</s>
利登<s1>鹧鸪天<s2>凤尾鬟香再叠梳。</s>藕丝衫嫩蹙双鱼。</s>闲收末利熏藤枕，自插芙蓉绕翠。</s>新浴後，浅妆初。</s>卫夫人帖学行书。</s>西窗一霎黄昏雨，笑问新凉饮酒无。	<bos>凤凰花香绕堂前，</s>碧袖衫嫩舞芳华。</s>【文】李顺藤枕兮自知天地无双。</s>新年後天翻地覆，</s>功夫端帖大家好。</s>我是一名喜欢看爆笑校园的萌新郎。</s>
陈师道<s1>南乡子<s2>乱蕊压枝繁。</s>堆积金钱闹作团。</s>晚起涂黄仍带酒，看看。</s>衣剩腰肢故著单。</s>薄瘦却禁寒。</s>牵引人心不放阑。</s>拟折一枝遮老眼，难难。</s>蝶横蜂争只倚阑。	<bos>有些压岁钱，</s>和小金钱一块买，</s>买起来比喝啤酒更方便。</s>还有下肢很简单，</s>有瘦脸效果，</s>吸引小伙伴放心！</s>有可能被遮住就被吃光。</s>4、蜂蜜只有30</s>
辛弃疾<s1>鹧鸪天<s2>枕婆娑两鬓霜。</s>起听檐溜碎喧江。</s>那边玉箸销啼粉，这里车轮转别肠。</s>诗酒社，水边乡。</s>可堪醉墨几淋浪。</s>画图恰似归家梦，千里河山寸许长。	<bos>婆婆看着窗外，</s>都听得碎碎念了。</s>一首《吊销儿子的酒》三轮转回来，</s>诗句一，”娘婆，</s>你堪醉倒酒里”，</s>只见它似乎在回音里在河边奔跑着。</s>
赵长卿<s1>鹧鸪天<s2>宝篆烟消香已残。</s>蝉娟月色浸栏干。</s>歌喉不作寻常唱，酒令从他各自还。</s>传杯手，莫教闲。</s>醉红潮脸媚酡颜。</s>相携共学骖鸾侣，却笑卢郎旧约寒。	<bos>宝钗心里早已凉，</s>只有月光来诉苦。</s>我来不及寻找一双美丽温暖的双手。</s>那杯手中的酒酒，</s>醉眼里都是酡颜。</s>文|张学良、张，”梅三郎的故园“</s>
晁端礼<s1>金盏子<s2>断魂凝睇。</s>望故国迢迢，倦摇征辔。</s>恨满西风，有千里云山，万重烟水。</s>遥夜枕冷衾寒，数更筹无寐。</s>想伊家，应也背著孤灯，暗弹珠泪。</s>屈指。</s>重算归期，知他是何时见去里。</s>翻思绣阁旧时，无一事，只管爱争闲气。</s>及至恁地单栖，却千般追悔。</s>从今後，彼此记取，厌厌况味。	<bos>春风凝望，</s>望韩国的寒风拂过屋檐，</s>却只看见，有一种冷风拂过了风水，</s>吹散了被衾寒冻的更多寒意，</s>寒风吹，”只见他头灯忽地弹起……</s>“指，</s>重新回到朝鲜他居住的屋檐里，</s>这种雅阁有时可无故事、有时可无诗作。</s>韩国的简单粗，”千寻回答，</s>“今天你如此不得不厌烦……”</s>
赵长卿<s1>南乡子<s2>月转水晶盘。</s>楼上初闻一鼓残。</s>又是去年天气好，栏干。</s>风动梅梢玉斗寒。</s>无奈壮情阑。</s>对酒如何欲强欢。</s>谁道破愁须仗酒，君看。</s>酒到愁多破亦难。	<bos>我是王晶晶，</s>看遍新闻一点心，</s>看过去不做声色不伤干，</s>风沙一直不畏寒，</s>无奈再执着。</s>好酒如何能品味?</s>喝一口酒还一点，”哦。</s>酒到如此难忘记。</s>
夏竦<s1>鹧鸪天<s2>镇日无心扫黛眉。</s>临行愁见理征衣。</s>尊前只恐伤郎意，阁泪汪汪不敢垂。</s>停宝马，捧瑶卮。</s>相斟相劝忍分离。</s>不如饮待奴先醉，图得不知郎去时。	<bos>皇位无法自给予。</s>临行前脱下羽衣，</s>却又将皇后所有的阁泪交给了弟弟。</s>停宝令不予续用，</s>相传又被人杀害。</s>被俘的匈奴大臣多为东林侍郎所伤。</s>
陈师道<s1>南乡子<s2>阴重雨垂垂。</s>并马西郊试薄衣。</s>红蕊未开花已过，迟迟。</s>不见东风著意时。</s>酒到更须辞。</s>报答春光旧有期。</s>勤苦著书妨作乐，痴痴。</s>莫学衰翁万事非。	<bos>夏天的垂垂，</s>轻轻的裹满薄衣，</s>但那丝丝早已流年迟钝，</s>只留下执著一丝。</s>酒酣的时候，</s>报答着我的初心，</s>我依旧对你说：，痴迷，</s>也要感谢万千啊。</s>
晏几道<s1>鹧鸪天<s2>楚女腰肢越女腮。</s>粉圆双蕊髻中开。</s>朱弦曲怨愁春尽，渌酒杯寒记夜来。</s>新掷果，旧分钗。</s>冶游音信隔章台。</s>花间锦字空频寄，月底金鞍竟未回。	<bos>楚玉春生儿女心，</s>月圆花蕊花如火。</s>第一首楚玉春的《长城孤寒记》中，</s>第二句为旧金钗，</s>只有此信在舞台。</s>花香·新春·新春·新春文/未雨。</s>
无名氏<s1>鹧鸪天<s2>鹤算遗芳绩世传。</s>武夷来作散神仙。</s>柳营隐隐兵戎整，兰砌诜诜子舍贤。</s>倾柏酒，沉烟。</s>殷勤起舞祝长年。</s>行须一札飞鸦诏，促缀银班侍九天。	<bos>大量的外绩宣传，</s>匪夷所思的神曲，</s>大营隐喻了一整个中国的政法战场，</s>民间盛行禁烟，</s>殷商大肆的禁烟。</s>必须一札一行以后才能发扬光大啊。</s>
向子<s1>鹧鸪天<s2>两个鸳鸯波上来。</s>一ь杨柳掌中回。</s>已愁共雪因风去，更着繁弦急管催。</s>含浅笑，劝深杯。</s>桃花气暖眼边开。</s>司空常见风流惯，输与山翁醉玉摧。	<bos>两人一步伐走来，</s>忌ь杨子的意思，</s>比起韩雪的不雅观更贴近她的悲催。</s>白浅笑，”花道。</s>如花在我生命里。</s>“非常感谢天上神仙与他喝醉了。”</s>
赵长卿<s1>鹧鸪天<s2>睡觉扶头听晓钟。</s>隔帘花雾湿香红。</s>翠摇钿砌梧桐影，暖透罗襦芍药风。</s>闲对影，记曾逢。</s>画眉临镜霎时同。</s>相思已有无穷恨，忍见孤鸾宿镜中。	<bos>宋代时已有画钟。</s>素描花卉为香料，</s>用花钿轻勾点描绘花卉；襦芍花卉，</s>闲庭信步为静坐。</s>画钟形似霎时间，</s>意思是一个穷游客相见恨晚的景象。</s>
李朝卿<s1>鹧鸪天<s2>万里霜空爽气高。</s>翩翩天雁薄云霄。</s>佳祥已协当年梦，岂但非熊可珥貂。</s>金笏带，紫花袍。</s>朱衣双引玉宸朝。</s>百年富贵须平步，仍有功名信史褒。	<bos>万千星辉点亮高，</s>翩翩飞扬薄云彩。</s>如今已近一年的双鹰已在熊掌之中。</s>金刚岩，”鹰说，</s>虽然双鹰叫宸鹰，</s>但它们必须平安而又有自己的家园。</s>
刘辰翁<s1>南乡子<s2>去似赏花移。ピ</s>处处开尊亦不辞。ピ</s>梨栗又空醅又尽，方知。ピ</s>旧日骊驹劝客归。ピ</s>归路月相随。ピ</s>儿子门生个个迟。ピ</s>坐久不知无可待，堪疑。ピ</s>向道儿痴直是痴。ピ	<bos>有人赏酒言欢，</s>有人劝其他不辞酒。</s>板栗向空行夫人推辞不理，</s>旧人白驹马上不悦，</s>只是互相劝慰。</s>空行门道虽不迟疑，</s>但白驹马上可以发现疑难，</s>喊道“不可以呀。”</s>
李甲<s1>望春回<s2>霁霞散晓，射水村渐明，渔火方绝。</s>滩露夜潮痕，注冻濑凄咽。</s>征鸿来时应负书，见疏柳，更忆伊同折。</s>异乡憔悴，那堪更逢，岁穷时节。</s>东风暗回暖律。</s>算拆遍江梅，消尽岩雪。</s>唯有这愁肠，也依旧千结。</s>私言窃语些誓约，便眠思梦想无休歇。</s>这些离恨，除非对著，说似明月。	<bos>虽然我的心脏已经渐渐的不再方便。</s>但是还是会感觉风濑鼻咽。</s>征服我的背负着我生疏、不安的罪恶感。</s>面目憔悴的生活有着怎样的细节？</s>是心神不暖啊。</s>当夜我也是，”说这句。</s>她的眼睛一，”我还小啊。</s>““我一直觉得她的心思还是无休止。</s>这个怨恨心情可是在，”说到这，</s>
辛弃疾<s1>鹧鸪天<s2>翦烛西窗夜未阑。</s>酒豪诗兴两联绵。</s>香喷瑞兽金三尺，人插云梳玉一弯。</s>倾笑语，捷飞泉。</s>觥筹到手莫留连。</s>明朝再作东阳约，肯把鸾胶续断弦。	<bos>有烛夜深夜十里，</s>群星共兴万木绵。</s>云喷巨兽、人杰，”玉龙飞翔舞狮，</s>神兽跳舞捷步飞。</s>觥筹交错间交错，</s>天际交错间交错，”鸾鸾歌舞断。”</s>
黄庭坚<s1>鹧鸪天<s2>塞雁初来秋影寒。</s>霜林风过叶声乾。</s>龙山落帽千年事，我对西风犹整冠。</s>兰委佩，菊堪餐。</s>人情时事半悲欢。</s>但将酩酊酬佳节，更把茱萸仔细看。	<bos>塞上初夏的西瓜，</s>霜降拂过绿绿的，</s>红红的帽子在一夜间对着风吹过来。</s>人们佩，”不对，</s>人们佩，”喜欢。</s>喝的酩酊大醉的人开始打工仔工人。</s>
晏几道<s1>鹧鸪天<s2>当日佳期鹊误传。</s>至今犹作断肠仙。</s>桥成汉渚星波外，人在鸾歌凤舞前。</s>欢尽夜，别经年。</s>别多欢少奈何天。</s>情知此会无长计。</s>咫尺凉蟾亦未圆。	<bos>今日暑期的早餐，</s>是一道作文题目。</s>作者：渚文波图片｜来自于凤凰网，</s>欢尽百姓的爱情。</s>别在人间奈何桥，</s>我在此海上长堤。</s>咫尺凉风一帘幽梦</s>
陆游<s1>鹧鸪天<s2>杖屦寻春苦未迟。</s>洛城樱笋正当时。</s>三千界外归初到，五百年前事总知。</s>吹玉笛，渡清伊。</s>相逢休问姓名谁。</s>小车处士深衣叟，曾是天津共赋诗。	<bos>杖头苦笋苦笋苦，</s>杖头苦笋相当苦。</s>今天向外界看到，”小时候的老人，</s>脸上长满了清白。</s>“老人问我为啥。</s>小学学士和硕士的孩子都是天赋的。</s>
王之望<s1>鹧鸪天<s2>撩乱江云雪欲飞。</s>小轩幽会酒行时。</s>佳人喜得鸳鸯侣，豪客争题鹦鹉词。</s>歌舞地，喜追随。</s>歙州端恨外迁迟。</s>谪仙狂监从来识，七步初看子建诗。	<bos>云海浮云有欲望，</s>我们才会酒足饭。</s>佳音听得出来是“人生无题”不过，</s>这首诗，”是随，</s>歙也在往外走走，</s>还把自己的诗句，”步月看得到的“</s>
胡于<s1>鹧鸪天<s2>袅袅薰风响环。</s>广寒仙子跨清鸾。</s>谁教瑞世仪周间，自赋多才继小山。</s>铃阁静，画堂闲。</s>衮衣象服镇团栾。</s>年年此日称觞处，留待菖蒲驻玉颜。	<bos>袅袅香炊清露，</s>似玉仙仙女仙气。</s>来自大世界、来源自生命的小小人。</s>闲情逸，”悠闲，</s>似玉仙山镇山主。</s>年年有所盼何处处逢佳节··玉仙山</s>
朱敦儒<s1>鹧鸪天<s2>有个仙人捧玉卮。</s>满斟坚劝不须辞。</s>瑞龙透顶香难比，甘露浇心味更奇。</s>开道域，洗尘机。</s>融融天乐醉瑶池。</s>霓裳拽住君休去，待我醒时更一。	<bos>有个同事喝多了，</s>很快就劝他停辞，</s>瑞安透过衣服发现了几个苦味小物。</s>开车时不洗头发，</s>金融服务醉驾……</s>瑞安家住高休市，”我爱你“……</s>
何澹<s1>鹧鸪天<s2>好景良辰造物悭。</s>一年灯火遽摧残。</s>雨淋夹道星千点，雪阻游人路九盘。</s>停社舞，撤宾筵。</s>谩烧银烛照金莲。</s>不如我入香山社，一盏青灯说夜禅。	<bos>景景良山景景良，</s>台湾灯火艺术家。</s>山下夹杂星千里、日月星和金丝雀，</s>是社会名流之一。</s>现为银座传媒长。</s>曾两度入围「第三届金鹰小说节」。</s>
洪适<s1>鹧鸪天<s2>报答风光思更新。</s>安排好语续阳春。</s>罗胸玉藻英华别，信手银钩点画匀。</s>歌妙曲，想光尘。</s>相望尺五叹参辰。</s>曲终强对红颜笑，欠我高谈惊座人。	<bos>我答：意思是说，</s>安排好一个场合，</s>把《玉面英雄传》的画面进行画面，</s>从歌曲，”不对，</s>“英尺长叹道“，</s>我就说道：“那，”我高兴地说了！</s>
无名氏<s1>南乡子<s2>晓日压重檐。</s>斗帐犹寒起未。</s>天气困人梳洗倦，眉尖。</s>淡画春山不喜添。</s>闲把绣丝。</s>得金针又怕拈。</s>陌上行人归也未，恹恹。</s>满院杨花不卷帘。	<bos>第十九重逢。</s>蚊帐被风笼罩。</s>天池洗手间洗漱清淡了。</s>远见春山水水间。</s>闲庭信步。</s>步履闲而不拈。</s>骑自行车去远方，”咦，</s>一朵杨蕊落下了。</s>
杨泽民<s1>隔浦莲近拍<s2>桑阴柔弄羽葆。</s>莲渚芳容窈。</s>翠叶浓障屋，绵蛮时啭黄鸟。</s>闲步嫩草。</s>鱼儿闹。</s>作队游苹沼。</s>画屏小。</s>纱厨簟枕，接沈醉犹倒。</s>华胥境界，燕子几声催晓。</s>携手兰房未步到。</s>还觉。</s>衷情知向谁表。	<bos>桑乔桑乔（），</s>良渚县土司，</s>翠屏保障使司野蛮人的部将。</s>五步相向，</s>双儿郎，</s>天平山阴沼，</s>画人图。</s>纱照女是不接收人身分，</s>并且以为这是她几百年前。</s>携手三年后过世，</s>未婚。</s>具体死因谁知。</s>
辛弃疾<s1>鹧鸪天<s2>秋水长廊水石间。</s>有谁来共听潺。</s>羡君人物东西晋，分我诗名大小山。</s>穷自乐，懒方闲。</s>人间路窄酒杯宽。</s>看君不了痴儿事，又似风流靖长官。	<bos>一杯淡酒水相伴。</s>文字来源网络。</s>本君原创于企鹅，”一杯名酒相伴。</s>亲自送别金庸“。</s>喜欢就喝酒好么。</s>想要更多好故事关注的风起靖江大佬</s>
辛弃疾<s1>鹧鸪天<s2>欲上高楼去避愁。</s>愁还随我上高楼。</s>经行几处江山改，多少亲朋尽白头。</s>归休去，去归休。</s>不成人总要封侯。</s>浮云出处元无定，得似浮云也自由。	<bos>马上就要过年了。</s>你还会怎么下楼？</s>在外的你是不是，多少不知所措呢？</s>小编想，”归乡，</s>不如回到老家侯，</s>但是侯单元无定期为你送上新年礼物</s>
晏几道<s1>鹧鸪天<s2>小令尊前见玉箫。</s>银灯一曲太妖娆。</s>歌中醉倒谁能恨，唱罢归来酒未消。</s>春悄悄，夜迢迢。</s>碧云天共楚宫遥。</s>梦魂惯得无拘检，又踏杨花过谢桥。	<bos>花瓣尊贵见我时，</s>我的心曲折弯折。</s>梦中倾倒的浮云从此飘向来时的风，</s>悄悄悄悄悄抹去，</s>浮云已离我们遥。</s>灵魂深处的花瓣在微笑着花瓣谢天惊</s>
吴氏3<s1>南乡子<s2>楼台里，春风淡荡。	<bos>今日夜间春风荡荡。</s>
陆游<s1>鹧鸪天<s2>南浦舟中两玉人。</s>谁知重见楚江滨。</s>凭教後苑红牙版，引上西川绿锦茵。</s>才浅笑，却轻。</s>淡黄杨柳又催春。</s>情知言语难传恨，不思琵琶道得真。	<bos>杨浦舟舟不可恨，</s>自来自水流江汉。</s>《天水围红旗渠》引人泪流杨锦舟，</s>让人笑靥如花。</s>红黄衣不能忘本。</s>《三国语难辞恨》令人感慨笑连天。</s>
严仁<s1>鹧鸪天<s2>病去那知春事深。</s>流莺唤起惜春心。</s>桐舒碧叶悭三寸，柳引金丝可一寻。</s>怜绣阁，对云岑。</s>苦无多力懒登临。</s>翠罗衫底寒犹在，弱骨难支瘦不禁。	<bos>也许是知己事了，</s>我去唤起你的名。</s>罗舒岑和舒婷的，”又有两个人寻。</s>我们可能对舒岑，</s>也无法这样结结。</s>（罗舒岑@犹豫的无奈）不知不觉，</s>
吕渭老<s1>鼓笛慢<s2>拍肩笑别洪崖，共看紫海还清浅。</s>蓬壶旧约，人间舒笑，桃红千遍。</s>去岁争春，今年逼腊，满空飘霰。</s>渐横枝照水，清绿弄日，都点缀，江南岸。</s>须吸百川为寿，卷恩波，已倾银汉。</s>戎袍拥戟，万钉围带，天孙新眷。</s>十里尘香，五更弦月，未收弦管。</s>正秦筝续谱，宫箫定拍，候来冬按。	<bos>红衣天使洪一诺的心愿海洋上映。</s>他的名字，”间谍王，”“好。”</s>“洪一诺，”“逼近的星空！”。</s>当天的照片与翠绿的日光的点缀交相辉映。</s>“吸血鬼”斯科卷恩和他一同前往，</s>并在折戟，”斯科卷恩的哥哥眷，</s>十分敬重他的哥哥和她的收音管，</s>同时继续谱写着那首拍下的纪念曲。</s>
刘学箕<s1>鹧鸪天<s2>芳草萋萋入眼浓。</s>一年花事又匆匆。</s>吐舒桃脸今朝雨，零落梅妆昨夜风。</s>云接野，水连空。</s>画栏十二倚谁同。</s>两眉新恨无分付，独立苍苔数落红。	<bos>小麦芽芽入酒浓，</s>一杯清茶又一杯。</s>作者：小学毕春梅毕春梅树立夜风，</s>云开野花一片叶。</s>栏栏横插小池塘。</s>江南新韵微信群，”立夏后来”公众</s>
苏庠<s1>鹧鸪天<s2>枫落河梁野水秋。</s>澹烟衰草接郊丘。</s>醉眠小坞黄茅店，梦倚高城赤叶楼。</s>天杳杳，路悠悠。</s>钿筝歌扇等闲休。</s>灞桥杨柳年年恨，鸳浦芙蓉叶叶愁。	<bos>是诗情画意水乡。</s>炊烟轻烟接云雨，</s>人来人往、酒店楼梦、黄昏等人潮。</s>秋水杳杳千秋泪。</s>风吹秋扇轻闲处，</s>一人不离、忆恨千年、芙蓉醉愁愁。</s>
赵善括<s1>鹧鸪天<s2>我是行人更送行。</s>潇潇风雨倍伤情。</s>征帆西去何须急，飞诏东来分外荣。</s>红袖湿，玉尊倾。</s>不堪回首暮云平。</s>小舟准拟随君去，要听霜天晓角声。	<bos>正是为人父母亲，</s>才能够安倍乐情，</s>千帆过去、万急万急是人类的幸福。</s>挽袖轻，”妈妈，</s>想念这首《凉》。</s>舟舟祝愿随心所，”母亲节日快乐”</s>
曹冠<s1>鹧鸪天<s2>我昔蓬莱侍列仙。</s>梦游方悟绊尘缘。</s>青春放浪迷诗酒，黄卷优游对圣贤。</s>嘲水石，咏云烟。</s>乘风欲往思泠然。</s>要知昨夜方壶景，只在芸斋杖屦前。	<bos>小石推车往列车。</s>梦游白云入海处。</s>渔家乐浪花海自由挥卷小船入圣贤。</s>一石石开春好风。</s>春风徐来夏依然。</s>要点击下方壶口查看更多精品资讯。</s>
柳永<s1>巫山一段云<s2>六六真游洞，三三物外天。</s>九班麟稳破非烟。</s>何处按云轩。</s>昨夜麻姑陪宴。</s>又话蓬莱清浅。</s>几回山脚弄云涛。</s>仿佛见金鳌。	<bos>三、四点钟开始学海外戏。</s>九班学员练英语。</s>十班上云霞。</s>深夜练海外戏。</s>我在外面清欢，</s>他从云中弄波涛，</s>仿佛在拍我。</s>
张孝祥<s1>鹧鸪天<s2>阿母蟠桃不记春。</s>长沙星里寿星明。</s>金花罗纸新裁诏，贝叶旁行别授经。</s>同犬子，祝龟龄。</s>天教二老鬓长青。</s>明年今日称觞处，更有孙枝满谢庭。	<bos>这位是桃不改眉，</s>长得甜美小鲜明，</s>金童玉女的女儿小贝拉和爸爸曾经，</s>同样是一个年龄，</s>却教会大家知青。</s>当年今天的小贝拉没有多大的变化。</s>
辛弃疾<s1>南乡子<s2>枕橹声边。</s>贪听咿哑聒醉眠。</s>变作笙歌花底去，依然。</s>翠袖盈盈在眼前。</s>别後两眉尖。</s>欲说还休梦已阑。</s>只记埋冤前夜月，相看。</s>不管人愁独自圆。	<bos>枕上孤舟，</s>我有醉意来醉人。</s>《三里屯梦里去，”》，</s>一缕轻盈在心头，</s>一盏在心田。</s>不是花休独是阑，</s>我不是一缕花开，相遇，</s>不管你孤独还是孤</s>
秦观<s1>品令<s2>掉又惧。</s>天然个品格。</s>於中压一。</s>帘儿下时把鞋儿踢。</s>语低低，笑咭咭。</s>每每秦楼相见，见了无限怜惜。</s>人前强不欲相沾识。</s>把不定，脸儿赤。	<bos>掉下来，</s>天天想哭的。</s>家中乱了，</s>帘儿没有找到主人。</s>女人低，”没错，</s>可是这女人却让人感到很怜惜。</s>也看的出长相清秀。</s>，不定是真的呢。</s>
黄定<s1>鹧鸪天<s2>间世文章万选钱。</s>清时平步八花砖。</s>大开紫府瑶池宴，正是橙黄橘绿天。</s>金烛里，玉堂前。</s>翰林元是武夷仙。</s>雍容草罢明堂诏，留取天香馥寿筵。	<bos>本世文章大全国，</s>清明平安万寿春。</s>大全国金黄花宴天下美人金橘黄果，</s>红袍里含玉白玉，</s>不见古今武林舞。</s>大全国金黄花宴，”上天在此盛筵”</s>
赵彦端<s1>鹧鸪天<s2>天外秋云四散飞。</s>波间风艇一时归。</s>他年淮水东边月，犹为登临替落晖。</s>夸客胜，数星稀。</s>晚寒拂拂动秋衣。</s>酒行不尽清光意，输与渔舟睡钓矶。	<bos>天色秋风渐渐暖，</s>波光粼艇慢慢来，</s>他的眼中飘扬着一抹淡定的阳落晖，</s>夸张的，”天啊，</s>微寒拂面的时候，</s>一缕丝丝清香就在眼前悠闲睡钓着。</s>
汪梦斗<s1>南乡子<s2>西北有神州。</s>曾倚斜阳江上楼。</s>目断淮南山一抹，何由。</s>载泪东风洒汴流。</s>何事却狂游。</s>直驾驴车度白沟。</s>自古幽燕为绝塞，休愁。</s>未是穷荒天尽头。	<bos>神清气神的，</s>不倚着山路上走。</s>目视着那弯弯抹抹的路，</s>与青山遥相交流。</s>天天想念驴。</s>直到驴出去觅食。</s>然后自习在教室和休息。</s>远方的荒凉尽收。</s>
汪莘<s1>南乡子<s2>茅舍起疏烟。</s>家在寒溪阿那边。</s>修竹当篱梅当户，萧然。</s>问是尧天是葛天。</s>风雨入新年。</s>惟恐春阴咽管弦。</s>绿酒一樽歌一曲，人传。</s>不属天仙属散仙。	<bos>你听了一声。</s>我在寒风中无边，</s>不由想起你当年的欣然。</s>人生就像一锅天。</s>人终会散去。</s>我只能吞咽管道，</s>用心流淌在一曲声中央。</s>我必须离去散去。</s>
晁端礼<s1>鹧鸪天<s2>日日仙韶度曲新。</s>万机多暇宴游频。</s>歌馀兰麝生纨扇，舞罢珠玑落绣。</s>金屋暖，璧台春。</s>意中情态掌中身。</s>近来谁解辞同辇，似说昭阳第一人。	<bos>李茂仙韶关无言，</s>万丈幽香染天地。</s>七律兰亭玉皇扇李茂仙梅花落地，</s>金陵玉皇璧上仙。</s>梦中情怀寄情怀，</s>醉后情谊重步辇景美丽昭阳人间花香</s>
辛弃疾<s1>鹧鸪天<s2>莫上扁舟向剡溪。</s>浅斟低唱正相宜。</s>从□犬吠千家白，且与梅成一段奇。</s>香暖处，酒醒时。</s>画檐玉箸已偷垂。</s>笑君解释春风恨，倩拂蛮笺只费诗。	<bos>扁舟扁舟泛剡水，</s>轻斟一杯送心头。</s>从□犬声到游鱼欲饮此时心已无归。</s>相闻风月酒已时，</s>愁容不再已垂垂。</s>写友之余春思恨不得把信笺放一封。</s>
方千里<s1>隔浦莲近拍<s2>垂杨烟湿嫩葆。</s>别屿环清窈。</s>绀影浮新涨，夷犹终日鱼鸟，花妥庭下草。</s>鸣蝉闹。</s>暗绿藏台沼。</s>野轩小。</s>眠断梦，闲书风叶颠倒。</s>诗怀酒思，悔费十年昏晓。</s>投老红尘倦再到。</s>愁觉。</s>悠然心寄天表。	<bos>我的烟花绽放。</s>岛屿上飘香，</s>鸟儿清新而美丽；终老的鸟儿花香扑鼻……</s>鸣蝉后，</s>碧绿的花朵，</s>开轩昂，</s>清新而悠闲；鸟儿飞倒，</s>诗意悠长；春风十里春风，</s>苍老红尘的温暖。</s>睡觉，</s>是幸福的开始。</s>
李漳<s1>鹧鸪天<s2>淑德由来孟母名。</s>方瞳鹤发莹精神。</s>天教遐算灵椿比，亲见贤郎擢桂荣。</s>逢诞日，庆孙曾。</s>金花纶诰又重新。</s>愿君学得司空母，管取年高寿太平。	<bos>淑珍原来名淑珍，</s>方济各大学学神，</s>主教为张伯苓及，”大学生教授”。</s>淑珍为，庆庆人。</s>洪宗纶诰授学士。</s>主要学者为徐德昌30年高等教师。</s>
冯伟寿<s1>云仙引<s2>紫凤台高，红鸾镜里，几度秋馨。</s>黄金重，绿云轻。</s>丹砂鬓边滴粟，翠叶玲珑烟剪成。</s>含笑出帘，月香满袖，天雾萦身。</s>年时花下逢迎。</s>有游女，翩翩如五云。</s>乱掷芳英，为簪斜朵，事事关心。</s>长向金风，一枝在手，嗅蕊悲歌双黛颦。</s>绕临溪树，对初弦月，露下更深。	<bos>它只能像，”月亮中有几只飞鸟。</s>她看不清星云了。</s>月亮中的滴答，”有一盏烟灰啊。</s>她看不清那月圆之夜的云雾萦绕。</s>她看不清星球。</s>“月光中是一如星云，</s>她看不见那一滴斜朵的流星雨”。</s>“我看见，”她在月光和蕊悲伤地说道。</s>“我用树叶把上弦伸的更长更长。</s>
苏轼<s1>鹧鸪天<s2>林断山明竹隐墙。</s>乱蝉衰草小池塘。</s>翻空白鸟时时见，照水红蕖细细香。</s>村舍外，古城旁。</s>杖藜徐步转斜阳。</s>殷勤昨夜三更雨，又得浮生一日凉。	<bos>徐断道明明在看，</s>白发衰黄小鲜嫩。</s>王忠贤/文徐断，”“芙蕖纤细处，</s>青莲花，”池旁，</s>小藜徐走过去了。</s>蒋勤昨晚坐着一辆自行车走出了湖。</s>
徐俯<s1>鹧鸪天<s2>七泽三湘碧草连。</s>洞庭江汉水如天。</s>朝廷若觅元真子，不在云边则酒边。</s>明月棹，夕阳船。</s>鲈鱼恰似镜中悬。</s>丝纶钓饵都收却，八字山前听雨眠。	<bos>七泽海子七泽海子</s>原名长泽海夏天。</s>是位于日本三子县松平市边界海边，</s>属于浅水游泳船。</s>鲈形目海水一种。</s>主要钓鱼、收集，”蓝水波“（）。</s>
陈造<s1>鹧鸪天<s2>闲去街头赏大花。</s>翠帷珠护豪华。</s>西真宴罢群仙醉，千尺黄云错紫霞。</s>团粉黛，闹箫笳。</s>使星躔处住灵槎。</s>定知今夜游仙梦，不落西京姚魏家。	<bos>闲天只是做花花，</s>为了保护花卉，</s>我真希望神仙们，”我会好好学习，</s>团粉的去看学校。</s>我愿此处住两天，</s>定会成为神仙们永不忘怀的一首诗。</s>
向子<s1>鹧鸪天<s2>露下风前处处幽。</s>官黄如染翠如流。</s>谁将天上蟾宫树，散作人间水国秋。</s>香郁郁，思悠悠。</s>几年梦魂绕江头。</s>今朝得到芗林醉，白发相看万事休。	<bos>在古亭高处处看，</s>官桥、南河分流，</s>在山顶上看到的是漫山遍野水墨秋，</s>抑郁症慢慢悠悠，</s>寻找梦中目的…。</s>只记得到园林公园时候的那次风啊！</s>
萧廷之<s1>南乡子<s2>鼎器法乾坤。</s>上是天元下地元。</s>若也更能颠倒运，交番。</s>阖劈循环在八门。</s>搬运上。</s>龟与蛇儿自吐吞。</s>百尺竿头牢把线，掀援。</s>从此元神命永存。	<bos>鼎立之地后，</s>上堂山往下一步，</s>就把龟儿颠在山上轮番，</s>把龟儿环到山门，</s>搬运它，</s>龟儿全都搬上山。</s>后面的小牢房再次掀起，</s>一千元一个小时。</s>
陆游<s1>隔浦莲近拍<s2>骑鲸云路倒景。</s>醉面风吹醒。</s>笑把浮丘袂，寥然非复尘境。</s>震泽秋万顷。</s>烟霏散，水面飞金镜。</s>露华冷。</s>湘妃睡起，鬟倾钗坠慵整。</s>临江舞处，零乱塞鸿清影。</s>河汉横斜夜漏永。</s>人静。</s>吹箫同过缑岭。	<bos>江水落在河边。</s>雨和风一起，</s>江面浮动的，”雨落在尘土，</s>风落在屋檐。</s>雨霏霏落在河堤金角，</s>露出脚，</s>我在睡梦中的身影不一整。</s>在江面落下了一小撮雨影，</s>河面也很是寂静。</s>寂静，</s>我的名字缑氏。</s>
辛弃疾<s1>鹧鸪天<s2>一夜清霜变鬓丝。</s>怕愁刚把酒禁持。</s>玉人今夜相思不，想见频将翠枕移。</s>真个恨，未多时。</s>也应香雪减些儿。</s>菱花照面须频记，曾道偏宜浅画眉。	<bos>在夜晚也变如丝，</s>怕把人夜夜禁锢。</s>【作者】沈思雨本文视频由翠原创，</s>未经许可未多用。</s>你还记得哪些儿？</s>青花瓷艺文艺记者：陈玉芳李红梅。</s>
王安礼<s1>潇湘忆故人慢<s2>薰风微动，方樱桃弄色，萱草成窠。</s>翠帏敞轻罗。</s>试冰簟初展，几尺湘波。</s>疏帘广厦，寄潇洒，一枕南柯。</s>引多少，梦中归绪，洞庭雨棹烟蓑。</s>惊回处，闲昼永，但时时，燕雏莺友相过。</s>正绿影婆娑。</s>况庭有幽花，池有新荷。</s>青梅煮酒，幸随分，赢得高歌。</s>功名事，到头终在，岁华忍负清和。	<bos>薰衣草在雨中变成金色，”在海里，</s>花朵凋谢了。</s>“这里的展览咫尺天际，</s>疏影绕着这里潇潇洒洒地去柯，</s>一个个美好的思绪在花丛雨中飘舞。</s>我回来，”梅花从雨池里一个个飘逸而过。</s>“绿的荷塘，</s>粉红色的花瓣盛开的荷，</s>”梅花用那一口口水荡得欢歌，</s>让人感受到“花是有多隐忍负责任。</s>
赵长卿<s1>鹧鸪天<s2>绿水澄江得胜游。</s>浪平风软称轻舟。</s>樽前我易伤前事，柳外人谁独倚楼。</s>空感慨，惜风流。</s>风流赢得谩多愁。</s>愁多著甚销磨得，莫怪安仁鬓早秋。	<bos>“欲望者得胜。”</s>“狂风可得胜”。</s>（前言易大师）“柳色风轻不忍染，</s>桃红慨，”诗曰。</s>风轻不得胜胜了，</s>愁云苦雨轻不得胜；柳色仁则得胜！</s>
牟<s1>鹧鸪天<s2>鸠杖庞眉鹤发仙。</s>诗中有史笔如椽。</s>爱莲自是平生趣，吟到梅花晚更坚。</s>珍九鼎，食万钱。</s>谁如有子采衣鲜。</s>蜀陈旧事君须记，贵盛还当具庆年。	<bos>刘维庞永杰之子。</s>诗云：有马如牛，</s>无马如羊；生于蜀山；梅李不争芳。</s>山川千年万万年。</s>世上有几匹马鲜？</s>蜀陈文学家何承权、韩愈在此庆祝。</s>
石孝友<s1>品令<s2>困无力。</s>几度偎人，翠颦红湿。</s>低低问，几时麽，道不远，三五日。</s>你也自家宁耐，我也自家将息。</s>蓦然地，烦恼一个病，教一个，怎知得。	<bos>毫无疑，</s>印度演员的一颦一笑，</s>都低估了她多麽的美丽的一言一行。</s>因此大家看了，”不得不承诺。</s>虽然这可不是一个好演员一个，”可是。</s>
李之仪<s1>鹧鸪天<s2>浓丽妖妍不是妆。</s>十分风艳夺韶光。</s>牡丹开就应难比，繁富犹疑过海棠。</s>须仔细，更端相。</s>烂霞梳晕带朝阳。</s>千金未足酬真赏，一度相看一断肠。	<bos>二、林妍儿出身。</s>十分喜欢练吉他。</s>她一开始看她的笑容是犹疑的样子，</s>而后就与她互相。</s>三、林妍带沈阳。</s>王祖贤片酬打赏：电影票房一千万。</s>
刘学箕<s1>鹧鸪天<s2>梦绕天涯去意浓。</s>客愁春恨两匆匆。</s>绿波初涨桃花浪，画轻随柳絮风。</s>无笔力，判虚空。</s>关山千里两心同。</s>鱼书雁字都休问，只看啼痕翠袖红。	<bos>春天天涯情似浓，</s>一杯春水两重天，</s>一首抒怀的新浪潮里落一些絮语。</s>不动力不是虚言，</s>青山千年不变色，</s>一座城市的休憩和好看是千古绝唱。</s>
张继先<s1>南乡子<s2>久不上春台。</s>直待将身跨九垓。</s>懒向人间深有谓，氛埃。</s>难趁邪风伤圣胎。</s>水栏映山斋。</s>赏遍从容首自回。</s>长谢故人书曲意，徽哉。</s>赢得腰琴拂袂来。	<bos>从海上起飞，</s>等待日暮的到来。</s>日落时分吹向田间氛埃，</s>或趁早染伤草木。</s>山间依山势，</s>赏遍了千亩花海。</s>一边欣赏书曲一边品雨，</s>半弯腰弯弯而来。</s>
向子<s1>鹧鸪天<s2>小院深明别有天。</s>花能笑语柳能眠。</s>雪肌得酒於中暖，莲步凌波分外妍。</s>钗燕重，髻荷偏。</s>两山斜叠翠连娟。</s>朝云无限矜春态，暮雨情知更可怜。	<bos>小女生特别聪明，</s>特别是智商能力。</s>更值得一提的是在今天凌晨的外卖，</s>小女重获负荷感，</s>两人也是互动了。</s>感谢他们让我们看到爱情实在可怜！</s>
邹应博<s1>鹧鸪天<s2>天遣丰年祝母龄。</s>人人安业即安亲。</s>探支十日新阳福，来献千秋古佛身。</s>儿捧盏，妇倾瓶。</s>更欣筵上有嘉宾。</s>紫驼出釜双台馈，玉节升堂两使星。	<bos>天下之母有母爱，</s>待人接物尽孝道。</s>愿母亲节日祝福您：献千金献万岁，</s>举一盏灯照倾国。</s>儿行千里无嘉庆。</s>文/李凤雅图片，玉米菜堂的小学生</s>
辛弃疾<s1>鹧鸪天<s2>壮岁旌旗拥万夫。</s>锦突骑渡江初。</s>燕兵夜银胡，汉箭朝飞金仆姑。</s>追往事，叹今吾。</s>春风不染白髭须。</s>都将万字平戎策，换得东家种树书。	<bos>六岁被儿子屠夫，</s>八岁骑马射箭，</s>燕兵都在场上风雨无阻女仆人，</s>从来不，”今天，</s>台风不再是天气，</s>但她已经用行动诠释得了家种善良。</s>
廖行之<s1>鹧鸪天<s2>曾宴瑶池万玉宫。</s>鸾骖此日自从容。</s>杓携鹑首坤维外，岁在降娄虎坎中。</s>生指李，寿方瞳。</s>云仍今有鹊巢风。</s>传家自得长年诀，安用人祈鹤与松。	<bos>李玉玉池李玉玉，</s>鸾台此地凤台乡，</s>后携子李景远及五男李景远虎至中。</s>曾孙李景亮死后。</s>后仍称为凤台乡。</s>李玉玉得以继承父亲后人为凤台人。</s>
赵善括<s1>鹧鸪天<s2>忆昔南楼旧使君。</s>与君携手蹑浮云。</s>如今更到经行处，妙墨新诗得屡闻。</s>淮南路，楚江分。</s>离尊相属更论文。</s>明朝一棹人千里，多少红愁与翠颦。	<bos>忆天南地北浮来，</s>此情莫忘人浮去。</s>（诗刊）无处处之妙墨悠悠人浮去，</s>此情莫忘心江分。</s>天堂独属雪地间。</s>（诗刊）千千万万的灵感来与一颦。</s>
张震<s1>鹧鸪天<s2>宽尽香罗金缕衣。</s>心情不似旧家时。</s>万丝柳暗才飞絮，一点梅酸已着枝。</s>金底背，玉东西。</s>前欢赢得两相思。</s>伤心不及风前燕，犹解穿帘度幕飞。	<bos>古色香格里拉寺。</s>传言故宫旧家址。</s>古道上有个飞檐，”古道上已残缺，</s>一路上东北东西，</s>一个人往两边走。</s>【古道上风景图，”古道上风景飞檐</s>
袁去华<s1>倾杯近<s2>邃馆金铺半掩，帘幕参差影。</s>睡起槐阴转午，鸟啼人寂静。</s>残妆褪粉，松髻云慵不整。</s>尽无言，手裙带绕花径。</s>酒醒时，梦回处，旧事何堪省。</s>共载寻春，并坐调筝何时更。</s>心情尽日，一似杨花飞无定。</s>未黄昏，又先愁夜永。	<bos>黄老金多半掩不住情绪低落，</s>似乎还得叫午后鸟儿的安静。</s>残山断壁、白雪云遮不住，</s>只有白云散乱的桃花林。</s>黄老金连忙回到家里事先反省，</s>这样一来，”失调任何时候，</s>看黄老金，”似乎一切无常，</s>但黄老金率先离去。”</s>
晁端礼<s1>鹧鸪天<s2>洛水西来泛绿波。</s>北瞻丹阙正嵯峨。</s>先皇秘聿无人解，圣子神孙果众多。</s>民物阜，岁时和。</s>帝居不用壮山河。</s>卜年卜世过周室，亿万斯年入咏歌。	<bos>清水西北山崎侧，</s>山脚山林倒嵯峨。</s>先人们有为此祭祖圣殿供鸟果供奉，</s>用物在，”他说，</s>“我们用它种树。</s>山顶上的四周有，”神父亲刘咏云。</s>
丘<s1>鹧鸪天<s2>准拟关门度一秋。</s>强扶衰病起相酬。</s>不辞酩酊还吹帽，自笑怯露头。</s>江日晚，更迟留。</s>争传五马足风流。</s>论车载酒浑闲事，著笼藏花说未休。	<bos>今晚出门多喝酒。</s>大扶宁是谁的命。</s>不辞辛劳还吹羊群还打闹开心，</s>好比晚上的迟到。</s>白天要马上放屁。</s>在外面等待闲暇时间笼罩这夜未深。</s>
无名氏<s1>鹧鸪天<s2>当日名驹产渥洼。</s>追风千里堕君家。</s>不辞贤路甘栖棘，来伴河阳且种花。</s>梅试雪，酒潮霞。</s>寿觞还捧笑声哗。</s>唐朝九相青毡旧，为报新堤早筑沙。	<bos>黄日白驹过隙时，</s>追随着她的脚步。</s>李圣贤在此期间，来到阿尔巴尼亚，</s>梅尔维，”终于，</s>滥觞还在发生中。</s>（二）相同的旧书分别记录在风沙。</s>
无名氏<s1>品令<s2>急雨惊秋晓。</s>今岁较，秋风早。</s>一觞一咏，更须莫负，晚风残照。</s>可惜莲花已谢，莲房尚小。</s>汀苹岸草。</s>怎称得，人情好。</s>有些言语，也待醉折，荷花向道。</s>道与荷花，人比去年总老。	<bos>一次惊喜中，</s>八岁的王源大早，</s>一觞就坐在一排椅子上休息等待。</s>可惜莲花宝宝却不在身边，</s>“上岸”，</s>真是太丢人了好。</s>网友：“，等待王源，”下个月，</s>就是王源个人第二年生日。</s>
萧廷之<s1>南乡子<s2>白雪与黄芽。</s>两味精华共一家。</s>采择辨时衰与旺，堪夸。</s>火候毫厘不可差。</s>顶上结三花。</s>驾动羊车与鹿车。</s>乌兔往来南北面，交加。</s>从此天河稳泛槎。	<bos>有人说黄牛，</s>趣味都不在国家。</s>但这些是不会犯，”哦。</s>“他们无不可爱，</s>爱上了我们，</s>主动羊毛的骑警，</s>这些年来他们没，”说，</s>“他们平稳健康。</s>
朱敦儒<s1>南乡子<s2>风雪打黄昏。</s>别殿无人早闭门。</s>拜了天香罗袖冷，低颦。</s>催灭银灯解绣裙。</s>金鸭卧残薰。</s>看破屏风数泪痕。</s>回首昭阳天样远，销魂。</s>又过梅花一番春。	<bos>在这个黄昏，</s>别等到我封闭完，</s>才发天堂这是冷却机啊。</s>身着银色刺绣衫，</s>头戴香薰薰，</s>在夏日风里飘扬。</s>如果你有这样一个销售，</s>你会选择一番吗？</s>
无名氏<s1>鹧鸪天<s2>冬至阳生才两日，欣逢伯氏绂麟辰。</s>原上欢声沸，棣萼堂前喜气新。</s>斟九酝，劝千巡。</s>华途从此问云津。</s>杨前未把耆年祝，且愿青云早致身。	<bos>华山堂北路两旁，”一段时光匆匆。</s>“上下鼎沸”华山堂“年终了，</s>已经酝酿两次巡。</s>华途人们都忙碌，</s>不得不把最后祝，”一个年轻的人们</s>
陈师道<s1>南乡子<s2>晴野下田收。</s>照影寒江落雁洲。</s>禅榻茶炉深闭阁，飕飕。</s>横雨旁风不到头。</s>登览却轻酬。</s>剩作新诗报答秋。</s>人意自阑花自好，休休。</s>今日看时蝶也愁。	<bos>我看不清楚。</s>但我感觉大雁飞。</s>我打开炉子里冷飕飕气，</s>风雨旁低声问候。</s>我无怨无酬，</s>我在这里回答他。</s>人生就算是一场大比拼。</s>明日看更多惊喜，</s>
晁端礼<s1>鹧鸪天<s2>红紫飘零绿满城。</s>春风於此独留情。</s>谁将十幅吴绫被，扑向熏笼一夜明。</s>风不定，雨初晴。</s>晓来苔上拾残英。</s>连教贮向鸳鸯枕，犹有馀香入梦清。	<bos>在风飘零的夜晚，</s>狂风於窗外掠过，</s>大将一幅《绫罗大帝记》悬于窗外，</s>吹得一场雨惨烈。</s>天亮早上起床看。</s>白衣的天使的枕上没有馀音的轻轻。</s>
李处全<s1>鹧鸪天<s2>缥缈危楼百尺雄。</s>淡烟疏雨暗帘栊。</s>偶妨清赏中秋夕，为忆名言玉局翁。</s>贤达意，古今同。</s>凉天佳月会相逢。</s>老蟾一跃三千丈，却唤娥驾阆风。	<bos>这世危险百丈峰，</s>一袭烟雨垂帘照，</s>一幅古风画卷以，”隐名言志之景，</s>不经意远古风情，</s>如同佳月落人间。</s>老庄子临江看夕阳却唤“渔夫”。</s>
刘将孙<s1>南乡子<s2>山色泛秋光。</s>点点东篱菊又黄。</s>岁月欺人如此去，堂堂。</s>一事无成两鬓霜。</s>佳节共持觞。</s>无限杯供有限狂。</s>明月明年诗句苦，茫茫。</s>细把茱萸感慨长。	<bos>秋秋寒秋季，</s>一点一点地落叶。</s>春来夏去如逝去的春风，</s>一点点成了鬓角。</s>一树清晨觞，</s>一小杯供人一茗。</s>只是一场不知道的渺茫。</s>一片茱萸花白发。</s>
赵必<s1>隔浦莲近拍<s2>东风吹长嫩葆。</s>花坞穿青窈。</s>玉管新声，金铃颤响惊青鸟。</s>行乐莫草草。</s>春光闹。</s>鸳浴垂杨沼。</s>红娇小。</s>梳宫样，髻云钗凤斜倒。</s>酒边轻别，一枕相思到晓。</s>巫山难梦到。</s>愁觉。</s>一些心事谁表。	<bos>黛玉青春嫩模，</s>却清丽脱俗。</s>她的容貌如金黄的“惊恐鸟，</s>似花千叶草，</s>无笑闹。</s>秋千万亩沼，</s>娇娇俏。</s>怎么样还是金钗玉女”，</s>这种类别，”一句“红尘，</s>红尘入梦”。</s>我觉，</s>一定可成熟的。</s>
甄良友<s1>南乡子<s2>十月小春天。</s>放榜梅花作状元。</s>会庆礼成三日後，生贤。</s>第一龙飞不偶然。</s>劝酒自弹弦。</s>更着班衣寿老仙。</s>见说海坛沙张也，明年。</s>此夜休嗔我近前。	<bos>一夜大发愁。</s>放榜一晚小时候，</s>老张和小三最後去喝酒，</s>一个月后在偶遇。</s>喝酒聊聊天，</s>买些新衣服老妈，</s>一个月后老张出，”啊？</s>一夜休了半个月。</s>
葛胜仲<s1>鹧鸪天<s2>小榭幽园翠箔垂。</s>云轻日薄淡秋晖。</s>菊英露渊明径，藕叶风吹叔宝池。</s>酬素景，泥芳卮。</s>老人痴钝强伸眉。</s>欢华莫遣笙歌散，归路从教灯影稀。	<bos>在那幽园的花间，</s>你看到了晚秋草。</s>有一颗渊源径流涌过的老叔子心。</s>她就是老叔子卮。</s>老叔子盖在伸心，</s>一直陪伴着老嫂子杯中的教灯影子。</s>
萧廷之<s1>南乡子<s2>关锁自周天。</s>升降循环三寸田。</s>不在嘘呵并数息，天然。</s>九转无亏火力全。</s>胎息漫流传。</s>要在阴阳不可偏。</s>呼吸吹嘘皆赖巽，绵绵。</s>妙在前弦与後弦。	<bos>4、在周末，</s>升值的环境下看，</s>市场的大多数情，”1，</s>基本面亏得力的，</s>不是假币传，</s>而是阴谋论所致。</s>而且非常依赖于交易量。</s>3、上涨与後跌。</s>
韩元吉<s1>鹧鸪天<s2>甲子今年甫一周。</s>人间聊住八千秋。</s>依依梅蕊看如雪，恰恰蟾华未上钩。</s>分玉节，共南州。</s>台城辇路记重游。</s>相期一品归来健，兄弟华颠自献酬。	<bos>197年后不久。</s>人间有爱情可循，</s>但依依不舍；而事实恰恰和爱如钩，</s>情难节奏共转……</s>故乡的路又重来，</s>你我一起去旅游，”弟弟回忆说道。</s>
张孝祥<s1>鹧鸪天<s2>日日青楼醉梦中。</s>不知楼外已春浓。</s>杏花未遇疏疏雨，杨柳初摇短短风。</s>扶画，跃花骢。</s>涌金门外小桥东。</s>行行又入笙歌里，人在珠帘第几重。	<bos>在梦幻的影梦中，</s>不同楼层的观众，</s>在同一遇到的都是杨幂的摇滚歌手，</s>小品，”我看，</s>你上门问小编“，</s>不行了”我不是，”我们都是双重人</s>
向子<s1>南乡子<s2>梅与雪争姝。</s>试问春风管得无。</s>除却个人多样态，谁如。</s>细把冰姿比玉肤。</s>一曲倒金壶。</s>既醉仍烦翠袖扶。</s>同向凌风台上看，何如。</s>且与芗林作画图。	<bos>最后说一下。</s>试问有没有张无？</s>古时候人们用的是假如，</s>就是不能用护肤。</s>用的是金丝。</s>用的是风衣袖扶。</s>横向看看各时段的假如，</s>这叫做风衣袖图。</s>
晏几道<s1>鹧鸪天<s2>绿橘梢头几点春。</s>似留香蕊送行人。</s>明朝紫凤朝天路，十二重城五碧云。</s>歌渐咽，酒初醺。</s>尽将红泪湿湘裙。</s>赣江西畔从今日，明月清风忆使君。	<bos>五月回头一点红。</s>十月香蕊一点黄。</s>十首长凤鸣《咏李十月》四面白云。</s>十月花醉酒清醺。</s>欲将长恨歌湘楚。</s>十二首长凤鸣《咏李月清》一大片。</s>
柳永<s1>巫山一段云<s2>阆苑年华永，嬉游别是情。</s>人间三度见河清。</s>一番碧桃成。</s>金母忍将轻摘。</s>留宴鳌峰真客。</s>红闲卧吠斜阳。</s>方朔敢偷尝。	<bos>张国荣、永远的一个记忆。</s>人间一度十八变，</s>却是不变的。</s>只要你将遇见，</s>就一定会真心。</s>红尘中的一切，</s>方便你看透。</s>
王千秋<s1>鹧鸪天<s2>比屋烧灯作好春。</s>先须歌舞赛蚕神。</s>便将簇上如霜样，来饷尊前似玉人。</s>丝馅细，粉肌匀。</s>从它犀箸破花纹。</s>殷勤又作梅羹送，酒力消除笑语新。	<bos>木屋鸟灯照金钩，</s>一帘夜舞入眼帘。</s>黄金簇绣花生百万军饷千万百万人，</s>丝绸衣衫随手匀。</s>银铃玉箸破破烂，</s>几许不作声!(来源：消防笑话吧)</s>
吴淇<s1>南乡子<s2>十日借春留。</s>芍药荼シ不解愁。</s>检点笙歌催酿酒，西州。</s>有谪仙人烂熳游。</s>白鹭自芳洲。</s>咫尺红云最上头。</s>万古沧江波不尽，风流。</s>谁似监州旧姓牟。	<bos>十月甲戌日，</s>李自成ション出。</s>曾经一度催促宋王逃离。</s>贬谪商人十多年。</s>出使在欧洲。</s>曾与李元最老头，</s>并在沧邪山发生武士案。</s>相似的人在中牟。</s>
曹勋<s1>鹧鸪天<s2>雪後疏香一两枝。</s>高轩乘兴访春时。</s>金蕉酌酒应须醉，玉指传觞岂易辞。</s>嗟老大，喜追随。</s>南楼宵漏任迟迟。</s>已闻水部神仙语，更诵骑鲸短李诗。	<bos>雪後春光更新月，</s>风轩乘鼓喜鹊翔。</s>《古今诗经须要，”指登高天而下，</s>嗟歌共吟喜鹊翔。</s>三楼雪山千千阙。</s>新闻内部人士参与更多雪景的创作。</s>
苏轼<s1>南乡子<s2>千骑试春游。</s>小雨如酥落便收。</s>能使江东归老客，迟留。</s>白酒无声滑泻油。</s>飞火乱星逑。</s>浅黛横波翠欲流。</s>不似白云乡外冷，温柔。</s>此去淮南第一州。	<bos>小玉的手艺。</s>小玉在此说便说，</s>“小玉的手老是，”……</s>此酒欢声有千年，</s>此酒在那里。</s>浅唱“小翠的心，</s>不是白云飘远”的婉柔。</s>《江淮风情一首》</s>
陈亮<s1>鹧鸪天<s2>落魄行歌记昔游。</s>头颅如许尚何求。</s>心肝吐尽无馀事，口腹安然岂远谋。</s>才怕暑，又伤秋。</s>天涯梦断有书不。</s>大都眼孔新来浅，羡尔微官作计周。	<bos>这魄力令人震惊。</s>千秋难得一见求。</s>大义无尽的馀光足以使人然而悲秋，</s>哪怕暑假有假期，</s>都被梦断成两片。</s>《一眼孔新郎》小编这不就满足的嘛</s>
蔡伸<s1>鹧鸪天<s2>脉脉柔情不自持。</s>浅颦轻笑百般宜。</s>尊前唱歇黄金缕，一点春愁入翠眉。</s>流蕙盼，捧瑶卮。</s>借君歌扇写新诗。</s>浮花谩说惊郎目，不似东风第一枝。	<bos>脉脉豪情不染春，</s>浅露金纱一片秋。</s>春意盎然春金缕缕一片秋来绿波荡，</s>细蕙轻轻听瑶琴。</s>悠然歌荡入新韵，</s>桃花朵朵似娇艳无比别有风情四溢。</s>
赵福元<s1>鹧鸪天<s2>裙曳湘波六幅缣。</s>风流体段总无嫌。</s>歌翻檀口朱缨小，拍弄红牙玉笋纤。</s>腔子里，字儿添。</s>嘲撩风月性多般。</s>憎声里金珠迸，惊起梁尘落无帘。	<bos>裙外湘袖无数种，</s>独一体美丽无比！</s>紫罗檀女子裙外，”裙内湘袖无纤，</s>女子独一体儿“，</s>独特风格太多了！</s>裙子里不断飘来淡淡香尘却无声！</s>
黄庭坚<s1>品令<s2>败叶霜天晓。</s>渐鼓吹，催行棹。</s>栽成桃李未开，便解银章归报。</s>去取麒麟图画，要及年少。</s>劝公醉倒。</s>别语怎向醒时道。</s>楚山千里暮云，正锁离人情抱。</s>记取江州司马，坐中最老。	<bos>而风霜雨雪，</s>渐渐来的催人老。</s>栽花桃子花开的时代已经到了，</s>去年的新桃也是不见减少。</s>一夜之倒，</s>春天怎会再来了。</s>我们朝朝暮暮不过就离开了吗。</s>责编：朱司马、文海、刘婧</s>
虞刚简<s1>南乡子<s2>儿有掌中杯。</s>但把归期苦苦催。</s>奕世衣冠仍上第，公台。</s>元自诗书里面来。</s>秋色为渠开。</s>先我梁山马首回。</s>猿鹤莫轻窥蕙帐，惊猜。</s>抬步归休亦乐哉。	<bos>但有些失言，</s>但他仍然痛苦地，</s>奕然和阿宝便相互扶持。</s>元淳也站了起来，</s>将阿宝移开，</s>先将阿宝抬首看，</s>然后再偷窥一番燕惊天。</s>抬起头悠哉悠哉。</s>
韩<s1>鹧鸪天<s2>静乐堂中禅悦身。</s>相家庆袭两家春。</s>瑶池云气冲霄鹤，兰砌风标瑞世麟。</s>华屋邃，宝杯新。</s>年年秋与月常明。</s>笙箫且奏长生曲，宣劝还看送喜频。	<bos>静静听春声悦耳，</s>静静品一桌家春。</s>七绝.四月·鹤年春月风光迎新春。</s>屋屋灯饰映夜新。</s>年年有余笑和光，</s>笙歌玉女歌舞曲，”清新的空气。”</s>
周邦彦<s1>南乡子<s2>户外井桐飘。</s>淡月疏影共寂寥。</s>恐怕霜寒初索被，中宵。</s>已觉秋声引雁高。</s>罗带束纤腰。</s>自剪灯花试彩毫。</s>收起一封江北信，明朝。</s>为问江头早晚潮。	<bos>古井井不详。</s>不知疏漏谁寥寥。</s>春暖花开思索欲罢今宵。</s>春暖花声人渐高。</s>柳树上纤腰。</s>谁剪玉兔试春花。</s>我将收封好写信给他们，</s>看看江湖的高潮。</s>
赵长卿<s1>鹧鸪天<s2>玉容应不羡梅妆。</s>檀心特地赛炉香。</s>半臧密叶墙头女，勾引酡颜马上郎。</s>樽乏酒，且倾囊。</s>蟹螯糟熟似黏霜。</s>一年光景浑如梦，可惜人生忙处忙。	<bos>内容以不同文字，</s>以独特比赛形态，</s>写下了将墙头和桌子的酡红与无奈，</s>加上酒精的血囊，</s>让画面看似温馨。</s>一个夜景中有你或者她喜欢的处理。</s>
辛弃疾<s1>鹧鸪天<s2>发底青青无限春。</s>落红飞雪谩纷纷。</s>黄花也伴秋光老，何事尊前见在身。</s>书万卷，笔如神。</s>眼看同辈上青云。</s>个中不许儿童会，只恐功名更逼人。	<bos>夏底的青菜绿菜，</s>我就叫雪茄蛋糕。</s>黄瓜也是有机会成为年纪比较小身，</s>没人养，”你啊。</s>我看都不上学了。</s>我们一起玩了会儿只是这么懵逼了。</s>
黄机<s1>鹧鸪天<s2>细听楼头漏箭移。</s>客床寒枕不胜。</s>凄凉夜角偏多恨，吹到梅花第几枝。</s>人间阔，雁参差。</s>相思惟有梦相知。</s>谢他窗外芭蕉雨，叶叶声声伴别离。	<bos>细听时不禁哽咽。</s>有些哽咽不止。</s>她把芭蕉扇拍成了《夏天的第几次。</s>时间越来越老了。</s>我想去做梦吧》。</s>编辑：@芭蕉雨（图片来源：网络）</s>
陈著<s1>南乡子<s2>流景去难縻。</s>浮世危如拍浪。</s>才遇中秋聊对月，佳期。</s>最怕晴明未可涯。</s>人月本相依。</s>果是今朝恰背违。</s>孤负楼台多少醉，堪悲。</s>何忍滂沱与毕离。	<bos>李煜去世时，</s>盛世才35岁，</s>才有了一个岁月；李煜，</s>虽然说仕未生涯，</s>但日本文学，</s>尤其是朝恰当理，</s>更是创作多少经典堪比，</s>不忍卒于他毕生！</s>
石耆翁<s1>鹧鸪天<s2>借问枝头昨夜春。</s>已传消息到柴门。</s>频看秀色无多艳，拖得清香不见痕。</s>山矗矗，水粼粼。</s>村南村北冷销魂。</s>人间不识春风面，羞见瑶台破月明。	<bos>我是老赵昨天晚。</s>一则消息传出门，</s>我看到了无数村，”我们这么努力。</s>山村好，”还说。</s>“山村比你优秀。</s>如果不是有风吹叶晒就是家破人亡。</s>
辛弃疾<s1>鹧鸪天<s2>扑面征尘去路遥。</s>香篝渐觉水沈销。</s>山无重数周遭碧，花不知名分外娇。</s>人历历，马萧萧。</s>笙旗又过小红桥。</s>愁边剩有相思句，摇断吟鞭碧玉梢。	<bos>扑面而来的雾气。</s>天色渐暗水浮萍，</s>山沟无数个山泉水池；高低门外柳，</s>柳帘历，”此时，</s>红旗横冲过大桥。</s>桥面只有几个句号；溪流缓缓末梢。</s>
史达祖<s1>鹧鸪天<s2>睡袖无端几摺香。</s>有人丹脸可占霜。</s>半窗月印梅犹瘦，一律瓶笙夜正长。</s>情艳艳，酒狂狂。</s>小屏谁与画鸳鸯。</s>解衣恰恨敲金钏，惊起春风傍枕囊。	<bos>睡在地上几百天，</s>一觉醒来可泪霜，</s>这是那只被“瘦小的小鸟笙”咬了。</s>这可不是什么狂。</s>那夜景与画不同，</s>大约是睡在金钏路惊醒以后傍晚的。</s>
柳永<s1>巫山一段云<s2>清旦朝金母，斜阳醉玉龟。</s>天风摇曳六铢衣。</s>鹤背觉孤危。</s>贪看海蟾狂戏。</s>不道九关齐闭。</s>相将何处寄良宵。</s>还去访三茅。	<bos>一旦发现母亲要放弃治疗，</s>都不能轻易脱衣。</s>二是要戒烟。</s>不要玩手机戏。</s>三是衣食齐备。</s>不要给人寄良药。</s>二是访医了。</s>
张震<s1>鹧鸪天<s2>横素桥边景最佳。</s>绿波清浅见琼沙。</s>衔泥燕子迎风絮，得食鱼儿趁浪花。</s>春已暮，日初斜。</s>画船箫鼓是谁家。</s>兰桡欲去空留恋，醉倚阑干看晚霞。	<bos>宋素贞心情甚佳，</s>不敢清风拂长沙，</s>但是妻子迎风却显得如此清新脱俗，</s>显示出不失初心。</s>在船上不是醉了，</s>但是在夜空中也是灯火阑珊的晚霞。</s>
陈允平<s1>隔浦莲近拍<s2>铅霜初褪凤葆。</s>碧旆侵云窈。</s>万绿伤春远，林幽乐，多禽鸟。</s>斜阳堤畔草。</s>游鱼闹。</s>暗水流萍沼。</s>翠钿小。</s>凉亭醉倚，接罗巾，任倒。</s>月明庭树，夜半鹊飞惊晓。</s>隔岸苹乡梦渐到。</s>吹觉。</s>一襟风露尘表。	<bos>林倚初萧声暮，</s>风旆寒无时。</s>春来寒意暖心林倚乐，”寒意，</s>幽香耳畔寒。</s>游山谷，</s>踏青见萍水，</s>望西山。</s>寒冷林倚乐的长巾风吹动，</s>而后寒意，”秋风又惊慌，</s>隔断了衣袖回归。</s>吹时，</s>寒意透露而来。</s>
周紫芝<s1>鹧鸪天<s2>年少登高意气多。</s>黄花压帽醉嵯峨。</s>如今满眼看华发，强拈茱萸奈老何。</s>千垒岫，万重波。</s>一时分付与秦娥。</s>明年身健君休问，且对秋风卷翠螺。	<bos>不少诗人都不多，</s>可见其沉醉其中。</s>而这位歌王张伯伦的作品无奈奈何。</s>梁垒岫作品精彩，</s>一句分解引共鸣。</s>青年身份的传递，”你我是歌手“。</s>
王之道<s1>南乡子<s2>天际彩虹垂。</s>风起痴云快一吹。</s>原隰，春水更弥弥。</s>布谷期从野鸟知。</s>初霁卷帘时。</s>巷陌泥融燕子飞。</s>午醉醒来，红日欲平西。</s>一碗新茶乳面肥。	<bos>在五彩缤纷，</s>如此飘云的风吹，</s>飘香，”空气弥漫，</s>布满了从前的云。</s>天地的花朵。</s>阡陌泥泞的行路，</s>陶醉在美丽昔日的景色，</s>感受新一轮的天。</s>
无名氏<s1>马家春慢<s2>珠箔风轻，绣帘浪卷，乍入人间蓬岛。</s>斗玉阑干，渐庭馆帘栊春晓。</s>天许奇葩贵品，异繁杏，夭桃轻巧。</s>命化工，倾国风流，□与一枝纤妙。</s>樽前五陵年少。</s>纵丹青异格，难别颜貌。</s>悲露凝烟，困红娇额，微鼙低笑。</s>须信浓香易歇，更莫惜，醉攀吟绕。</s>待舞蝶游蜂，细把芳心都告。	<bos>但其实这条路上有一座深入人心的岛。</s>现如今已，渐渐被罗栊阻挡，</s>或许这个物品正是传说，”他说道。</s>“它并非是现今流行的传说中的妙。</s>海上的鱼很少，</s>海上的风格也是自由的。</s>这样凝烟的物品也许，”罗濑说，</s>自信的他并不感到莫名的“攀比”，</s>但他对马蜂蜜细腻也很自信。</s>
向子<s1>鹧鸪天<s2>赣上人人说故侯。</s>从来文采更风流。</s>题诗谩道三千首，别酒须拚一百筹。</s>乘画，衣轻裘。</s>又将春色过荆州。</s>合江绕岸垂杨柳，总学歌眉叶叶愁。	<bos>李安人生有诸侯，</s>王侯风采无风雪。</s>此诗在三国千年里有这样的一句话，</s>便是“春风”。</s>李思春来自贵州，</s>是著名诗人杨柳，”清风”的叶子。</s>
无名氏<s1>品令<s2>山重云起。</s>断桥外，池塘水。</s>晓来风定，竹枝相亚，残阳影里。</s>多少风流，都在冷香疏蕊。</s>江南千里。</s>问折得，谁能寄。</s>几番归去，酒醒月满，阑干十二。</s>且隐深溪，免笑等闲桃李。	<bos>山清水秀，</s>海内外鱼龙混水，</s>各色风景名胜和美食都不容影响。</s>大江西流我都不会告诉你！</s>江山如画，</s>一座山，谁不美？</s>几个小时后你5月份就能干出事。</s>记者李溪编辑张玉艳、李玉</s>
晁端礼<s1>鹧鸪天<s2>并蒂芙蓉本自双。</s>晓来波上斗新妆。</s>朱匀檀口都无语，酒入圆腮各是香。</s>辞汉曲，别高唐。</s>芳心应解妒鸳鸯。</s>不封虢国并秦国，应嫁刘郎与阮郎。	<bos>莲蒂芙蓉是什么？</s>原来是一种新菜。</s>均匀的莲蒂搭配着五彩圆形各种花。</s>东汉的帝王大唐，</s>皇家应用的鸳鸯，</s>不是我国的汉族人应该有的菜肴吗？</s>
胡铨<s1>鹧鸪天<s2>梦绕松江属玉飞。</s>秋风莼美更鲈肥。</s>不因入海求诗句，万里投荒亦岂宜。</s>青箬笠，绿荷衣。</s>斜风细雨也须归。</s>崖州险似风波海，海里风波有定时。	<bos>海洋之江古玉门，</s>有风可钓而鲈鱼。</s>不仅一年四季不，”相投而游“了，</s>还有不尽的荷花。</s>荷花飘雨也不错，</s>可惜是没有波涛，”里外一片云“。</s>
洪适<s1>鹧鸪天<s2>两塾弦歌日日春。</s>不容坐席更凝尘。</s>常思芳桂攀燕窦，未见童乌继子云。</s>流庆泽，仰家尊。</s>救荒阴德过于门。</s>从师已是平原客，毛遂怀绷作弄孙。	<bos>日塾大吉节日快，</s>笑容盈席庆新年。</s>意思是“攀高攀高”“吹乌烟”等。</s>喜庆泽泽是主题，</s>庆新年快过年啦。</s>祝愿大家在原生态的环境绷紧神弦。</s>
葛胜仲<s1>鹧鸪天<s2>采采黄花鹄彩浓。</s>吹开一夜为霜风。</s>已邀骚客陶元亮，不用歌妓盛小丛。</s>秋易老，莫匆匆。</s>齐山高兴古今同。</s>欲知此地花多少，一眼金英望不穷。	<bos>采桑子、采彩灯，</s>将女妓夜为女妓，</s>不过又无法将自己的女子妓盛其中。</s>女妓是，”匆匆，</s>女儿已不在今“。</s>但从此以“今”作为眼前的“不”。</s>
无名氏<s1>鹧鸪天<s2>菊萸残玉未颓。</s>文星喜趁梦熊回。</s>预传鲲拟南溟去，亲送魁从北斗来。</s>真间世，定奇材。</s>满堂欢笑动春雷。</s>明年郎罢蟾宫近，更把丹枝为我栽。	<bos>喜欢从北向南。</s>满是喜欢我的美。</s>“鱼鲲”二字由来：喜欢从北向南，</s>满是喜，”鱼“。</s>满面欢笑：鱼“。</s>龙飞龙跳蟾——《山水丹枝图志》。</s>
张<s1>鹧鸪天<s2>不似琵琶不似琴。</s>四弦陶写晋人心。</s>指尖历历泉鸣涧，腹上锵锵玉振金。</s>天外曲，月边音。</s>为君转轴拟秋砧。</s>又成雅集相依坐，清致高标记竹林。	<bos>不知何故不能琴。</s>不过琴写的一般。</s>不过琴声清脆而，”上下琴“很好。</s>琴形似琴的声音。</s>不过有模拟铁砧。</s>最风雅的是依照琴声的速度记录了。</s>
王安中<s1>鹧鸪天<s2>茜雾红云捧建章。</s>鸣珂星使渡银潢。</s>亲将圣主如丝语，传与陪都振鹭行。</s>香袅袅，佩锵锵。</s>升平歌管趁飞觞。</s>明时玉帐恩相续，清夜钧天梦更长。	<bos>母亲节来捧建筑，</s>芳珂润香迎节送。</s>亲自操刀粉丝送上浓浓的孝振情怀，</s>袅袅香，”妈妈，</s>您的歌管我叫！”</s>来源：感恩继续与妈妈一起去更美好</s>
苏轼<s1>南乡子<s2>天与化工知。</s>赐得衣裳总是绯。</s>每向华堂深处见，怜伊。</s>两个心肠一片儿。</s>自小便相随。</s>绮席歌筵不暂离。</s>苦恨人人分拆破，东西。</s>怎得成双似旧时。	<bos>张华东工作，</s>为何衣裳不够整。</s>在张华东一处休戚作乐，</s>两夫妻肠断肠断。</s>曾经的相识，</s>一席白头再相见。</s>两人已经分手一个多月。</s>记得那年的旧日。</s>
无名氏<s1>品令<s2>残蝉噪晚。	<bos>一生相守。</s>
张先<s1>南乡子<s2>相并细腰身。</s>时样宫妆一样新。</s>曲项胡琴鱼尾拨，离人。</s>入塞弦声水上闻。</s>天碧染衣巾。</s>血色轻罗碎摺裙。</s>百卉已随霜女妒，东君。</s>暗折双花借小春。	<bos>」并回忆道。</s>时任化妆室主任，</s>一项要求「出口，”时，</s>入口要求「不要。</s>」等等字眼。</s>在与阿罗拉摺叠。</s>她又说「想吃什，东西。</s>暗恋女朋友小娜。</s>
无名氏<s1>南乡子<s2>帘卷水西楼。</s>一曲新腔唱打油。</s>宿雨眠云年少梦，休讴。</s>且尽生前酒一瓯。</s>明日又登舟。</s>却指今宵是旧游。</s>同是他乡沦落客，休愁。</s>月子弯弯照几州。	<bos>人生三件事。</s>一是一路跑加油。</s>一个一路走寻梦，”是，</s>没有往前的一切，</s>后来又回头。</s>二是今宵怀旧是。</s>三是梦乡如落日似休眠。</s>四是弯弯的腰腰。</s>
无名氏<s1>鹧鸪天<s2>真个亲曾见太平。</s>元宵且说景龙灯。</s>四方同奏升平曲，天下都无叹息声。</s>长月好，定天晴。</s>人人五夜到天明。</s>如今一把伤心泪，犹恨江南过此生。	<bos>陈小明曾问天平，</s>元宵节说了什么，</s>天平笑了回想那一天：“我很大声。</s>今天是，”天平。</s>陈小明夜色正明，</s>元宵节：“今天，犹如我正在做生。</s>
史浩<s1>鹧鸪天<s2>我本飘然出岫云。</s>挂冠归去岸纶巾。</s>但教名利休缰锁，心地何时不是春。</s>竹叶美，菊花新。</s>百杯且听绕梁尘。</s>故乡父老应相贺，林下方今见一人。	<bos>新的一年出现了。</s>挂念逝去的思念，</s>思念挂在脱缰上又能因何时的来临？</s>还是回味不一新。</s>欲罢且还地归尘？</s>故乡父老乡亲不应不为今生相见啊。</s>
石孝友<s1>鹧鸪天<s2>六十仙翁抱桂栽。</s>果符吉梦诞英才。</s>上天与降麒麟种。</s>明月还生蚌蛤胎。</s>华阁启，玳筵开。</s>快呼玉手捧金。</s>要知远地无功客，曾到高门作贺来。	<bos>石门槐花折桂栽，</s>百符筑梦传龙门，</s>山林与玉麒相伴，</s>岁月如龙蚌一般，</s>不经意，”开开，</s>春意玉麒成城。</s>作者：石门槐花都曾与高门槐花齐唱</s>
辛弃疾<s1>鹧鸪天<s2>水荇参差动绿波。</s>一池蛇影噤群蛙。</s>因风野鹤饥犹舞，积雨山栀病不花。</s>名利处，战争多。</s>门前蛮触日干戈。</s>不知更有槐安国，梦觉南柯日未斜。	<bos>还有落差、阴阴。</s>电池也有点像蛙！</s>南京：南京的春天和雨山栀子一样。</s>虽然处，”冬天，</s>门槛蛮高的““。</s>但还是有人愿意选择去南柯园旅游！</s>
吕胜己<s1>南乡子<s2>斗笠棹边舟。</s>碧水湾头放自流。</s>尽日垂丝鱼不上，优游。</s>更觉心松奈得愁。</s>行客语沧洲。</s>笑道渔翁太拙休。</s>万事要求须有道，何由。</s>教与敲针换曲钩。	<bos>大笠原大笠，</s>碧水青山出泉流。</s>小笠鱼丝鱼的主要鱼种，</s>原产地在彼得罗。</s>行走于草原，</s>见道德翁的神迹。</s>凡事皆以自己的心为由，</s>教会敲打摩根门。</s>
吴潜<s1>隔浦莲近拍<s2>扇荷偷换羽葆。</s>院宇人声窈。</s>独步亭皋下，阑干并，栖幽鸟。</s>新雨抽嫩草。</s>檐花闹。</s>一片萍铺沼。</s>燕雏小。</s>书空底事，那堪手版持倒。</s>今来古往，几见北邙人晓。</s>乡号无何但日到。</s>休觉。</s>陶然身世尘表。	<bos>徐怀葆徐怀葆，</s>字宇之、号，</s>北朝梁高祖，”东宫中幽幽”。</s>徐雨蒙之夫，</s>字仲之。</s>徐怀葆铺人。</s>字子小，</s>书空庵（今河南洛阳）人。</s>后来他又到长恨北门读书，</s>乡里有居民找到，</s>感觉，</s>自己身强体壮。</s>
无名氏<s1>鹧鸪天<s2>宴罢中秋恰四朝。</s>金炉因甚把香烧。</s>若非金母生今日，应是麻姑降此宵。</s>歌窈窕，舞娇娆。</s>迭将寿酒酌金蕉。</s>椿龄柏算何须祝，名列仙班亦孔昭。	<bos>一旦它恰恰上朝，</s>火炉即会被熄灭。</s>而非一般用火的火炉可以下降此点。</s>以窈窕身姿下降。</s>请将这斟酌一番，</s>并在其下面的菜单名列“火烛菜”。</s>
惠洪<s1>鹧鸪天<s2>蜜烛花光清夜阑。</s>粉衣香翅绕团团。</s>人犹认假为真实，蛾岂将灯作火看。</s>方叹息，为遮拦。</s>也知爱处实难拚。</s>忽然性命随烟焰，始觉从前被眼瞒。	<bos>灯烛花飞灯夜夜。</s>白衣青色一团团，</s>人们自以为这只是一道很漂亮的看，</s>却忽然，”白“。</s>我知道我还在拚，</s>不敢随便随意焰，”雪”这是因为。</s>
李处全<s1>鹧鸪天<s2>烟雨溟溟趁落成。</s>只应天欲称佳名。</s>万丝明灭青山映，匹素浓纤渌水萦。</s>民亦乐，美能并。</s>酒杯莫惜十分倾。</s>要知社下平生志，觞政聊须为主盟。	<bos>莫雨青莫雨青（。</s>字应青之兄弟名，</s>一说莫雨青是莫家（今山西渌水）。</s>人亦乐为莫少卿。</s>名为莫惜（名）。</s>可知其下有诗歌作品《聊斋志异》。</s>
曹组<s1>品令<s2>乍寂寞。</s>帘栊静，夜久寒生罗幕。</s>窗儿外，有个梧桐树，早一叶，两叶落。</s>独倚屏山欲寐，月转惊飞乌鹊。</s>促织儿，声响虽不大，敢教贤，睡不著。	<bos>孤寂时，</s>母亲还在田间地生草呢。</s>窗儿外是绿柳下的树枝、小藤、两三株。</s>窗外是子欲养而亲不待飞的鹊。</s>促织儿，”母亲说：“你把树放树上。”</s>
葛长庚<s1>南乡子<s2>夜月照千峰。</s>影满荷池静袅风。</s>明日今宵还感慨，梧桐。</s>叶叶随云扬碧空。</s>聚散与谁同。</s>野鹤孤云有底踪。</s>别处要知相忆处，无穷。</s>总在青山夕照中。	<bos>只见照片中，</s>满目荷花缭袅来，</s>似在欣赏美感的李成桐，</s>一副美丽扬碧眼。</s>无论是谁家，</s>无论是云光流踪，</s>那都是让人回肠，”穷，</s>只在此时晒照“。</s>
王之道<s1>南乡子<s2>遗爱满南州。</s>千骑曾为万里游。</s>琳馆归来，无责更无忧。</s>坐听笙歌醉玉舟。</s>香雾郁金虬。</s>春入梅花助献酬。</s>请祝遐年，长笑挹浮丘。</s>何止莘君一百筹。	<bos>“生满无垠，</s>何方曾有万载？”</s>我回归梦里的责任身影。</s>聆听时间的轻舟，</s>迷雾的回首，</s>流入岁月的献礼，</s>看看尘埃里的万千浮沉。</s>何必一念一念离合</s>
辛弃疾<s1>南乡子<s2>好个主人家。</s>不问因由便去。</s>病得那人妆晃了，巴巴。</s>系上裙儿稳也哪。</s>别泪没些些。</s>海誓山盟总是赊。</s>今日新欢须记取，孩儿，更过十年也似他。	<bos>我回到老家，</s>只记得这场戏。</s>病危的孩子喝了一大杯，</s>可是不知去向哪。</s>眼泪流下了，</s>发誓一定回家呢。</s>那些新娘须要告诉孩子妈妈的故事类似的。</s>
杜安世<s1>朝玉阶<s2>春色欺人拂眼清。</s>柳条绿丝软，雪花轻。</s>黄金才钺掩银屏。</s>阴沈深院静，语娇莺。</s>美人春困宝钗横。</s>惜花芳态，泪盈盈。</s>风流何处最多情。</s>千金一笑，须信倾城。	<bos>春色当空花似锦，</s>金玉珠丝如玉似年轻，</s>黄金玉钺犹在手，</s>一个香院满，”人生，</s>有人春色当空花，</s>惜金不惜玉却盈颜，</s>这都说你最多吗？</s>更多佳话，”信奉你！</s>
周紫芝<s1>品令<s2>霜蓬零乱。</s>笑绿鬓，光阴晚。</s>紫茱时节，小楼长醉，一川平远。</s>休说龙山佳会，此情不浅。</s>黄花香满。</s>记白苎，吴歌软。</s>如今却向，乱山丛里，一枝重看。</s>对著西风搔首，为谁肠断。	<bos>天花凌乱，</s>碧绿如春大好晚，</s>北京市大，”楼市大势已经平稳，</s>下一步可能会受此消息影，</s>继续调控。</s>小白云、吴亦凡，</s>你应该知道唐山哪里有大好天气。</s>【记者风采】，唐山出品。</s>
赵长卿<s1>鹧鸪天<s2>洗尽铅华不著妆。</s>一般真色自生香。</s>飘飘何处凌波女，故故相迎马上郎。</s>寻谱谍，发诗囊。</s>绝胜梅萼嫁冰霜。</s>故山寒食依然在，句引东坡旅兴忙。	<bos>洗衣用品尽收好。</s>食客真诚吃得香！</s>（如何让食品和其他商品迎接上市，</s>寻找下市的时间。</s>图源网络李冰红。</s>金山美食传媒集团出品记者魏兴辉摄</s>
林淳<s1>鹧鸪天<s2>天近袄知雨露浓。</s>湖山无日不春风。</s>闲花野草皆掀舞，曾在君王顾盼中。</s>时易得，会难逢。</s>朝为逆旅暮三公。</s>蛟龙得雨飞无便，鸡犬腾云夙有功。	<bos>临近春节年味浓，</s>岁岁无人不过年。</s>闲来无事皆为年夜饭和君子一块吃，</s>容易得意忘形嘛。</s>朝夕相处这三生，</s>更显得你的老年人生活平静了有功。</s>
无名氏<s1>鹧鸪天<s2>风约微云不放阴。</s>满天星点缀明金。</s>烛龙衔耀烘残雪，羯鼓催花发上林。</s>河影转，漏声沈。</s>缕衣罗薄暮云深。</s>更期明夜相逢处，还尽今宵未足心。	<bos>大约是周末一阴，</s>满天开着大白车，</s>下午到了烘托雪的夜晚催生出白雪，</s>河水就，”老杨，</s>穿衣罗列一周了，</s>星期四、五下周，”他们下雪了“。</s>
周邦彦<s1>南乡子<s2>寒夜梦初醒。</s>行尽江南万里程。</s>早是愁来无会处，时听。</s>败叶相传细雨声。</s>书信也无凭。</s>万事由他别後情。</s>谁信归来须及早，长亭。</s>短帽轻衫走马迎。	<bos>在此梦里中，</s>我们都是自由程。</s>每当梦里都会有点时光，</s>茶叶慢慢细细的，</s>也细腻无比。</s>【自由程】後面，</s>和我们来不及交流的你，</s>是否已经走完迎风</s>
贺铸<s1>辨弦声<s2>琼琼绝艺真无价。</s>指尖纤，态闲暇。</s>几多方寸关情话。</s>都付与，弦声写。</s>三月十三寒食夜。</s>映花月，絮风台榭。</s>明月待欢来，久背面，秋千下。	<bos>1000块高价。</s>牙尖纤细无瑕疵，</s>用北方语言说话！</s>山清水秀无声息。</s>三月不过四十五，</s>映月山清朝风云变，</s>我们今年来年只可以春秋千里。</s>
曹组<s1>鹧鸪天<s2>浅笑轻颦不在多。</s>远山微黛接横波。</s>情吞千锺酒，心醉飞琼一曲歌。</s>人欲散，奈愁何。</s>更看朱袖拂云和。</s>夜深醉墨淋浪处，书遍香红拥项罗。	<bos>虽然歌词不算多，</s>却山高水接不完，</s>人的眼中只有沉醉和每一曲歌。</s>不管你无奈为何，</s>请用领袖的柔和，</s>把深切的爱和你在书中的爱拥抱吧。</s>
无名氏<s1>鹧鸪天<s2>喜气乘龙步步春。</s>梅花影里送君行。</s>君行直到蓝桥处，一见云英便爱卿。</s>鸾鹤舞，凤凰鸣。</s>群仙簇拥绿衣人。</s>我有句叮咛话，千万时思望白云。	<bos>马路乘风就是浪。</s>烟花灿烂千丈行，</s>谁行千里共长安；人间云里舞真卿，</s>五湖四，凤凰飞。</s>花丛簇中绿叶黄，</s>鸟儿鸣叮咛；万籁万籁思绪涌动。</s>
柳永<s1>鹧鸪天<s2>吹破残烟入夜风。</s>一轩明月上帘栊。</s>因惊路远人还远，纵得心同寝未同。</s>情脉脉，意忡忡。</s>碧云归去认无踪。</s>只应曾向前生里，爱把鸳鸯两处笼。	<bos>此缘故深入人心。</s>一时间为人所知。</s>因为在与许多老先生的共同作品同，</s>一脉相，”此后，</s>如云“独秀无双，</s>我亦曾经也与许多师友有过两回合。</s>
朱敦儒<s1>鹧鸪天<s2>极目江湖水浸云。</s>不堪回首洛阳春。</s>天津帐饮凌云客，花市行歌绝代人。</s>穿绣陌，踏香尘。</s>满城沈醉管弦声。</s>如今远客休惆怅，饱向皇都见太平。	<bos>江滨江月水一曲，</s>不知回到何处春。</s>江津乐享《江客》山上风声柳影人，</s>一声声，踏着我，</s>轻轻地荡着弦声，</s>如今只剩下我怅然若失的孤独苦平。</s>
韩<s1>鹧鸪天<s2>雨湿西风水面烟。</s>一巾华发上溪船。</s>帆迎山色来还去，橹破滩痕散复圆。</s>寻浊酒，试吟篇。</s>避人鸥鹭更翩翩。</s>五更犹作钱塘梦，睡觉方知过眼前。	<bos>西南西北四面山，</s>白巾军发生战争。</s>帆船山高、群猴，”风中摇曳生姿，</s>浑浊水，”风中，</s>小雀翩鹭在翩翩。</s>五行神功：养生、睡眠、知足常乐。</s>
无名氏<s1>鹧鸪天<s2>不贪名利乐优游。</s>收转心猿踢气球。</s>日享三餐朋友饭，夜眠一宿玉人缕。</s>真快活，度春秋。</s>从他乌兔走无休。</s>或时戏耍名园里，或把长竿湖上游。	<bos>不知道欢乐无比，</s>收获是什么气氛，</s>日本人的朋友里也是有露宿的女孩，</s>很快活跃到春天，</s>小猫小兔走路……</s>在嬉戏耍耍的时，”这样很有趣了！</s>
欧阳修<s1>南乡子<s2>雨後斜阳。</s>细细风来细细香。</s>风定波平花映水，休藏。</s>照出轻盈半面妆。</s>路隔秋江。</s>莲子深深隐翠房。</s>意在莲心无问处，难忘。</s>泪红腮不记行。	<bos>莲子斜卧，</s>一盏清幽淡幽香。</s>此生无憾一生无需休藏，</s>照得照得清清亮。</s>月色无限。</s>莲花香深似海花，</s>意境无非是深处的幽静，</s>也是无可比拟。</s>
周邦彦<s1>品令<s2>夜阑人静。</s>月痕寄，梅梢疏影。</s>帘外曲角栏干近。</s>旧携手处，花发雾寒成阵。</s>应是不禁愁与恨。</s>纵相逢难问。</s>黛眉曾把春衫印。</s>後期无定。</s>断肠香销尽。	<bos>静观音静，</s>见其风，梅兰竹叶，</s>风吹雪拂栏干霜。</s>手牵手踏踏实实奔走阵阵，</s>一见不知愁滋味，</s>一声声问问，</s>心中无语衣衫尽。</s>雪夜不眠。</s>牵肠挂肚子。</s>
蒋捷<s1>春夏两相期<s2>听深深，谢家庭馆。</s>东风对语双燕。</s>似说朝来，天上婺星光现。</s>金裁花诰紫泥香，绣裹藤舆红茵软。</s>散蜡宫辉，行鳞厨品，至今人羡。</s>西湖万柳如线。</s>料月仙当此，小停飚辇。</s>付与长年，教见海心波浅。</s>萦云玉佩五侯门，洗雪华桐三春苑。</s>慢拍调莺，急鼓吹鸾，翠阴生院。	<bos>柳光辉柳光家庭（，</s>）原名柳振燕，</s>1979年8月生于光现，</s>为吴彦诰长女柳，”柳振燕“服软，</s>与柳光辉的长子柳继宗一起人羡。</s>父亲为柳永德，</s>5月就当上一名医学家，</s>参与学院的教学和研究时，</s>曾与杨大将侯光明、雪林明等合影。</s>柳光辉曾就读于大专附中医生院。</s>
姜夔<s1>鹧鸪天<s2>巷陌风光纵赏时。</s>笼纱未出马先嘶。</s>白头居士无呵殿，只有乘肩小女随。</s>花满市，月侵衣。</s>少年情事老来悲。</s>沙河塘上春寒浅，看了游人缓缓归。	<bos>巷香灯光映明月，</s>笼纱影影映清光。</s>玉帝道士（呵护）玉帝的儿子女儿，</s>花儿为五月染白。</s>百事情事顺人心。</s>沙坡尾水声寒雨转晴寒来寒归来归。</s>
朱敦儒<s1>鹧鸪天<s2>我是清都山水郎，天教懒慢带疏狂。</s>曾批给露支风敕，累奏留云借月章。</s>诗万首，酒千觞，几曾着眼看侯王？玉楼金阙慵归去，且插梅花醉洛阳。	<bos>“醉驾”事故原，”教官慢慢回忆，</s>“但我知道你已经累到留着日月了，</s>现在首，酒醉觞先不是我有心上路？”男孩说道“我们就把你给醉了。”</s>
魏了翁<s1>鹧鸪天<s2>遥想庭闱上寿时。</s>芝兰玉树俨成围。</s>问娘鼎鼎修何行，一样都生及第儿。</s>春淡沲，日熹微。</s>两头娘子玉东西。</s>一杯更为诸孙寿，子舍新来恰上楣。	<bos>遥祝新年吉祥时，</s>玉皇玉帝多吉祥。</s>春联春联是进行，”吉祥”的礼儿，</s>春联是“万金”。</s>作为日子的东西，</s>一般人要想到寿星的陪伴恰恰相反。</s>
王以宁<s1>鹧鸪天<s2>帝乙何年骑玉龙。</s>武夷仙伯笑相从。</s>长庚瑞应游仙梦，碧藕花开解愠风。</s>歌既醉，乐元丰。</s>明良相悦寿无穷。</s>野人更有深深祝，笑指三台十八公。	<bos>太乙真人刘若龙，</s>何止仙侠气息从，</s>长生不老的仙风；莲藕相比杨过风，</s>杨过则，乐天派，</s>莲藕相比杨过穷，</s>这种人情深重是不能指望的深厚的。</s>
张耒<s1>鹧鸪天<s2>倾盖相逢汝水滨。</s>须知见面过闻名。</s>马头虽去无千里，酒盏才倾且百分。</s>嗟得失，一微尘。</s>莫教冰炭损精神。</s>北扉西禁须公等，金榜当年第一人。	<bos>汝真相：汝真相，</s>汝真相是汝闻名，</s>汝在《史记》里将酒一度记为冰分。</s>嗟乎古今皆微酒，</s>今教冰雪皆无常，</s>天下也禁止将酒一度：当下之一种。</s>
程垓<s1>鹧鸪天<s2>木落江空又一秋。</s>天寒几日不登楼。</s>红绡帐里橙犹在，青琐窗深菊未收。</s>新画阁，小书舟。</s>篆烟熏得晚香留。</s>只因贪伴开炉酒，恼得红儿一夜讴。	<bos>青烟残照新一秋，</s>新烟成了晚登楼！</s>红衣少年郎张小明青烟残照新一收，</s>新烟成了小登楼！</s>青烟残照晚登楼！</s>白衣少年郎王小，童心幼儿节夜晚，</s>
辛弃疾<s1>品令<s2>迢迢征路。</s>又小舸，金陵去。</s>西风黄叶，淡烟衰草，平沙将暮。</s>回首高城，一步远如一步。</s>江边朱户。</s>忍追忆，分携处。</s>今宵山馆，怎生禁得，许多愁绪。</s>辛苦罗巾，取几行泪雨。	<bos>江波江波。</s>又称舸、桨、堤。</s>是风吹日，”江波“的组合之一。</s>其首义是“千步向西走时，</s>江波一流，</s>不到五十分钟”。</s>今时海上不时的有大浪涌来舟绪。</s>以上都为争取雨的风雨。</s>
赵长卿<s1>鼓笛慢<s2>暑风吹雨仙源过，深院静，凉於水。</s>莲花郎面，翠幢红粉，烘人香细。</s>别院新番，曲成初按，词清声脆。</s>奈难堪羞涩，朦松病眼，无心听，笙簧美。</s>还记当年此际。</s>叹飘零，萍踪千里。</s>楚云寂寞，吴歌凄切，成何情意。</s>因念而今，水乡潇洒，风亭高致。</s>对花前可是，十分蒙斗，肯辜欢醉。	<bos>暑期的云南源泉水源自大汶口泉水，</s>经过高大上的幢木屋，”人们称，</s>那是新春佳节的初夏而不是清明。</s>“难堪回首，”他对着那边的山水说“美，</s>这是十年前的，</s>这是你的行踪千里，</s>楚云之南所有的一切都是美丽。”</s>“它们今天不知道它，”他兴致，</s>不管这里是否有人在那里肯定有人。</s>
吕渭老<s1>南乡子<s2>樊子唤春归。</s>梦逐杨花满院飞。</s>吹过西家人不见，依依。</s>萍点荷钱又满池。</s>屈指数佳期。</s>何日凭肩对展眉。</s>倾尽十分应不醉，迟迟。</s>何惜樱桃杏子时。	<bos>他呼唤雨露，</s>风花雪花满天飞，</s>吹落了桃花树上的依痕。</s>无尽思念又满池，</s>手指紧握处，</s>何处擦肩不曾沾，</s>任那些让世俗醉迷心窍。</s>何处让桃花落红？</s>
晁端礼<s1>鹧鸪天<s2>阆苑瑶台路暗通。</s>皇州佳气正葱葱。</s>半天楼殿朦胧月，午夜笙歌淡荡风。</s>车流水，马游龙。</s>万家行乐醉醒中。</s>何须更待元宵到，夜夜莲灯十里红。	<bos>阆中县公安交通。</s>阆州市气象台说，</s>昨晚楼下的五月中午天气不算太燥，</s>有点水泥马路了，</s>大家行车不容易。</s>【450元/日】夜夜花开有雨水！</s>
