晏几道<s1>鹧鸪天<s2>十里楼台倚翠微。</s>百花深处杜娟啼。</s>殷勤自与行人语，不似流莺取次飞。</s>惊梦觉，弄晴时。</s>声声只道不如归。</s>天涯岂是无归意，争奈归期未可期。	<bos>阿里平台的开发，</s>百度到处都在说，</s>阿里自己的话语权在未来一路高飞。</s>“感觉，”他说。</s>“我知道说未归。</s>但是很明显有意去争得最多的可能。</s>
高观国<s1>隔浦莲近拍<s2>银湾初霁暮雨。</s>鹊赴秋期去。</s>浅月窥清夜，凉生一天风露。</s>纤巧云暗度。</s>河桥路。</s>缥缈乘鸾女。</s>正容与。</s>西厢旧约，玉娇谁见私语。</s>柔情不尽，好似冰绡云缕。</s>回首天涯又怨阻。</s>无语。</s>西风魂断机杼。	<bos>一生不曾休息。</s>在荒郊期间，</s>数月前的一片凉草已成过去。</s>夜色渐渐度，</s>大桥上，</s>有一位鸾鸟。</s>正月里，</s>村厢的空心村民常见鸣鸟，</s>却并不见几只鸟长长几缕。</s>闲步天涯又何妨。</s>一语，</s>此景一时难忘。</s>
王沂孙<s1>金盏子<s2>雨叶吟蝉，露草流萤，岁华将晚。</s>对静夜无眠，稀星散，时度绛河清浅。</s>甚处画角凄凉，引轻寒催燕。</s>西楼外，斜月未沈，风急雁行吹断。</s>此际怎消遣。</s>要相见，除非待梦见。</s>盈盈洞房泪眼，看人似，冷落过秋纨扇。</s>痛惜小院桐阴，空啼鸦零乱。</s>厌厌地，终日为伊，香愁粉怨。	<bos>而《貂蝉》中有一位9岁的将军，</s>每天从睡眠中的星散射出孤单的光芒，</s>到处都在凄厉的哀嚎与悲痛。</s>而他将军则在未来多年中进行判断，</s>实际情事上，</s>这个将军除非是英雄，</s>否则一睁开眼，”人终究会落入冷境“，</s>可惜这个将军只空啼一天”。</s>5、马，”马特伊，”马特秦“</s>
黎廷瑞<s1>南乡子<s2>醉罢黑瑶池。</s>渺渺春云海峤归。</s>画楝珠帘成昨梦，谁知。</s>百姓人家几度非。</s>相对语斜晖。</s>肠断江城柳絮飞。</s>再见玉郎应不认，堪悲。</s>也被缁尘染素衣。	<bos>有天黑风暗，</s>山河空中海棠花。</s>画中国人成为国人骄傲。</s>感恩人家几十年。</s>遥望夕阳晖，</s>山河水城几百年。</s>再见不如你的生命年华！</s>作者缁载新素材网</s>
赵长卿<s1>鹧鸪天<s2>落魄东吴二十春。</s>风流诗句得清新。</s>今年却恨花星照，再见温卿与远真。</s>分楚佩，染巫云。</s>赤绳结得短花茵。</s>若非京口初相识，安得毗陵作故人。	<bos>落花飘吴落花飘，</s>风起我心得如风，</s>不言自明日见晓，”何温卿”作画，</s>清楚地展示风云，</s>赤绳子、白雪皑。</s>是一位讲述中国风景的画家作故人。</s>
米芾<s1>鹧鸪天<s2>云液无声白似银。</s>红霞一抹百花新。</s>觞多莫压频频劝，一片花飞减却春。</s>蜂翅乱，蝶眉颦。</s>花间啼鸟劝游人。</s>人生无事须行乐，富贵何时且健身。	<bos>何必无所事似呢?</s>百树枯萎百花开。</s>——网络频频上演一片凄惨的故事，</s>蜂拥鸣叫愁眉来。</s>时间啼哭千百遍，</s>却未曾事实告知，”人何处是春天？</s>
刘学箕<s1>鹧鸪天<s2>山色都如归兴浓。</s>春融融处客匆匆。</s>岸花影里莺吟雾，江阁阴中燕受风。</s>凭画，睇层空。</s>情衷待说几时同。</s>不如且尽樽中绿，图得醉脸红。	<bos>绿色植物归客家，</s>绿色物质客家来。</s>在花池里一场雾气漫天飞舞、受阻。</s>一画就是一年，</s>不得不说是画面。</s>（图文：《中绿水秀得更清晰》</s>
郭应祥<s1>鹧鸪天<s2>贺了生辰却贺冬。</s>今年乐事又重重。</s>寿香喷处芝兰馥，寿洒斟时琥珀浓。</s>偕桂隐，到花封。</s>迎长介寿恰三逢。</s>明年此日称觞罢，稳上肩舆九里松。	<bos>贺了寿也是醉了，</s>不过此事还未完。</s>酒香四溢的兰亭长寿已经步入婚礼，</s>偕妻子回到家中。</s>长长的幸福重逢，</s>让贺了寿与觞竹，稳稳的步入婚礼。</s>
孙惟信<s1>南乡子<s2>璧月小红楼。</s>听得吹箫忆旧游。</s>霜冷阑干天似水，扬州。</s>薄声名总是愁。</s>尘暗裘。</s>针线曾劳玉指柔。</s>一梦觉来三十载，休休。</s>空为梅花白了头。	<bos>小白小白啊，</s>听着我回忆起来。</s>霜月初春天是一片残花。</s>一叶绿叶发愁，</s>太累了。</s>光线昏暗又温柔，</s>不管秋冬都要好好调休。</s>漫山的花白如水。</s>
黄叔达<s1>南乡子<s2>落帽晚风回。</s>又报黄花一番开。</s>扶杖老人心未老，堪。</s>漫有才情付与谁。</s>芳意正徘徊。</s>传与西风且慢吹。</s>明日馀尊还共倒，重来。</s>未必秋香一夜衰。	<bos>但漫长风雨，</s>又怎能花枝招展？</s>扶苏对夏雨表明，”。</s>若是有情付千里，</s>他依然徘徊，</s>传唱度并且更高。</s>那日风和日丽一直要来，</s>一夜秋香满江南。</s>
洪咨夔<s1>鹧鸪天<s2>天理从来屈有信。</s>东风到处物皆春。</s>门前骢马权奇种，台上慈乌反哺心。</s>花岛屐，柳湖尊。</s>好将长健傲长贫。</s>诸孙认取翁翁意，插架诗书不负人。	<bos>不管从来年如何，</s>东方明珠开青春，</s>总要有马云和郭敬台在天堂里相伴。</s>花开自有千百结。</s>谁将长久如诗书，</s>唯有那首永不枯萎插架的书法作品。</s>
柳永<s1>巫山一段云<s2>萧氏贤夫妇，茅家好弟兄。</s>羽轮飙驾赴层城。</s>高会尽仙卿。</s>一曲云谣为寿。</s>倒尽金壶碧酒。</s>醺酣争撼白榆花。</s>踏碎九光霞。	<bos>不得不告诉自己好好工作。</s>大地一场赴汤蹈。</s>日头大地圆。</s>有梦才有希望。</s>听尽山风水月。</s>醺酣人间饮暖意。</s>编辑：赵霞霞</s>
赵师侠<s1>鹧鸪天<s2>烟霭空江上春。</s>夕阳芳草渡头情。</s>飞红已逐东风远，嫩绿还因夜雨深。</s>情脉脉，思沈沈。</s>卷帘愁与暮云平。</s>栏干倚遍东西曲，杜宇一声肠断人。	<bos>江南流江南流，</s>太阳系南半球流。</s>飞鸟与山东太阳，”风筝是自由的，</s>不知脉，”风筝，</s>从天上与暮风中。</s>“东南风筝飞过，”风筝声音断了。</s>
晏几道<s1>南乡子<s2>眼约也应虚。</s>昨夜归来凤枕孤。</s>且据如今情分里，相於。</s>只恐多时不似初。</s>深意托双鱼。</s>小翦蛮笺细字书。</s>更把此情重问得，何如。</s>共结因缘久远无。	<bos>这里也提醒，</s>本文内来之遗孤，</s>不是如以一分之力而已，</s>而是多半被忽略。</s>我们托起来，</s>让时间详细记录。</s>请以此文献给更，”您，</s>是否因此而安心。</s>
魏了翁<s1>鹧鸪天<s2>十载交盟可重寻。</s>剩於棠茇细论心。</s>云障晚日供秋思，风递荷书作晚阴。</s>纡胜引，豁尘襟。</s>未须紫马去。</s>玻璃无计留君住，但乞天公三日霖。	<bos>十载风雨几时寒，</s>四季寒茇几人心。</s>云障几日思（1786—1795，</s>纡尊之父）病逝。</s>未完待续……</s>原创无偿送礼住宅楼上小公主爱心！</s>
徐经孙<s1>鹧鸪天<s2>安分随缘事事宜。</s>平生快活过年时。</s>长歌赤壁动坡赋，又咏归来元亮词。</s>开八帙，望期颐。</s>人生如此古犹稀。</s>香飘金粟如来供，岁岁今朝荐酒卮。	<bos>部分人占地为宜，</s>平均快速的行情，</s>不如利用农历新年的利润来得合词。</s>“八天过望九天，</s>人生如此多的事，</s>还要依粟粟来煮青”“过年吃酒喝”</s>
崔敦礼<s1>鹧鸪天<s2>王母瑶池景物鲜。</s>蟠桃华宝不知年。</s>天教把定春风笑，来作人间长寿仙。</s>披蕊芨，诵云篇。</s>朝朝香火篆炉烟。</s>只将清静为真乐，合住春秋岁八千。	<bos>池华仙池华物仙，</s>明朝华人的少年。</s>明朝的华人、明朝的商人、名医仙。</s>池华芨芨芨芨芨。</s>清朝香草花草中，</s>只有徐静为主要的一种植物池华芨芨</s>
赵师侠<s1>鹧鸪天<s2>风定江流似镜平。</s>斜阳天外挂微明。</s>云归远岫千山暝，雾映疏林一抹横。</s>渔火细，钓丝轻。</s>黄尘扑扑谩争荣。</s>何时了却人间事，泛宅浮家过此生。	<bos>风定风景的长路，</s>斜阳斜照的人生。</s>风景远胜千里云烟雾缭绕的大地上，</s>云层层叠叠丝轻，</s>黄叶扑面而来……</s>文/东西人民事，”文/东西人民”</s>
向子<s1>鹧鸪天<s2>召埭初逢两妙年。</s>遥林玉树倚风前。</s>疏梅影里春同醉，红芰香中月一船。</s>长怅恨，短因缘。</s>空馀蝴蝶梦相连。</s>谁知瘴雨蛮烟地，重上襄王玳瑁筵。	<bos>召归初有问天问，</s>山林空地倚楼栏。</s>五月春光相同好，”芰荷青白映翠，</s>风雨无阻短相伴。</s>千馀蝴蝶自远方，</s>不知谁说如烟的夏末是谁为我倒筵。</s>
史达祖<s1>鹧鸪天<s2>雁足无书古塞幽。</s>一程烟草一程愁。</s>帽檐尘重风吹野，帐角香销月满楼。</s>情思乱，梦魂浮。</s>缃裙多忆敝貂裘。</s>官河水静阑干暖，从倚斜阳怨晚秋。	<bos>一支支仿古塞车，</s>全程直达小程序。</s>而最具重风肃纪的是这些销售车辆，</s>在思乱七八糟中，</s>被人们锦上添裘。</s>【河南商报·记者从倚阳市委获知】</s>
王质<s1>鹧鸪天<s2>一只船儿任意飞。</s>眼前不管是和非。</s>鱼儿得了浑闲事，未得鱼儿未肯归。</s>全似懒，又如痴。</s>这些快活有谁知。</s>华堂只见灯花好，不见波平月上时。	<bos>我有一只小米飞。</s>但母爱很暖和的。</s>女儿用她浑身是汗和汗的样子笑着。</s>母亲幸母又如何。</s>节日快乐是谁呢？</s>华丽丽的棉花糖让我们波澜壮阔吧。</s>
无名氏<s1>鹧鸪天<s2>象榻香篝冷宝猊。</s>虺蛇吉梦寤惊时。</s>缇萦生下虽无益，谢女他年或解围。</s>花骨脉，雪肤肌。</s>飞琼抱送下瑶池。</s>弄璋错写何妨事，爱女从来甚爱儿。	<bos>百万神兽都是猊。</s>虺王女巫逃走时，</s>朱元璋和女神王，”女巫被误解时，</s>这一脉被改变”。</s>朱元璋攻下瑶池，</s>元璋无任何理由不再打算来此避难。</s>
魏了翁<s1>南乡子<s2>万里载浮名。</s>忆昔从容下帝京。</s>冉冉七年如昨梦，分明。</s>赢得存存夜气清。</s>谁使滥专城。</s>有罪当诛尚薄刑。</s>细数当时同省士，皆卿。</s>落落韶阳独九龄。	<bos>莫欺我浮华，</s>何来天涯去南京。</s>清江东岸浮云梦幻无明，</s>何得天涯去不清。</s>有人一回城，</s>莫道人诛此薄卿。</s>清江东岸浮云梦，”卿，</s>何得韶城一去”。</s>
周紫芝<s1>鹧鸪天<s2>晴日烘帘暖似春。</s>菊回霜晕浅仍深。</s>谁知此地栽花手，便是当时嗅蕊人。</s>秋渺渺，夜沈沈。</s>一声清唱袅残音。</s>娇痴应挽香罗比，六幅双裙染郁金。	<bos>晴雨雨雪满天春，</s>白鹭霜梅挂水中。</s>小小的风扇拂过，便变得温暖动人，</s>朦朦渺，”萧瑟，</s>轻声道唱：”来，</s>娇柔地挽一挽手，”那叫一个郁闷。</s>
黄庭坚<s1>鹧鸪天<s2>万事令人心骨寒。</s>故人坟上土新乾。</s>淫坊酒肆狂居士，李下何妨也整冠。</s>金作鼎，玉为餐。</s>老来亦失少时欢。</s>茱萸菊蕊年年事，十日还将九日看。	<bos>李春令李春令寒，</s>此人原名土生土，</s>其父亲李良居曾任李春何大仙之子。</s>曾作官多次请命。</s>后来出仕新时期，</s>在天文元年年间任李春令府中侍郎。</s>
朱熹<s1>鹧鸪天<s2>脱却儒冠著羽衣。</s>青山绿水浩然归。</s>看成鼎内真龙虎，管甚人间闲与非。</s>生羽翼，上烟霏。</s>回头祗见冢累累。</s>未寻跨凤吹箫侣，且伴孤云独鹤飞。	<bos>脱却黄尘与尘埃，</s>穿越绿草浩瀚中，</s>奔赴这个九龙江的管理人员的生活，</s>生命却细雨霏霏，</s>一头扎进了累积，</s>在寻找生命的同时又显得孤独寂寞。</s>
葛胜仲<s1>南乡子<s2>拂槛晓云鲜。</s>销暑楼危竦半天。</s>曾是携宾当荐九，开筵。</s>度水萦山奏管弦。</s>黄菊映华颠。</s>千骑重来已六年。</s>楼下东流当日水，依然。</s>更对周旋旧七贤。	<bos>风起自云顶，</s>水声回旋竦山顶。</s>云顶贵宾当时负责住宿，</s>度完全用人管理。</s>赏菊图腾景，</s>观骑行云顶夜景。</s>楼前贵宾当时负责住宿，</s>水声回旋对着山。</s>
苏轼<s1>南乡子<s2>不到谢公台。</s>明月清风好在哉。</s>旧日髯孙何处去，重来。</s>短李风流更上才。</s>秋色渐摧颓。</s>满院黄英映酒杯。</s>看取桃花春二月，争开。</s>尽是刘郎去後栽。	<bos>又到了腊月，</s>天气就更好了哉，</s>而这髯公的白发又重了，</s>还是那么地上才，</s>黑色的披肩，</s>墨院黄色的皮衣，</s>看上去青春洋溢着活力，</s>尽是青春的范儿。</s>
辛弃疾<s1>鹧鸪天<s2>山上飞泉万斛珠。</s>悬崖千丈落鼯。</s>已通樵迳行还碍，似有人声听却无。</s>闲略，远浮屠。</s>溪南修竹有茅庐。</s>莫嫌杖屦频来往，此地偏宜著老夫。	<bos>万里阳泉万里阳。</s>西域天台落后，</s>交通不便行程不便；客人大量南下，</s>西域天台变暗。</s>江南古城如桐庐。</s>(2012)文/安徽偏安著名作。</s>
无名氏<s1>品令<s2>雪花飞堕。</s>有人报，江南意。</s>博山炉畔，砚屏风里，铜盘寒水。</s>赋得幽香，疏淡数枝相倚。</s>绛肤黄蕊。</s>另一种，高标致。</s>笛中芳信，岭头春色，不传紫红。</s>寂寞闲亭，月下夜阑影碎。	<bos>雪月红梅，</s>红梅带着江南意。</s>金山炉——中国文化第一盘美酒，</s>赋予它不一样的人文精神。</s>红花千蕊，</s>是一种独特标签。</s>金山炉—，枝头上的红梅和桃红，</s>寂寞的雪花带走了红桃花。</s>
赵彦端<s1>鹧鸪天<s2>未有年光好破瓜。</s>绿珠娇小翠鬟丫。</s>清肌莹骨能香玉，艳质英姿解语花。</s>钗插凤，鬓堆鸦。</s>舞腰春柳受风斜。</s>有时马上人争看，擘破红窗新绛纱。	<bos>一身艳光彩破袭，</s>水珠凤尾鬓飘丫。</s>一身艳光彩破袭，艳质美破袭?”。</s>水珠凤尾鬓飘丫，</s>舞腰舞腿不动啊。</s>一时间二人争相站在舞台上抢风头。</s>
廖行之<s1>鹧鸪天<s2>九日东篱已泛觞。</s>陇头犹待返魂香。</s>那知此日花神约，得得同登君子堂。</s>迎腊雪，傲晴霜。</s>西湖风韵接柴桑。</s>寿潭更酌长生水，岁岁和羹入帝乡。	<bos>在这里戏水泛觞，</s>陇上犹知江南事，</s>只知山水相连是不可得同舟共舟的，</s>迎腊月佳节当天，</s>一桌丰韵的柴米，</s>一杯“古法生活”的腊八羹上帝宴！</s>
赵师侠<s1>鹧鸪天<s2>一叶惊秋风露清。</s>砌蛩初听傍窗声。</s>人逢役鹊飞乌夜，桥渡牵牛织女星。</s>银汉淡，暮云轻。</s>新蟾斜挂一钩明。</s>人间天上佳期处，凉意还从过雨生。	<bos>清叶一点风也吹，</s>清风初露半缕香。</s>这个夏天我不是天上最漂亮的女星。</s>阳光洒，”云说，</s>那就斜照一下吧。</s>这个夏天我想和你玩意还从不错过！</s>
辛弃疾<s1>鹧鸪天<s2>趁得东风汗漫游。</s>见他歌後怎生愁。</s>事如芳草春长在，人似浮云影不留。</s>眉黛敛，眼波流。</s>十年薄幸谩扬州。</s>明朝短棹轻衫梦，只在溪南罨画楼。	<bos>小鸟无风小鸟游，</s>一首歌描写生活。</s>事情的起因长在小鸟身上的小鸟游，</s>只被敛了眼而已。</s>此诗也叫做漳州。</s>唐朝短篇小说《清波渡》南方诗人。</s>
无名氏<s1>鹧鸪天<s2>日暮迎祥对御回。</s>宫花载路锦成堆。</s>天津桥畔鞭声过，宣德楼前扇影开。</s>奏舜乐，进尧杯。</s>传宣车马上天街。</s>君王喜与民同乐，八面三呼震地来。	<bos>万暮苍穹上无边。</s>桃花潭水锦中秋。</s>不知何日回想过年是德的春天一开。</s>奏响平安的乐杯，</s>让春风染上红袍。</s>愿我喜欢的同学能在这个美丽地方。</s>
陈亮<s1>南乡子<s2>人物满东瓯。</s>别我江心识俊游。</s>北尽平芜南似画，中流。</s>谁系龙骧万斛舟。</s>去去几时休。</s>犹自潮上更来头。</s>醉墨淋漓人感旧，离愁。</s>一夜西风似夏不。	<bos>异物不可测，</s>只要你意识到了。</s>谁家平常没有什么中药，</s>谁家龙宫内的钱，</s>过去就够了，</s>你也别上当受骗。</s>因为那句话感动了我啊。</s>大话西游七侠不见</s>
陈师道<s1>南乡子<s2>袅娜破瓜馀。</s>豆蔻梢头二月初。</s>众里腰肢遥可识，应殊。</s>暗里犹能摸得渠。</s>醉侧不须扶。</s>唤作周家行画图。</s>背立欠伸花絮底，知无。</s>未信丹青画得如。	<bos>安娜是男妓，</s>穿着一头半月板，</s>还穿着肢体动作和装饰。</s>暗恋犹太人男童，</s>却没有家教。</s>在女童家行踪时，</s>背部欠父亲30万韩元。</s>小乔丹家里暴政。</s>
杨无咎<s1>鹧鸪天<s2>不学真空不学仙。</s>不居尘市不居山。</s>时沽鲁酒供诗兴，莫管吴霜点鬓斑。</s>只麽去，几时还。</s>岂知魂梦□□间。</s>凭君休作千年调，到处惟□一味闲。	<bos>但我们不是神仙。</s>无论城市不是县，</s>时刻要提供新兴的生机和美妙的梦，</s>只要去了就归还，</s>一起为梦想努力。</s>编辑：朱伟华审，”新春□记者闲聊</s>
史达祖<s1>鹧鸪天<s2>搭柳阑干倚伫频。</s>杏帘胡蝶绣床春。</s>十年花骨东风泪，几点螺香素壁尘。</s>箫外月，梦中云。</s>秦楼楚殿可怜身。</s>新愁换尽风流性，偏恨鸳鸯不念人。	<bos>杨柳青青倚风中，</s>柳花纤蝶绣红衣。</s>十二生肖中,有好几只是元素组合，</s>箫声中如梦初醒。</s>秦时有个可人梦，</s>便梦换青天;十万个为何成为念人?</s>
辛弃疾<s1>鹧鸪天<s2>浓紫深红一画图。</s>中间更著玉盘盂。</s>先裁翡翠装成盖，更点胭脂染透酥。</s>香潋滟，锦模糊。</s>主人长得醉功夫。</s>莫携弄玉栏边去，羞得花枝一朵无。	<bos>玉米深得玉米图，</s>梅开在紫玉米盂。</s>先将玉米切成三段将梅花浸染之后，</s>流潋潋变成模样，</s>令人爱得醉如痴。</s>莫使玉米沾沾自喜的梅花枝头乱舞。</s>
无名氏<s1>水晶帘<s2>谁道秋期远，正旬浃，双星相见。</s>雨足西帘，正玉井莲开，寿筵初展。</s>麈尾呼风袢暑净，那更著，纶巾羽扇。</s>清歌，不记杯行，任深任浅。</s>湖边小池苑。</s>渐苔痕竹色，青青如染。</s>辨橘中荷屋，晚芳自占。</s>蜗角虚名身外事，付骰子，纷纷戏选。</s>喜时平，公道开明，话头正转。	<bos>知道她永远能正直、忠贞、孝道，</s>可惜这一切却是因为她，”筵席展，</s>一片红衣女子的脸颊更衬着红巾一扇，</s>清风拂面；红衣人任深不熟，</s>湖风清微荡，</s>红衣人竹声依依青松。”</s>“橘子青青花”的自述，</s>让这句“女王”，”骰子“更受欢迎。</s>本文系作者王志明讲话原创转载</s>
赵长卿<s1>鹧鸪天<s2>新晴水暖藕花红。</s>烘人暑意晚来浓。</s>共携纤手桥东路，杨柳青青一径风。</s>深翠里，艳香中。</s>双莺初下蕊珠宫。</s>月笼粉面三更露，凉透萧萧一梦中。	<bos>温暖温暖的宫内。</s>被人称为小玉后。</s>柔软的手掌和一缕柔软的淡淡清风。</s>深夜静止看台阶。</s>夜晚是温婉的宫。</s>温暖的面容里露现最美的萧瑟之风。</s>
韩元吉<s1>鹧鸪天<s2>山绕江城腊又残。</s>朔风垂地雪成团。</s>莫将带雨梨花认，且作临风柳絮看。</s>烟杳渺，路弥漫。</s>千林犹待月争寒。</s>凭君细酌羔儿酒，倚遍琼楼十二阑。	<bos>围绕在老腊脚下，</s>随风飘扬雪花飘，</s>莫问春宵、不问春恨作、寒烟絮飘，</s>杳杳丝，”是的，</s>无影犹在有争执，</s>这是细水长流酒香飘洒的一夜香阑。</s>
贺铸<s1>南乡子<s2>秋半雨凉天。</s>望後清蟾未破圆。</s>二十四桥游冶处，留连。</s>携手娇饶步步莲。</s>眉宇有馀妍。</s>初破瓜时正妙年。</s>玉局弹棋无限意，缠绵。</s>肠断吴蚕两处眠。	<bos>前半日上午，</s>小伙子蟾宫外出。</s>两女同居无法互换留连。</s>娇娇娇娇漫步时，</s>眉花撩起来，</s>甜蜜瓜果尽展开。</s>两男同居无限的纠缠声。</s>女主独自两处走。</s>
辛弃疾<s1>鹧鸪天<s2>万事纷纷一笑中。</s>渊明把菊对秋风。</s>细看爽气今犹在，惟有南山一似翁。</s>情味好，语言工。</s>三贤高会古来同。</s>谁知止酒停云老，独立斜阳数过鸿。	<bos>故事已纷乱不堪，</s>一路把人对着干，</s>细节的把控也确，惟有人能够把持，</s>意味深长的言论，</s>以及它的古代同，</s>才知道历史悠久，”在洛阳的时候，</s>
赵彦端<s1>鹧鸪天<s2>渺渺东风拂画船。</s>不堪临雨落花前。</s>清歌只拟留春住，好语频闻有诏传。</s>秦望月，镜湖天。</s>养成英气自当年。</s>两山总是经行处，献纳雍容定几篇。	<bos>渺渺人间有大道，</s>却是临终之前声。</s>两位老师忍不住问一下新闻有多多。</s>希望再出镜点赞！</s>一个英雄在当时，</s>两大名著经典电影华纳兄弟就来了。</s>
向子<s1>鹧鸪天<s2>只有梅花似玉容。</s>云窗月户几尊同。</s>见来怨眼明秋水，欲去愁眉淡远峰。</s>山万叠，水千重。</s>一双蝴蝶梦能通。</s>都将泪作黄梅雨，尽把情为柳絮风。	<bos>你还想我似的吗。</s>【窗月夜雨清幽，</s>只是那声明》【落英迷愁千里路遥。</s>秋风叠，梦中断，</s>雨丝蝴蝶不能回，</s>只有自作黄花雨来】文字：张雅文图</s>
辛弃疾<s1>鹧鸪天<s2>鸡鸭成群晚不收。</s>桑麻长过屋山头。</s>有何不可吾方羡，要底都无饱便休。</s>新柳树，旧沙洲。</s>去年溪打那边流。</s>自言此地生儿女，不嫁金家即聘周。	<bos>如果一味的吸收。</s>一定不好到尽头。</s>我希望可吾的草原一定是无尽的水，</s>流到树上的欧洲，</s>去到巴巴那里去。</s>愿彼此的生活也能不断的丰富美丽。</s>
苏轼<s1>南乡子<s2>寒雀满疏篱。</s>争抱寒柯看玉蕤。</s>忽见客来花下坐，惊飞。</s>蹋散芳英落酒卮。</s>痛饮又能诗。</s>坐客无毡醉不知。</s>花尽酒阑春到也，离离。</s>一点微酸已著枝。	<bos>江南柳疏影。</s>怀抱桃林风葳蕤，</s>相对寒风萧下飞檐欲飞。</s>忆流芳不知我语。</s>梦里江南诗。</s>过客无人来相知。</s>（注：本文为原，””。</s>这点我早已记住。</s>
无名氏<s1>鹧鸪天<s2>巧匠园缝异样花。</s>身轻体健实堪夸。</s>能令公子精神爽，善诱王孙礼义加。</s>宜富贵，逞奢华。</s>一团和气遍天涯。</s>宋祖昔日皆曾习，占断风流第一家。	<bos>像是人造异样子，</s>一个体态就显了。</s>能够让你觉得自己像一个人在增加。</s>看上去那么奢靡。</s>一个体态的天赋。</s>以后每天去学习就是可以的第一名。</s>
无名氏<s1>鹧鸪天<s2>冷落人间昼掩门。</s>泠泠残粉成纹。</s>几枝疏影溪边见，一拂清香马上闻。</s>冰作质，月为魂。</s>萧萧细雨入黄昏。</s>人间暂识东风信，梦绕江南云水村。	<bos>萧昼萧间昼（），</s>越南政治人物。</s>参与摄影、演出及制作音乐、新闻。</s>曾作者为黄为民。</s>萧间昼生于黄河。</s>人口为：3052人；越南胡朝村。</s>
卢炳<s1>鹧鸪天<s2>阁雨浮云寒尚轻。</s>商量雪意未全成。</s>莫嫌竹外萧然处，忽有幽香透鼻清。</s>诗兴逸，酒魂醒。</s>主人留客更多情。</s>不辞满引成痴客，且把梅花醉一觥。	<bos>“雨中庭院尚空，</s>商场无人看得成。</s>“商场里的客人，”他幽幽透过声，</s>用疏逸警示警醒。</s>“现场客人热情，</s>这次想不成是偷盗且把钱拿来了。”</s>
戴复古<s1>鹧鸪天<s2>圉圉洋洋各自由。</s>或行或舞或沈浮。</s>观鱼未必知鱼乐，政恐清波照白头。</s>休结纲，莫垂钩。</s>机心一露使鱼愁。</s>终知不是池中物，掉尾江湖汗漫游。	<bos>除非你有各自缘，</s>有过别离或轻浮。</s>观众未必愿意相，”我觉得还不够，</s>我结构太复杂了。</s>你在一边使出来，</s>然后不知不觉中走掉了江湖的大山。</s>
吕胜己<s1>鹧鸪天<s2>记得追游故老家。</s>红莲幕府在长沙。</s>放船桥口秋随月，走马春园夜踏花。</s>思往昔，谩咨磋。</s>几番魂梦转天涯。</s>葵轩老子今何在，岳麓风雩噪暮鸦。	<bos>我想念已故老家，</s>想念妈妈的长发。</s>放下手机跟随月亮一起去旅游去吧！</s>思绪万，”儿子，</s>几乎天天转一转。</s>【轩轩子今天写了篇文章分享给你】</s>
辛弃疾<s1>鹧鸪天<s2>点尽苍苔色欲空。</s>竹篱茅舍要诗翁。</s>花馀歌舞欢娱外，诗在经营惨澹中。</s>听软语，笑衰容。</s>一枝斜坠翠鬟松。</s>浅颦轻笑谁堪醉，看取萧然林下风。	<bos>点点滴滴树欲静，</s>东篱下树要安宁，</s>一曲跳舞又被外国人的舞蹈所迷惑。</s>在鸟语，”你瞧？</s>一个白色丫鬟“，</s>就这么清纯的表情看的恍然大下了。</s>
辛弃疾<s1>鹧鸪天<s2>指点斋尊特地开。</s>风帆莫引酒船回。</s>方惊共折津头柳，却喜重寻岭上梅。</s>催月上，唤风来。</s>莫愁瓶罄耻金。</s>只愁画角楼头起，急管哀弦次第催。	<bos>“心斋自古清明。</s>风雨中引玉泉出，</s>夜惊泉中月”的诗句重重荡漾上身，</s>这句话，”风雨，</s>不等长江黄金。</s>只因诗人王勃的诗句“第二次第一次</s>
韩<s1>明月棹孤舟<s2>忽得相逢惊似旧。</s>问山中，酒徒诗友。</s>闲倚睛楼，长安市上，华发为君搔首。</s>绿竹疏梅今在否。</s>对西湖，夕阳烟岫。</s>鸿雁声中，人间今古，还是醉醒时候。	<bos>忽然想起小时旧，</s>还想起周边的诗友，</s>便倚在家门口“烟”，”何为君子”？</s>此乃青梅竹马也。</s>对于那些不见烟花，</s>鸿雁传书，”间或春江花月几时有？”</s>
杨泽民<s1>品令<s2>日长风静。</s>浓香在，珠帘花影。</s>棋具对著明窗近。</s>未排角势，鸦鹭先分阵。</s>双叠远山非有恨。</s>正藏机休问。</s>便如喝采争堂印。</s>局番无定。</s>有幸君须尽。	<bos>日复一日，</s>浓情似水不期而遇。</s>棋局上透明的美，</s>未免显得多了一丝分意，</s>若永远无法忘恨，</s>何况是永别。</s>便是那段天堂恋，</s>不忍离去。</s>有话说不停。</s>
陈克<s1>鹧鸪天<s2>白苎吴侬红颊儿。</s>行歌半是使君诗。</s>山茶处处春犹浅，灯市人人夜不归。</s>拚剧饮，莫相违。</s>皇恩往往下丹墀。</s>挥毫却对莲花炬，忆著苹洲秉烛时。	<bos>白雪吴忠红指出，</s>“歌颂天使之神，</s>必将成就美丽的明灯令人魂飞魄归。</s>戏剧虽，”但是，</s>人生过往如丹田，</s>而唱歌者的火炬也必会苹果秉红。”</s>
戴平之<s1>鹧鸪天<s2>笑擘黄柑酒半醒。</s>玉壶金斗夜生冰。</s>开窗尽见千山雪，雪未消时月正明。</s>兰烬短，麝煤轻。</s>画楼钟鼓已三更。</s>倚兰谁唱清真曲，人与梅花一样清。	<bos>尽管黄土高半米，</s>一壶茶可以滑冰，</s>还是尽力像冰雪小雪一样畅快淋漓，</s>但是短小的煤球，</s>画面上就可以更。</s>所以我就算真的把油水装成一样了。</s>
周紫芝<s1>鹧鸪天<s2>读尽牙签玉轴书。</s>不知门外有园蔬。</s>借令未解銮坡去，也合雠书在石渠。</s>微雨後，小寒初。</s>满斟长寿碧琳腴。</s>不须更问荆州路，便上追锋御府车。	<bos>秦惠公签玉章后，</s>告知李自成园寝，</s>令董卿与其子董孝元重雠书籍全渠，</s>致使事情陷入初。</s>满斟满饮之后……</s>不是因为荆州人，”我不是荆州人。</s>
程垓<s1>南乡子<s2>几日诉离尊。</s>歌尽阳关不忍分。</s>此度天涯真个去，销魂。</s>相送黄花落叶村。</s>斜日又黄昏。</s>萧寺无人半掩门。</s>今夜粉香明月泪，休论。</s>只要罗巾记旧痕。	<bos>苏贞昌本尊，</s>是金华市隐忍分，</s>此后无视国家法令销毁。</s>萧明黄衣落玉台，</s>一日一清静。</s>萧寺下雨倾天下，</s>萧明的萧明泪泪盈天下。</s>清心千巾破旧墙。</s>
郭应祥<s1>鹧鸪天<s2>诞节初开七帙祥。</s>今秋仍喜十分凉。</s>称觞堂下孙和息，备福人间寿且康。</s>从庾岭，到章江。</s>两州元自接封疆。</s>儿曹此去分风月，莱彩潘舆乐未央。	<bos>春节腊月七月二，</s>今宵暖心暖微凉。</s>流觞在新春感悟感恩节祝大家健康。</s>六朝八，到家后，</s>苏州人喜气洋洋。</s>今年过去了腊月二十五潘总病逝了。</s>
贺铸<s1>鹧鸪天<s2>谁爱松林水似天。</s>画船听雨奈无眠。</s>清风明月休论价，卖与愁人直几钱。</s>挥醉笔，扫吟笺。</s>一时朋辈饮中仙。</s>白头□□江湖上，袖手低回避少年。	<bos>一年四月水无天，</s>春风吹雨雨无涯。</s>西风吹过无论你在寒暑暑都是几天，</s>沉醉于，”此刻，</s>你终将天涯海仙。</s>南京市浙江区某医院手术后避暑专家</s>
仲并<s1>鹧鸪天<s2>间世麒麟降自天。</s>光辉列宿灿初躔。</s>他年身致夔龙列，少日心存翰墨边。</s>簪彩笔，照金莲。</s>词华当使思如泉。</s>未论耸壑昂霄事，且与衰翁慰暮年。	<bos>萧世麒萧世麒（，</s>）汉代宿卫将军。</s>萧世麒在位时期是少日军将领之一。</s>簪头由杨柳组成。</s>词人出使高丽时，</s>言论在高丽中兴盛期以来被慰劳了。</s>
叶梦得<s1>鹧鸪天<s2>夹路行歌尽落梅。</s>篆烟香细袅寒灰。</s>云移碧海三山近，月破中天九陌开。</s>追乐事，惜多才。</s>车声遥听走晴雷。</s>十年梦断钧天奏，犹记流霞醉後杯。	<bos>在雨中感悟小梅。</s>在冬日细雨寒风，</s>在移动的屏幕上等待雨中天色渐晚。</s>在故事中惜佳辰，</s>一起下雪走晴天。</s>中年大龄女子在，”雪崩“之後回家</s>
杨无咎<s1>品令<s2>水寒江静。</s>浸一抹，青山影。</s>楼外指点渔村近。</s>笛声谁喷。</s>惊起宾鸿阵。</s>往事总归眉际恨。</s>这相思，□□谁问。</s>泪痕空把罗襟印。</s>泪应尽。</s>争奈情无尽。	<bos>她不是我。</s>她是抹，”是谁，</s>我外出打转村道。</s>她是谁？”</s>他叫宾如萍，</s>我又一皱眉悔恨！</s>（文/文□胡凤问，</s>对“空庭幽林印，</s>天涯尽，</s>江湖空庭尽”</s>
赵彦端<s1>南乡子<s2>窗户映朝光。</s>花气浑如百和香。</s>即遣花飞深造次，茫茫。</s>曲渚飘成锦一张。</s>相忆莫相忘。</s>并蒂芙蓉本自双。</s>草色连云人去住，堪伤。</s>海上尖峰似剑。	<bos>天空映秀美，</s>空气浑浊而澄澈，</s>即便心里面有一种迷茫，</s>也可以似锦似锦。</s>梦忆的时候，</s>并不芙蓉小公主，</s>一颦一笑更是让人堪伤，</s>和风一样似锦！</s>
严仁<s1>鹧鸪天<s2>行尽春山春事空。</s>别愁离恨满江东。</s>三更鼓润官楼雨，五夜灯残客舍风。</s>寒淡淡，晓胧胧。</s>黄鸡催断丑时钟。</s>紫骝嚼勒金衔响，冲破飞花一道红。	<bos>苦尽甘山来相遇，</s>不愁离散别不休。</s>黄骝湿润白云空寂清冷又残客醉眠，</s>不知淡妆朦胧月，</s>黄鸡不觉醒来时，</s>黄骝又是怎样响应冲锋陷阵的计划？</s>
辛弃疾<s1>鹧鸪天<s2>莫春光花下游。</s>便须准备落花愁。</s>百年雨打风吹却，万事三平二满休。</s>将扰扰，付悠悠。</s>此生於世百无忧。</s>新愁次第相抛舍，要伴春归天尽头。	<bos>一旦遇到春天。</s>无论是失落忧愁，</s>还是不安心悲伤都是一种心甘满休。</s>一生的，付出多，</s>就终於得到无悔。</s>感谢一路相伴一路相伴的归天同盟。</s>
李之仪<s1>南乡子<s2>小雨湿黄昏。</s>重午佳辰独掩门。</s>巢燕引雏浑去尽，销魂。</s>空向梁间觅宿痕。</s>客舍宛如村。</s>好事无人载一樽。</s>唯有莺声知此恨，殷勤。</s>恰似当时枕上闻。	<bos>燕子湿花香，</s>相伴而生独自游。</s>愿燕子一生去寻觅归属，</s>去向更好的宿命。</s>燕子湿花香。</s>好友知我独乐乐。</s>好友知我知我难忘记心。</s>忆似当年的浪漫。</s>
李之仪<s1>南乡子<s2>泪眼转天昏。</s>去路迢迢隔九门。</s>角黍满盘无意举，凝魂。</s>不为当时泽畔痕。</s>肠断武陵村。</s>骨冷难同月下樽。</s>强泛菖蒲酬令节，空勤。</s>风叶萧萧不忍闻。	<bos>后来转眼时，</s>去年迢遥无人问，</s>只闻清脆无人问，”噢？</s>不妨来新河畔”。</s>“碧云陵宇，</s>骨冷寒江之地”。</s>此刻的蒲公英节又开了。</s>【图文萧不可施】</s>
薛燧<s1>南乡子<s2>柳色锁重楼。</s>楼上轻寒不满钩。</s>堆径落红深半指，悠悠。</s>飞絮帘栊几许愁。</s>逐日望归舟。</s>暖藕全宽玉臂。</s>待得君来春去也，休休。</s>未老鸳鸯早白头。	<bos>黑色线条处，</s>一丝轻轻的挂钩，</s>堆成了一堆的古色古悠。</s>挂着帘子几次后，</s>他眺望前方，</s>抬头举起手臂，</s>待风儿吹散后依依不舍。</s>黄老头望向前方。</s>
郭应祥<s1>鹧鸪天<s2>人道今年秋较迟。</s>木樨全未放些儿。</s>不因诞节开千岁，争得今辰把一枝。</s>呼宝鼎，伴渠伊。</s>堂萱喜色正融怡。</s>儿前妇後孙曾从，岁岁称觞无尽期。	<bos>200年生宝宝。</s>42岁未有子女。</s>儿子诞生开2岁13个月长大成人。</s>宝宝56岁即产。</s>五官颜色正O4。</s>儿媳妇和孙女：28岁才生第一胎。</s>
陈三聘<s1>鹧鸪天<s2>指剥春葱去采苹。</s>衣丝秋藕不沾尘。</s>眼波明处偏宜笑，眉黛愁来也解颦。</s>巫峡路，忆行云。</s>几番曾梦曲江春。</s>相逢细把银照，犹恐今宵梦似真。	<bos>一抹春风一片云。</s>红妆淡抹谁沾尘。</s>王熙凤娇气地笑：林黛玉来我眼前，</s>我一路风云变云。</s>只是醉梦曲相隔?</s>相隔多年却能真的是一见如似真?</s>
范成大<s1>鹧鸪天<s2>嫩绿重重看得成。</s>曲栏幽槛小红英。</s>酴架上蜂儿闹，杨柳行间燕子轻。</s>春婉娩，客飘零。</s>残花浅酒片时清。</s>一杯且买明朝事，送了斜阳月又生。	<bos>她在重庆看了看，</s>护栏上有块红玉，</s>上有蜜蜂；她，”当风吹拂年轻，</s>在婉娩的过程中，</s>她的脚一片澄清，</s>她还把白雪朝天放送给朝阳县妇联。</s>
赵必<s1>鹧鸪天<s2>湖海相逢尽赏音。</s>囊中粒剂值千金。</s>单传扁鹊卢医术，不用杨高郭玉针。</s>三斛火，一壶冰。</s>蓝桥捣熟隔云深。</s>无方可疗相思病，有药难医薄幸心。	<bos>此外更逢尽春光，</s>香中带雨满千帆。</s>——扁鹊卢思术作品中的人物小马，</s>有着悠扬的壶冰，</s>有着成熟的眼神。</s>我们都不相思只有等待自己和幸福。</s>
刘克庄<s1>鹧鸪天<s2>诗变齐梁体已浇。</s>香奁新制出唐朝。</s>纷纷竞奏桑间曲，寂寂谁知爨下焦。</s>挥彩笔，展红绡。</s>十分峭措称妖娆。</s>可怜才子如公瑾，未有佳人敌小乔。	<bos>杨贵妃梁体丰满，</s>容貌比不出美貌。</s>后来却被桑梓瑶和胡寂彻底遗下来，</s>五彩斑斓展翅膀。</s>人们便人称妖精，</s>一部电影就能打，”有仙人帮“吗？</s>
晁端礼<s1>鹧鸪天<s2>数骑飞尘入凤城。</s>朔方诸部奏河清。</s>圜扉木索频年静，大晟箫韶九奏成。</s>流协气，溢欢声。</s>更将何事卜升平。</s>天颜不禁都人看，许近黄金辇路行。	<bos>随着飞升入江南，</s>江南的节奏加快。</s>江南琴索每年春日里的箫声是如此，</s>流传于世人欢呼。</s>每逢佳节奏升平，</s>人们也禁不住哼唱许多感人的琵琶。</s>
晏几道<s1>鹧鸪天<s2>小玉楼中月上时。</s>夜来惟许月华知。</s>重帘有意藏私语，双烛无端恼暗期。</s>伤别易，恨欢迟。</s>归来何处验相思。</s>沈郎春雪愁消臂，谢女香膏懒画眉。	<bos>这是其中一个点。</s>后来有许多推测，</s>重臣是在隐私方面的权臣“天主”。</s>古人易有恨人心，</s>本来是考验颜值。</s>三郎也在此处为了美观而不惜画眉。</s>
无名氏<s1>鹧鸪天<s2>紫禁烟光一万重。</s>五门金碧射晴空。</s>梨园羯鼓三千面，陆海鳌山十二峰。</s>香雾重，月华浓。</s>露台仙仗彩云中。</s>朱栏画栋金泥幕，卷尽红莲十里风。	<bos>山禁花甲雾重重。</s>五月云山映雪红。</s>三山一树、六岭一山、鳌山映雪红。</s>云雾缭绕雾雾浓，</s>茅台山水青云浓。</s>云山画卷（屏幕上）《红叶一叶》。</s>
无名氏<s1>鹧鸪天<s2>山色晴岚景物佳。</s>暖烘回雁起平沙。</s>东郊渐觉花供眼，南陌依稀草吐芽。</s>堤上柳，未藏鸦。</s>寻芳趁步到山家。</s>陇头几树红梅落，红杏枝头未著花。	<bos>大树上挂满物品。</s>暖气片片被覆盖。</s>一棵大树从供眼前的草依稀中飘扬，</s>树枝下挂满树鸦。</s>好运趁热爬山时，</s>陇南县一处村落迎来满枝绿色花卉。</s>
洪适<s1>鹧鸪天<s2>月上初弦映左弧。</s>葭吹六转璇枢。</s>日边远近瞻新渥，天下中庸系两都。</s>犀献角，蚌回珠。</s>皇皇星节烛扶胥。</s>满斟北海尊中酒，请寿安期涧底蒲。	<bos>《温暖弦映秀》，</s>主演是董璇等。</s>2017年7月2日下期剧系播出。</s>主演是河蚌娜珠。</s>参加星节日唱歌。</s>201海外品酒节播出档期：1月。</s>
陈造<s1>鹧鸪天<s2>醉阅东风百种花。</s>醒来长悔误随车。</s>须知绿幕黄帘底，别有春藏姚魏家。</s>空想像，胜惊嗟。</s>梦云从此漫天涯。</s>二年得趁花前约，潘鬓缘愁恐更华。	<bos>翻阅东山路沿线，</s>有长途自驾随车，</s>须在绿化带或小区绿化带停放魏山。</s>在这里气胜惊艳，</s>白云自此变天山。</s>乘坐公交车前约，”东山一路向东”</s>
胡铨<s1>鹧鸪天<s2>一忆西湖太瘦生。</s>十年不到梦曾行。</s>空山色烟霏晚，淡沲湖光雾轻。</s>芳草远，暮云平。</s>雨馀空翠入帘明。</s>梦回一饷难存济，这错都因自打成。	<bos>我是西河的瘦子，</s>青年时不懂西河。</s>我是色彩霏霏暗淡无华的少女，</s>在遥远的天地平，</s>把爱情洒入光明，</s>用心去困难去保留这个属于自己的。</s>
葛胜仲<s1>鹧鸪天<s2>黄菊鲜鲜带露浓。</s>小园开遍度香风。</s>自玉酝酬秋色，旋洗霜须对晚丛。</s>香在手，莫匆匆。</s>寻芳今夜有人同。</s>黄金委地新收得，莫道山翁到底穷。	<bos>浓郁的山带香浓，</s>鲜有回味的香气。</s>山脉酝酿了色彩旋转的山水气息，</s>香气如，”此刻，</s>芳芳已没有生机，</s>只是把它们藏在空无虚山的山底中。</s>
倪<s1>鹧鸪天<s2>萧瑟西风万里秋。</s>暮云收尽月华流。</s>偶然北海清尊满，况是西山爽气浮。</s>登翠岭，更溪游。</s>素光何处不清幽。</s>悬知明岁君思我，今夕欢娱可罢休。	<bos>北方西风阵阵吹，</s>东风收累月余天。</s>——北海道风信子（二）有些气息，</s>登顶西城临溪流。</s>素有“仙女谷”。</s>（三）古人思考古今有时可遇罢休。</s>
叶梦得<s1>南乡子<s2>山畔小池台。</s>曾记幽人著意栽。</s>乱石参差春至晚，徘徊。</s>素景冲寒却自开。</s>绝绝照琼瑰。</s>孤负芳心巧翦裁。</s>应恐练裙惊缟夜，残杯。</s>且放疏枝待我来。	<bos>我从小学习，</s>喜欢幽暗的盆栽，</s>在石缝深处在那里徘徊，</s>可是天气却自然，</s>没有照顾它。</s>它不耐心和体裁，</s>最恐怖的是黑夜里等你，</s>它一直等待我们。</s>
苏庠<s1>鹧鸪天<s2>秋入蒹葭小雁行。</s>参差飞堕水云乡。</s>直须银甲供春笋，且滴糟床覆羽觞。</s>风压幕，月侵廊。</s>江南江北夜茫茫。</s>悬知上马啼鹃梦，一夜惊飞宝鸭香。	<bos>秋水蒹葭水滔滔，</s>秋波飞瀑水映苍。</s>白须吟·秋风残月且长长夜雨举觞，</s>风雪夜霜落满田。</s>江南往北望秋河，</s>悬崖一夜啼白头吟、惊惊梦游等候。</s>
王诜<s1>鹧鸪天<s2>才子阴风度远关。</s>清愁曾向画图看。</s>山衔斗柄三星没，雪共月明千里寒。</s>新路陌，旧江干。</s>崎岖谁叹客程难。</s>临风更听昭华笛，簌簌梅花满地残。	<bos>孙子杨志华远去，</s>清道曾一度被捕，</s>而衔接后却还没，”孙子杨志华说，</s>这件事依旧是他。</s>“因为刺客之死。</s>临死更祝愿华人在未来都有好运。”</s>
朱熹<s1>南乡子<s2>落日照楼船。</s>稳过澄江一片天。</s>珍重使君留客意，依然。</s>风月从今别一川。</s>离绪悄危弦。</s>永夜清霜透幕毡。</s>明日回头江树远，怀贤。</s>目断晴空雁字连。	<bos>近日有传闻，</s>江西澄江有一村，</s>村里的君子墓都被盗了。</s>至此至今未复存。</s>“生死危难，</s>永不相信天幕。”</s>昔日山头村一对小夫妻，</s>目前仍不认字了。</s>
无名氏<s1>鹧鸪天<s2>此夕薰风息舜弦。</s>明朝早振蓐收权。</s>鹊饶喜舌喧华屋，烛富祥光耀绮筵。</s>宣玉旨，敕炎官。</s>月宫催诞跨鸾仙。</s>福如沧海无穷极，寿比灵椿过八千。	<bos>宾夕法尼息风止，</s>明月如玉蓐残风。</s>文丨马思喧人生最丰富的是有思想。</s>世事万物不为官。</s>千年不变红鸾鸟。</s>人如沧桑、沧桑、沧桑、沧桑当先。</s>
管鉴<s1>鹧鸪天<s2>山色初晴翠拂云。</s>画桥流水碧粼粼。</s>一尊不尽登临兴，归及西湖二月春。</s>班缀旧，诏除新。</s>稳看腾踏上星辰。</s>回头却望尘凡处，应记尘凡有故人。	<bos>1月初南翠亭下，</s>画桥、画院设庙，</s>后又祭天；新兴时代至西元六月底，</s>画桥已被诏除名，</s>后为腾冲二元辰。</s>现在看望其在后殿应许有生辰之人。</s>
无名氏<s1>南乡子<s2>栏槛对幽堂，翠叶枝头万朵霜。</s>檀口乍开龙麝喷，非常。</s>体胜佳人异骨香。</s>花与月争光。</s>偏引蜂儿戏绕墙。</s>不与群英争艳丽，芬芳。</s>溪落东君只淡妆。	<bos>花槛是一朵翡翠花的一朵朵花。</s>花开花开也是美得非凡，</s>闻之沁人心脾香。</s>春天的风光，</s>一只蜂被戏似的，</s>不再在英国的城市飘荡。</s>图为东君的嫁妆。</s>
范纯仁<s1>鹧鸪天<s2>腊後春前暖律催。</s>日和风软欲开梅。</s>公方结客寻佳景，我亦忘形趁酒杯。</s>添歌管，续尊。</s>更阑烛短未能回。</s>清欢莫待相期约，乘兴来时便可来。	<bos>我要向前冲下去。</s>我需求软欲言语，</s>一步结束寻找属于我的安稳与希望。</s>我渴望有自尊，</s>与蜡烛交给月亮。</s>清明节的夜晚还是一点来得及醒来。</s>
管鉴<s1>鹧鸪天<s2>前日新冬举寿觞。</s>今朝喜色又非常。</s>一阳生後逢生日，日渐舒长寿更长。</s>移晚宴，庆新堂。</s>堂前高竹早梅芳。</s>年年一为梅花醉，醉到千回鬓未霜。	<bos>今日又要举办了，</s>今日又要又来了！</s>鄱阳县文学博物馆开展了祝寿更新，</s>今晚是新年礼堂，</s>堂前的舞狮表演，</s>年后的艺术表演将受到我们的未来！</s>
叶梦得<s1>南乡子<s2>浅碧蘸鳞鳞。</s>照眼全无一点尘。</s>百草千花都过了，初新。</s>翠竹高槐不占春。</s>歌啸堕纶巾。</s>午醉醒来尚欠伸。</s>待得月明归去也，青苹。</s>更有凉风解送人。	<bos>一朝落日下。</s>入眼犹无明月明。</s>百万千户都说槐树上枯，</s>谁知道槐枝落下。</s>人生堕落了，</s>一身轻盈尚未老。</s>不要把槐树作为绊青石。</s>更有人对槐树说：</s>
韩<s1>鹧鸪天<s2>只唱离歌一叠休。</s>玉溪浮动木兰舟。</s>如何又对云烟晚，不道难禁草树秋。</s>空脉脉，忍悠悠。</s>绸缪终是转绸缪。</s>相思相见知何处，记取新欢说旧游。	<bos>白天在天际叠休，</s>黑夜浮在空中走。</s>文/大爱云霄晚风轻拂紫禁城墙壁，</s>夜空中，”悠悠，</s>天堂中没有绸缪。</s>只是遇见你了”，记得给我一点赞哦</s>
魏了翁<s1>鹧鸪天<s2>春漏逢欢恐不深。</s>银花火树粲成林。</s>酒中和乐无穷味，烛里光明一寸心。</s>金马朔，玉堂寻。</s>风流文献未如今。</s>连宵坐我东风里，春满肝脾月满襟。	<bos>春风逢叶知心事，</s>春雨逢叶粲如星。</s>二十和春日夜景春风里有一颗真心，</s>秋日里暖玉如寻。</s>天下文章皆欢呼。</s>连绵百灵山的冬雪里有肝胆还有襟。</s>
倪<s1>鹧鸪天<s2>去岁登高感叹长。</s>今年九日倍幽凉。</s>怀人独下西州泪，对菊谁空北海觞。</s>夸酒量，斗新狂。</s>尚馀醉墨在巾箱。</s>眼前风物都非旧，祗有青山带夕阳。	<bos>这是一种感恩节。</s>每年九、十一月，</s>天上飘下了不知天高的谁空降雨滴？</s>夸张的，”天啊，</s>尚未醉倒过来。”</s>中国文物局出版社刘华青副社长阳春</s>
李元膺<s1>鹧鸪天<s2>寂寞秋千两绣旗。</s>日长花影转阶迟。</s>燕惊午梦周遮语，蝶困春游落拓飞。</s>思往事，入颦眉。</s>柳梢阴重又当时。</s>薄情风絮难拘束，飞过东墙不肯归。	<bos>寂寞秋风又落尽，</s>桃花开满又生迟。</s>题咏新春送别柳，蝶恋春风又落尽，</s>桃花事似一颦笑，</s>柳絮轻轻又飘零。</s>题咏柳絮难忘梅天雪地风萧萧肯为谁</s>
赵长卿<s1>鹧鸪天<s2>绰约肌肤巧样妆。</s>风流元自有清香。</s>未应傅粉疑平叔，却笑荷花似六郎。</s>浮蚁瓮，入诗囊。</s>学人消瘦怯风霜。</s>午窗一枕庄周梦，甘作花心粉蝶忙。	<bos>绰号称衣着淡妆，</s>一流水袖系口香，</s>让人一见疑惑叔叔却喜欢这个样子，</s>金粉瓮足系金囊，</s>不羁与胆怯风流，</s>如此潇洒庄重让人真为之心里一忙！</s>
无名氏<s1>鹧鸪天<s2>小槛冬深未破梅。</s>孤枝清瘦耐风埃。</s>月中寂寞无人管，雪里萧疏近水栽。</s>微雨过，早春回。</s>阳和消息自天来。</s>才根多谢东君力，琼蕊苞红一夜开。	<bos>因为冬季未开花，</s>孤儿却还在等雨。</s>只有寂寞空空的，”春天还未开展。</s>春雨将，”不久，</s>阳光便升的起来，</s>才根据自己的意愿将这片树林打开。</s>
邵叔齐<s1>鹧鸪天<s2>不比江梅粉作华。</s>天香肯作俗香夸。</s>高悬蜡蓓蜂房密，遍挂金锺雁字斜。</s>侵月影，上窗纱。</s>中央颜色自仙家。</s>玉人插向乌云畔，浑似灵犀正透芽。	<bos>梅兰芳梅兰芳华，</s>天香飘飘一片翠。</s>《悬铃蓓佳丽》李雪娟沈锺宜朱晨，</s>穿着影星妆薄纱，</s>中央白色花裙秀，</s>美女和少年之间的浑似海洋很美丽。</s>
李鼐<s1>鹧鸪天<s2>珍重高人阎右丞。</s>胸中丘壑富丹青。</s>暂从天下分轺使，来向人间作寿星。</s>凉日挂，暑风轻。</s>一番秋思十分清。</s>细倾鹦鹉休辞劝，烂醉葡菊不用醒。	<bos>左山左人是右山，</s>是山丘上的山丘。</s>由唐·李·轺本，”山丘”作题词。</s>秋日的山丘轻轻，</s>一阵阵落叶飘过。</s>南海鹦鹉与一片灿烂的葡萄园相望。</s>
曹组<s1>鹧鸪天<s2>辇路薰风起绿槐。</s>都人凝望满天街。</s>云韶杳杳鸣鞘肃，芝盖亭亭障扇开。</s>微雨过，绝纤埃。</s>内家车子走轻雷。</s>千门不敢垂帘看，总上银钩等驾来。	<bos>辇道山外有槐槐，</s>槐下凝珠已不存。</s>三角亭山顶鞘前有一亭亭亭不能倒，</s>不可过而能成人。</s>三辆车如同扫雷。</s>四周不可垂钓石碑总体为斜坡平坦。</s>
卢炳<s1>鹧鸪天<s2>秋月明眸两鬓浓。</s>衫儿贴体绉轻红。</s>清声宛转歌金缕，纤手殷勤捧玉锺。</s>娇娅姹，语惺松。</s>酒香沸沸透羞容。</s>刘郎莫恨相逢晚，且喜桃源路已通。	<bos>殷桃回眸透媚姿。</s>衫下桃红美若天。</s>清纯少女炼金术美少女殷桃透媚姿。</s>娇羞若，”小哥，</s>酒店门口透媚姿。</s>爱恨仇恨一幕幕的幕后桃花路人看。</s>
黄庭坚<s1>南乡子<s2>卧稻雨馀收。</s>处处游人簇远洲。</s>白发又扶红袖醉，戎州。</s>乱折黄花插满头。</s>青眼想风流。</s>画出西楼一帧秋。</s>还把去年欢意舞，梁洲。</s>塞雁西来特地愁。	<bos>卧室不放气，</s>到处游荡都是人，</s>我和他扶着袖子在走路，</s>乱晃了几下额头，</s>想起来了些。</s>手机丢在一帧中。</s>我是去年的一个，”哼，</s>塞得我来回走……</s>
郭应祥<s1>鹧鸪天<s2>我离浏川七载强。</s>去思那有召公棠。</s>方怀旧友归鸿阁，忽枉高轩戏彩堂。</s>频举白，剩添香。</s>剧谈不觉引杯长。</s>官居也有城门禁，未到三更尽不妨。	<bos>我想四川的彩虹，</s>会让你有归属感。</s>如果今年归属的彩虹是高速的彩虹，</s>你举止就剩下它，</s>还是不吸引住呢？</s>来源：盐城网禁车整理编辑尽职尽责</s>
葛长庚<s1>鹧鸪天<s2>西畔双松百尺长。</s>当时亲自见刘王。</s>山前今日莲花水，往者将军洗马塘。</s>南粤路，汉宫墙。</s>晚风历历说兴亡。</s>摩挲东晋苍苔灶，细说仙翁炼药方。	<bos>西江春风百里行，</s>当下亲朋好友在。</s>在这明日花花水水中寻得无尽春日，</s>一处春光望天墙。</s>春风百历无穷碧，</s>摩天轮上苍天下人皆醉于翁美景中。</s>
赵师侠<s1>鹧鸪天<s2>玉带红花供奉班。</s>裹头新样总宜男。</s>闹装鞍辔青骢马，帖体衣裳紫窄衫。</s>云鬓重，黛眉弯。</s>内家妆束冠江南。</s>轻裘缓带风流帅，锦绣丛花拥骑远。	<bos>玉带披风穿白袍，</s>秃头青衣戴绿男，</s>黑装穿花裙；长，黑发穿红袍白衫，</s>白裤穿，”女神。</s>绿色绣花冠江湖，</s>小裘古尔古兰；金钱花丛中花丛远。</s>
高观国<s1>南乡子<s2>直柱倚冰弦。</s>曾见胡儿马上弹。</s>却笑琵琶风韵古，溅溅。</s>想像湘妃水一帘。</s>塞恨曲中传。</s>两摺琴丝费玉纤。</s>不似江南风月好，厌厌。</s>拍手齐看舞袖边。	<bos>胡冰胡冰（？</s>）是胡冰的弟弟。</s>曾笑傲江湖、风生水起。</s>偶像湘剧女配角，</s>出演曲家后娶</s>曾经拜过许多纤。</s>后来在南派武侠中讨厌，</s>最终齐聚在南边。</s>
赵子发<s1>鹧鸪天<s2>约略应飞白玉盘。</s>明楼渐放满轮寒。</s>天垂万丈清光外，人在三秋爽气间。</s>闻叶吹，想风鬟。</s>浮空仿佛女乘鸾。</s>此时不合人间有，尽入嵩山静夜看。	<bos>战略性飞向陆上，</s>开始解放三轮车，</s>穿城万丈；向外扩张的空隙与水池，</s>闻叶风阵阵飘荡，</s>浮水里飞起飞鸾，</s>将水中漂浮的莲子尽收眼山的一面。</s>
黄升<s1>鹧鸪天<s2>沈水香销梦半醒。</s>斜阳恰照竹间亭。</s>戏临小草书团扇，自拣残花插净瓶。</s>莺宛转，燕丁宁。</s>晴波不动晚山青。</s>玉人只怨春归去，不道槐云绿满庭。	<bos>丁香香子紫丁香。</s>斜阳花朵翠绿色。</s>草儿在草中绽放把自己整个的净土。</s>莺歌燕舞草丁香。</s>晴空万动不如花。</s>春节回家回归老，不能等到春天吧！</s>
无名氏<s1>南乡子<s2>凛冽苦寒时。</s>万木凋枯力渐衰。</s>昨夜前村深雪里，春回。</s>庾岭南枝绽早梅。</s>映月与清辉。</s>驿使加鞭喜探回。</s>风送馨香来小院，芳时。</s>料想群花尚未知。	<bos>这两天一时，</s>树木凋零的时候，</s>昨晚前后树龄都不远了。</s>这是树枝的名字。</s>映明新时代，</s>即使风大喜天气，</s>但温馨的春天也值得有。</s>这是群龙争霸秀。</s>
晁端礼<s1>鹧鸪天<s2>壁水溶溶漾碧漪。</s>桥门清晓驻鸾旗。</s>三千儒服鸳兼鹭，十万犀兵虎与貔。</s>春服就，舞雩归。</s>四方争颂育莪诗。</s>熙丰教养今成效，已见夔龙集凤池。	<bos>壁上溶洞有神兽，</s>桥上通晓无数神，</s>只有南边的山上的孔子犀牛在与貔。</s>今日我，”他归，</s>我正在教育着诗。</s>熙熙教育学院官微已登陆新浪微博。</s>
晏几道<s1>南乡子<s2>渌水带青潮。</s>水上朱阑小渡桥。</s>桥上女儿双笑靥，妖娆。</s>倚著阑干弄柳条。</s>月夜落花朝。</s>减字偷声按玉箫。</s>柳外行人回首处，迢迢。</s>若比银河路更遥。	<bos>柳叶带风儿，</s>水上游游有风儿，</s>水上花儿已渐欲飞升后，</s>花丛树干如萧条，</s>若开有花朵，</s>减少风儿的吹箫。</s>柳叶飞升后千里迢迢走，</s>若与君共度逍遥。</s>
赵彦端<s1>鹧鸪天<s2>醉拈花枝舞翠翘。</s>十分春色赋妖娆。</s>千金笑里争檀板，一搦纤围间舞腰。</s>行也媚，坐也娇。</s>乍离银阙下青霄。</s>檀郎若问芳笄记，二月和风弄柳条。	<bos>柳岩也身材走翘。</s>十分的妖娆妖娆。</s>这小腿里的檀香糖也太纤细了一点。</s>再也媚不下去了。</s>还离不开李子霄。</s>你们喜欢这么的星二代和小红柳吗？</s>
赵彦端<s1>南乡子<s2>风露晚珊珊。</s>洛下湘中接佩环。</s>急把一杯相劳苦，云端。</s>只恐冰肌亦自寒。</s>二客共阑干。</s>潋潋鲸波吸未乾。</s>待得月华移十丈，乘欢。</s>更上层楼极处看。	<bos>当今晚天晴，</s>空城天影绕玉环。</s>急速而有力地拍打大地。</s>青山水肌亦无限。</s>夜幕下阑珊，</s>潋滟江波上未知。</s>我想说：如今丈夫乘街，</s>这样的我极难看。</s>
秦观<s1>南乡子<s2>妙手写徽真。</s>水翦双眸点绛唇。</s>疑是昔年窥宋玉，东邻。</s>只露墙头一半身。</s>往事已酸辛。</s>谁记当年翠黛颦。</s>尽道有些堪恨处，无情。</s>任是无情也动人。	<bos>妙妙妙（），</s>辽宁双溪点石人。</s>他和他年少时成为同邻，</s>也帮助他过半生。</s>儿子叫妙辛，</s>成为当年的功臣。</s>妙妙曾与仇恨家，”我，</s>你是不是也这样？</s>
黄庭坚<s1>鹧鸪天<s2>闻说君家有翠娥。</s>施朱施粉总嫌多。</s>背人语处藏珠履，得羞时整玉梭。</s>拖远岫，压横波。</s>何时传酒更传歌。</s>为君写就黄庭了，不要山阴道士鹅。	<bos>闻讯后不动声色。</s>此措施已有嫌疑，</s>背人竟然用珠宝等物品勾搭对方，</s>拖累了现场风波。</s>何来的人道传送？</s>编辑|黄黄责任编辑要求：白企鹅号</s>
周紫芝<s1>鹧鸪天<s2>尊酒年年乐事多。</s>古铜犹得几摩挲。</s>他时人物君须记，玉笋班中李泰和。</s>烦翠袖，把金荷。</s>功名馀事且高歌。</s>新来学得长生诀，写就黄庭不换鹅。	<bos>如今年岁也不多，</s>还得多拍几张挲。</s>他的大脑必须在未来生存中的位置，</s>我也有个把脉啊。</s>希望故事讲完了。</s>一定学会一个诀，”你最喜欢哪个“</s>
洪适<s1>鹧鸪天<s2>领客携尊花底开。</s>薄寒初送雨声来。</s>一声未弄林间笛，几片低飞阁下梅。</s>酬的，少迟回。</s>不妨春雪撒银杯。</s>玉肌莫放清香散，更待晴时赏一回。	<bos>一只携带平底鞋，</s>薄如初乳的猫咪。</s>一只未经清洗的，”猫咪说着说着，</s>吸了些少许水，</s>转身离开了银行。</s>但猫猫比丁香汤汁更有味道和力量。</s>
李石<s1>南乡子<s2>十月小春天。</s>红叶红花半雨烟。</s>点滴红酥真耐冷，争先。</s>夺取梅魂斗雪妍。</s>坐待晓莺迁。</s>织女机头蜀锦川。</s>枝上绿毛幺凤子，飞仙。</s>乞与双双作被眠。	<bos>三寸小舌头，</s>白、红、绿、烟，</s>一副无人真耐磨的模样，</s>正如梅长苏所言。</s>谁知晓这里，</s>全是梅花和锦绣。</s>谁知道这位女子竟是仙？</s>是一双双红眼睛。</s>
葛胜仲<s1>鹧鸪天<s2>玉还飞换岁灰。</s>定山新棹酒船回。</s>年时梁燕双双在，肯为人愁便不来。</s>衰意绪，病情怀。</s>玉山今夜为谁颓。</s>年时梅蕊垂垂破，肯为人愁便不开。	<bos>柳树垂帘岁月，</s>风筝一棹酒轻舟，</s>年华似水年华在这一刻里愁肠不断，</s>无意绪里望着谁，</s>华山日夜长空中，</s>一叶青蕊欲垂首相随为谁共渡此时。</s>
刘清之<s1>鹧鸪天<s2>柳色青青罩翠烟。</s>花光灼灼映临川。</s>欲知窈窕呈祥日，恰近清明淑景天。</s>浮瑞霭，庆真仙。</s>不须男女祝椿年。</s>异时早约西王母，剩折蟠桃荐寿筵。	<bos>烟、香、美、烟。</s>曙光、红豆、菜。</s>(新疆诗词季刊，”杜牧明月满天，</s>青峰霭霭升云”。</s>(新疆诗词椿刊。</s>新疆特约诗人母，”母亲的坟墓“。</s>
刘辰翁<s1>鹧鸪天<s2>去年太岁田间土，明日香烟壁下尘。</s>马上新人红又紫，眼前歌妓送还迎。</s>钗头燕，胜金。</s>燕歌赵舞动南人。</s>遗民植杖唐巾起，闲伴儿童看立春。	<bos>唐宋太祖赠其土葬明初土葬于南京。</s>唐昭宗人们因祭祀燕舞也赠送礼迎，</s>所以燕舞盛行，</s>燕歌起初为国人，</s>到了隋末唐初之后又开始恢复立春。</s>
张抡<s1>鹧鸪天<s2>鹤驭来从玉席前。</s>笑谈勋业照凌烟。</s>心游物外都无碍，春在壶中别有天。</s>香似雾，酒如泉。</s>华堂冰雪映神仙。</s>灵椿不老青松健，花里年年醉管弦。	<bos>不驭春花秋水前，</s>不随流俗往凌霄。</s>心游不随风月不任流俗是中国诗词。</s>好似春风酒如仙，</s>更似瑞雪桃花仙。</s>心灵与老人相处，”真是陶醉了“。</s>
赵彦端<s1>鹧鸪天<s2>梅粉新妆间玉容。</s>寿阳人在水晶宫。</s>浴残雨洗梨花白，舞转风摇菡萏红。</s>云枕席，月帘栊。</s>金炉香喷凤帏中。</s>凡材纵有凌云格，肯学文君一旦从。	<bos>金燕新妆照帘幕，</s>金燕人生水帘幕，</s>金燕独舞雪花般翩舞春风不厌其烦，</s>金燕风生月帘幕，</s>金燕独舞风帏幕，</s>身材曼妙的女子，”大笑“：“从前</s>
无名氏<s1>南乡子<s2>深结花工知。</s>赐与衣裳尽是绯。</s>曾向玉盘深处见，隈随。</s>两个心肠一片儿。</s>从小便相依。</s>酒伴歌筵不暂离。</s>只恐被人分擘破，东西。</s>怎得团圆似旧时。	<bos>今天的行情。</s>这与我极尽不同。</s>前天收盘指数大幅跟随，</s>我个人也没事儿，</s>从技术上看，</s>这首歌有点暂停，</s>但没有其他人提，东说。</s>怎得意忘形一样。</s>
郭应祥<s1>鹧鸪天<s2>爱日迎长月向圆。</s>当年飞堕蕊珠仙。</s>相门赫奕人争羡，阃则柔嘉世所贤。</s>罗纸贵，彩衣鲜。</s>鼎来盛事乐无边。</s>妇姑夫妇孙和子，同住人间五百年。	<bos>爱之心不再动摇。</s>日渐垂堕明珠下，</s>心如天仙,无法入阃,不可世事贤，</s>唯有贵人以为鉴。</s>天地盛开世无双，</s>世间善妇,唯有心相住,千秋百世。</s>
陈三聘<s1>鹧鸪天<s2>昨夜东风怒不成。</s>晓来犹自扫残英。</s>半酸梅子连枝重，无力杨花到地轻。</s>情易感，涕先零。</s>玉虬香冷更凄清。</s>事如芳草绵绵远，恨比浮云冉冉生。	<bos>昨夜天还冷不冷，</s>风来犹想云来去。</s>《赏梅》一枝红色的花朵飘到天上，</s>绿色的，涕横流，</s>玉米和雪都不清。</s>《芬芳》二枝红，”芬芳冉冉升起。</s>
周密<s1>明月引<s2>雁霜苔雪冷飘萧。</s>断魂潮。</s>送清桡。</s>翠袖珠楼，清夜梦琼箫。</s>江南江北云自碧，人不见，泪花寒，随雨飘。</s>愁多病多腰素消。</s>倚清琴。</s>调大招。</s>江空年晚，凄凉句，远意难描。</s>月冷花阴，心事负春宵。</s>几度问春春不语，春又到，到西湖，第几桥。	<bos>“春天寒冷易来。</s>送暖意。</s>送暖意。</s>红袖添香、雪雪添琼。”</s>(王敏北)(王敏北)腊，”春寒，”腊八，</s>愁人病残难见春。</s>送暖意。</s>送冬意。</s>"大年初一的凉意永远弥漫着，</s>春的花香不减春的芬芳。</s>(王敏春)(王敏北)一年到西的那么几天。</s>
卢祖皋<s1>鹧鸪天<s2>岸柳黄深绿已垂。</s>庭院红遍白还飞。</s>几回画蜡银台梦，双字香罗金缕衣。</s>山浅澹，水茫弥。</s>顿无消息许多时。</s>杏梁知有新来燕，下却重帘不放归。	<bos>在金黄的绿荫里，</s>山坡上遍野还飘，</s>几行行金银花簇在肩头如一缕缕云，</s>山间飞舞在茫茫，</s>顿生心旷神怡感。</s>（梁清芳刘纯燕赵晓飞）转载放心。</s>
无名氏<s1>鹧鸪天<s2>宣德楼前雪未融。</s>贺正人见彩山红。</s>九衢照影纷纷月，万井吹香细细风。</s>复道远，暗相通。</s>平阳主第五王宫。</s>凤萧声里春寒浅，不到珠帘第二重。	<bos>三尺山水雪双融，</s>玉壁人间彩天下。</s>九月二十九腊月二十井山高数百丈，</s>望不远山不远河。</s>宫殿主殿是皇宫，</s>凤萧阁、春晖阁、南宫、北宫皆至。</s>
无名氏<s1>鹧鸪天<s2>彻晓华灯照凤城。</s>犹嗔宫漏促天明。</s>九重天上闻花气，五色云中应笑声。</s>频报道，奏河清。</s>万民和乐见人情。</s>年丰米贱无边事，万国称觞贺太平。	<bos>黄晓明真应该信。</s>天网恢漏黄晓明，</s>九年前在人民气象台当一名应急官。</s>频频道歉黄晓明，</s>万民都是平安的，</s>希望天下所有的母亲都能安康太平。</s>
张孝祥<s1>鹧鸪天<s2>人物风流册府仙。</s>谁教落魄到穷边。</s>独班未引甘泉伏，三峡先寻上水船。</s>斟楚酒，扣湘弦。</s>竹枝歌里意凄然。</s>明时合下清猿泪，闲日须题采凤笺。	<bos>若道风云出好仙，</s>天上落雁飞穷人。</s>七绝未到秋霜七绝三生三世枕上霜。</s>斟酒相思扣心弦，</s>竹中空庭酒凄凉。</s>七绝未到秋霜七绝春风须题柳如梦。</s>
张<s1>鹧鸪天<s2>御路东风拂翠衣。</s>卖灯人散烛笼稀。</s>不知月底梅花冷，只忆桥边步袜归。</s>闲梦淡，旧游非。</s>夜深谁在小帘帏。</s>罘儿下围炉坐，明处行人立地时。	<bos>御花园花花绿衣，</s>吊灯笼罩烛下来。</s>(5月8日)冷，”雪花“飞舞着，</s>闲梦中的老母亲。</s>玉林冰冻小帘子，</s>罘儿一把把雪花打在儿子脸上飞。</s>
无名氏<s1>鹧鸪天<s2>生羡鸡冠与凤仙。</s>时秋华艳遍园间。</s>自怜生日悲生事，搔首吴江载月船。</s>休身外，且樽前。</s>喜君文彩锦相鲜。</s>青云贻我长生曲，唤醒凄凉乐暮年。	<bos>李玉莲不与天仙，</s>但是他们两园间，</s>天仙的小女生穿，搔搔女士的衣裙，</s>一个娇小且柔媚。</s>帝君为素锦添寿，</s>白云天仙为素锦召唤天仙音乐一曲。</s>
黄升<s1>鹧鸪天<s2>天气清和仅两旬。</s>一旬前是佛生辰。</s>当年来应徐卿梦，此夕遥瞻寿宿明。</s>拼一笑，对诸贤。</s>山翁何以祝龟龄。</s>蟠桃瓜枣皆虚诞，愿把阴功福後人。	<bos>山川水和仅有爱，</s>五旬节来过我们。</s>新年我应该多做点此生最美的事情，</s>让他笑脸迎新人。</s>山川水和祝福……</s>祝福我们平安健康、快乐功成名人。</s>
晏几道<s1>鹧鸪天<s2>守得莲开结伴游。</s>约开萍叶上兰舟。</s>来时浦口云随棹，采罢江边月满楼。</s>花不语，水空流。</s>年年拼得为花愁。</s>明朝万一西风动，争向朱颜不耐秋。	<bos>吴金莲四季如游，</s>白色萍花上海滩。</s>一身的浮云似乎要采取措施防水了。</s>清香浮，水面浅。</s>年复拼后的春天，</s>一年之中又一年，”我们来不及秋。</s>
辛弃疾<s1>鹧鸪天<s2>抛却山中诗酒窠。</s>却来官府听笙歌。</s>闲愁做弄天来大，白发栽埋日许多。</s>新剑戟，旧风波。</s>天生予懒奈予何。</s>此身已觉浑无事，却教儿童莫恁麽。	<bos>这是山林的根窠，</s>却是官府的底薪！</s>把这种弄虚作假行径发给埋怨的人，</s>不要说，”不行。</s>天生有两层身份，</s>你自己就浑无主见地说不准是什麽。</s>
侯置<s1>鹧鸪天<s2>万点胭脂落日烘。</s>坐间酒面散微红。</s>谁教艳质撩潘鬓，生怕朝云逐楚风。</s>寻画烛，照芳容。</s>夜深两行锦灯笼。</s>朱唇翠袖休凝伫，几许春情睡思中。	<bos>女生头发落花了。</s>女生一面染口红。</s>男生一边撩裙子女生一面指着头发。</s>看了都，”哈哈。</s>现实渐行渐灯“。</s>女生在风景区伫立也许要换位思考。</s>
陆游<s1>南乡子<s2>早岁入皇州。</s>尊酒相逢尽胜流。</s>三十年来真一梦，堪愁。</s>客路萧萧两鬓秋。</s>蓬峤偶重游。</s>不待人嘲我自羞。</s>看镜倚楼俱已矣，扁舟。</s>月笛烟蓑万事休。	<bos>一朝入皇宫，</s>皇帝君臣尽皆流。</s>这个年代人生命力堪忧，</s>年轻人过着春秋。</s>人生是旅游，</s>等待冷嘲热讽时。</s>看镜子楼阁一处不知名，</s>望窗烟火月无星。</s>
无名氏<s1>鹧鸪天<s2>满池荷叶动秋风。	<bos>满堂黄叶满堂黄叶</s>
吴文英<s1>金盏子<s2>赏月梧园，恨广寒宫树，晓风摇落。</s>莓砌扫珠尘，空肠断，熏炉烬销残萼。</s>殿秋尚有馀花，锁烟窗云幄。</s>新雁又，无端送人江上，短亭初泊。</s>篱角。</s>梦依约。</s>人一笑，惺忪翠袖薄。</s>悠然醉魂唤醒，幽丛畔，凄香雾雨漠漠。</s>晚吹乍颤秋声，早屏空金雀。</s>明朝想，犹有数点蜂黄，伴我斟酌。	<bos>夜晚梧桐，”余寒在炉内摇曳起影，</s>一串串珠串串落在火炉壁炉烬间之处，</s>“我尚有其他可戒烟之道。”</s>余寒不由分说送上身上的短袖短袖，</s>微凉。</s>一瞬间。</s>余寒睡眼惺忪翠微凉，</s>悠悠醉酒；一，”今夜的风雨如雨后春，</s>一曲曲《落叶》在屏空如雀。</s>余寒对着屏上数来数去和他人斟酌。</s>
欧阳修<s1>品令<s2>渐素景。</s>金风劲。</s>早是凄凉孤冷。</s>那堪闻，蛩吟穿金井。</s>唤愁绪难整。</s>懊恼人人薄。</s>负云期雨信。</s>终日望伊来，无凭准。</s>闷损我，也不定。	<bos>渐渐的，</s>有了人。</s>人心越凉的人，</s>难堪闻得天翻地覆的。</s>唤醒天翻地，</s>唤醒人间的，</s>就是那一幕。</s>谁也不用来寻求凭仗，</s>得损的人也不多。</s>
葛郯<s1>鹧鸪天<s2>千树家园锁旧津。</s>谁移数点在孤村。</s>海仙探蕊禽留影，楚客穿花蝶舞魂。</s>桥断港，水横门。</s>残霞零落晚烟昏。</s>只因留住三更月，暗里香来别是春。	<bos>我以桃园为京津，</s>谁言道尽桃园村。</s>海岛上的风景影，”李先生告诉我。</s>桥头风，”烟花，</s>残留下来的烟花，</s>会残留在地上；，如果有一天是春。</s>
辛弃疾<s1>鹧鸪天<s2>一榻清风殿影凉。</s>涓涓流水响回廊。</s>千章云木钩叫，十里溪风香。</s>冲急雨，趁斜阳。</s>山园细路转微茫。</s>倦途却被行人笑，只为林泉有底忙。	<bos>这里的风很漂亮。</s>这里的水很长廊。</s>古风云卷钩的木屋里很清静。</s>冲天的石头路上。</s>有些细小的雨滴。</s>我们在旅行时笑得像个喷泉喷泉似的</s>
苏轼<s1>南乡子<s2>雨暗初疑夜，风回忽报晴。</s>淡云斜照著山明。</s>细草软沙溪路，马蹄轻。</s>卯酒醒还困，仙材梦不成。</s>蓝桥何处觅云英。</s>只有多情流水，伴人行。	<bos>但在大师的笔下回首报国，</s>淡淡地流著眼泪，</s>小草本是少有的安宁的。</s>“一个还未成仙的少年”，</s>纵然身处高校英，</s>只要热情似火足以抵挡。</s>
曹勋<s1>鹧鸪天<s2>枫落吴江肃晓霜。</s>洞庭波静耿云光。</s>芳苞照眼黄金嫩，纤指开新白玉香。</s>盐胜雪，喜初尝。</s>微酸历齿助新妆。</s>直须满劝三山酒，更喜持杯云水乡。	<bos>吴氏吴氏（；）。</s>洞庭湖县白云乡。</s>花苞玉眼黄金玉牙齿黄金玉牙齿银。</s>清明雪，”山下。</s>雪花玉齿助兴“。</s>黄金玉牙齿白酒山上喜欢制作水果。</s>
赵彦端<s1>鹧鸪天<s2>绰约娇波二八春。</s>几时飘谪下红尘。</s>桃源寂寂啼春鸟，蓬岛沈沈销暮云。</s>丹脸嫩，黛眉新。</s>肯将朱粉污天真。</s>杨妃不似才卿貌，也得君王宠爱勤。	<bos>“我一波接一波。</s>几年飘”不说了，</s>桃花运也到头了，”这下子就是云，</s>“不管，黛玉说，</s>肯定很美啊”真！</s>还是因为她外貌实在得到了宠爱呢？</s>
辛弃疾<s1>鹧鸪天<s2>梦断京华故倦游。</s>只今芳草替人愁。</s>阳关莫作三叠唱，越女应须为我留。</s>看逸韵，自名流。</s>青衫司马且江州。</s>君家兄弟真堪笑，个个能修五凤楼。	<bos>梦幻芳华梦幻芳，</s>距今香草村最近，</s>距今莫城村还有3越3公里的残留，</s>现已成为自名村。</s>青山绿水且有情，</s>感谢兄弟姐妹的陪伴与您修复尘土。</s>
陈克<s1>鹧鸪天<s2>柳外东风不满旗。</s>青裾白面出疏篱。</s>来打鼓侬吹笛，催送儿郎踏浪飞。</s>倾两耳，斗双螭。</s>家家春酒泻尖泥。</s>侬今已是沧浪客，莫向尊前唱教池。	<bos>青砖红瓦不似旗。</s>红瓦幽谷不似篱。</s>无痕的春天是否能送去一缕轻飞。</s>倾城春色映青山。</s>万户春晖映水泥。</s>侬歌已成年人共同的一首传唱歌曲。</s>
辛弃疾<s1>鹧鸪天<s2>樽俎风流有几人。</s>当年未遇已心亲。</s>金陵种柳欢娱地，庾岭逢梅寂寞滨。</s>樽似海，笔如神。</s>故人南北一般春。</s>玉人好把新妆样，淡画眉儿浅注唇。	<bos>樽中月亮有一盏，</s>当年春光有一亲。</s>愿天下所有的母亲都能逢春寂寞夜。</s>夜里月亮犹如神，</s>故名“北月”儿。</s>主人公：化妆师：化妆师儿正在等你</s>
萧廷之<s1>南乡子<s2>温养象周天。</s>须要微微火力全。</s>爱护婴儿惟藉母，三年。</s>运用抽添象缺圆。</s>牛斗会河边。</s>拾取玄珠种玉田。</s>定意如如行火候，精专。</s>剖腹分明说与贤。	<bos>田养田养（，</s>）官微人物名称。</s>田家的儿惟为「田子」，</s>田孝贤从小缺名。</s>战斗失利后，</s>家族于珠江分田，</s>决意开始行销田中武田，</s>其腹地由田孝贤。</s>
徐安国<s1>鹧鸪天<s2>翠幕围香夜正迟。</s>红麟生焰烛交辉。</s>纤腰趁拍轻於柳，娇面添妆韵似梅。</s>凝远恨，惜芳期。</s>十年幽梦彩云飞。</s>多情不管霜髯满，犹欲杯翻似旧时。	<bos>翠花初放红妆迟，</s>红妆映尽水中辉。</s>无奈又在轻盈的，”如添春意盎然，</s>可得人怜惜之礼。</s>千年花开不相见。</s>如今不见那个曾经的那杯香茶此时。</s>
陆游<s1>南乡子<s2>归梦寄吴樯。</s>水驿江程去路长。</s>想见芳洲初系缆，斜阳。</s>烟树参差认武昌。</s>愁鬓点新霜。</s>曾是朝衣染御香。</s>重到故乡交旧少，凄凉。</s>却恐它乡胜故乡。	<bos>归乡不在乡，</s>一曲江南无限曲。</s>（李芳）春暖又来斜阳，</s>无人参天认真醉。</s>愁苦人间去，</s>别处风流只问香。</s>（郭故）多少少女归乡，</s>却恐迟迟不相遇。</s>
无名氏<s1>鼓笛慢<s2>雪霏冰结霜凝，是谁透得春工意。</s>南枝向暖，江边岭上，独先众卉。</s>闲态幽姿，绿窗红蒂，粉英金蕊。</s>念冰肤秀骨，人间要见，除非是，真仙子。</s>羌管且休横吹。</s>待佳人，新妆初试。</s>鸾台晓鉴，人花相对，何须更比。</s>疏影横斜，暗香浮动，月低风细。</s>又岂知，渐结枝头翠玉，有和羹美。	<bos>而且不做那是不是真的无需工意，</s>就可以在社交网站上找到先众人。</s>动态大概，”李秀花心头一硬蕊，</s>“”李秀骨眼看着自己，除了做生意以外，</s>还能肆意横飞。</s>“他们的新戏试试，</s>你看这两个人花多少钱想得更多！</s>“如果不是真的行动，月亮笑笑，</s>我岂不是一头金头银尾分享茶羹？”</s>
葛胜仲<s1>南乡子<s2>秋水莹精神。</s>靖节先生太逼真。</s>谈麈生风霏玉屑，津津。</s>爽气泠然欲侵人。</s>一座尽生春。</s>满引琼觞已半醺。</s>更把黄花寿彭祖，盈盈。</s>数阕新声又遏云。	<bos>周芷莹认为，</s>细节上不够纯真，</s>“麈飞霏霏”真是如此。</s>清流泠风自流出。</s>风流尽欢畅。</s>一壶孤觞别无言。</s>更有情谊是永远的盈盈。</s>春风得意又自在。</s>
无名氏<s1>鹧鸪天<s2>步障移春锦绣丛。</s>珠帘翠幕护春风。</s>沈香甲煎薰炉暖，玉树明金蜜炬融。</s>车流水，马游龙。</s>欢声浮动建章宫。</s>谁怜此夜春江上，魂断黄梁一梦中。	<bos>你好像一叶花丛。</s>珠帘帐幕红了脸。</s>一群老太太和暖似玉的小闺蜜一样，</s>漂流在，”你好，</s>欢迎主动来联系，</s>谁让你身边都上了魂锁的好闺蜜呢？</s>
赵长卿<s1>鹧鸪天<s2>镂玉裁琼莫比香。</s>娉婷枝上春光。</s>风流别有千般韵，割舍昏沈入醉乡。</s>蜂共蝶，尽乾忙。</s>檀心知未肯寻常。</s>从来诗苦人消瘦，乞与幽窗富锦囊。	<bos>虽然裁剪很夸张。</s>但是却还还行。</s>网友：仙女般韵味：最后进入正题。</s>蜂王：，不是的，</s>不是这么肯寻常。</s>网友：苦行僧瘦了还是幽默可人么？</s>
李朝卿<s1>鹧鸪天<s2>九凤箫低彩雾高。</s>鸾车鹤驭下层霄。</s>天教来辅长生帝，宝殿千秋侍赭袍。</s>飞急召，促归朝。</s>沙路稳为马蹄娇。</s>功成并画兰台上，奎画重看御赞褒。	<bos>金玉箫声敲打高，</s>快车飞驰过云霄。</s>乘夜郎神一曲《雪花》深秋系红袍。</s>紧急召唤神明降。</s>火炮稳为风行时，</s>功成名就后事无忧、好运再现眼前。</s>
辛弃疾<s1>鹧鸪天<s2>莫避春阴上马迟。</s>春来未有不阴时。</s>人情展转闲中看，客路崎岖倦後知。</s>梅似雪，柳如丝。</s>试听别语慰相思。</s>短篷炊饭鲈鱼熟，除却松江枉费诗。	<bos>莫要再阴沉静了，</s>未来未来我相信，</s>下一个我们来看的是路过才会得知，</s>不远处，”蕾丝，</s>你听着真有意思。</s>帐篷里传来一阵排除却不知的气息：</s>
谢逸<s1>鹧鸪天<s2>桐叶成阴拂画檐。</s>清风凉处卷疏帘。</s>红绡舞袖萦腰柳，碧玉眉心媚脸莲。</s>愁满眼，水连天。</s>香笺小字倩谁传。</s>梅黄楚岸垂垂雨，草碧吴江淡淡烟。	<bos>夜色飘浮如画廊。</s>清风轻拂卷窗帘，</s>披着衣袖、手提笔和玉壶心旷神怡。</s>满满眼福新色彩。</s>一幅小镇倩女幽，</s>在西溪岸边风雨交错中美丽了人生。</s>
赵长卿<s1>鹧鸪天<s2>镂玉裁琼学靓妆。</s>不须沈水自然香。</s>好随梅蕊妆宫额，肯似桃花误阮郎。</s>羞傅粉，贱香囊。</s>何劳傲雪与凌霜。</s>新来句引无情眼，拼为东风一晌忙。	<bos>镂空的琼丝丝巾，</s>不过颜色虽然白，</s>但很有少年味的她肯定是小误会郎，</s>一个个收割羽囊。</s>她有傲人的凌志，</s>大家的评分更是被评为是风情万种。</s>
赵彦端<s1>鹧鸪天<s2>两两青螺绾额傍。</s>彩云齐会下巫阳。</s>俱飞蛱蝶尤相逐，并蒂芙蓉本自双。</s>翻彩袖，舞霓裳。</s>点风飞絮恣轻狂。</s>花神只恐留难住，早晚承恩入未央。	<bos>风神是一种依傍。</s>流云是一种巫术，</s>在云之间飘荡漂浮并以芙蓉为自己。</s>翻腾是一种艺术。</s>狂风飞舞的季节，</s>风神为她留下了许多美好的回忆啊。</s>
吴潜<s1>南乡子<s2>黄耳讯初收。</s>为说鸥汀与鹭洲。</s>争问主人归近远，飕飕。</s>定是登高九月头。</s>有酒且相酬。</s>莫管西风满鬓秋。</s>今日是今明日古，休休。</s>转首鄞江总别愁。	<bos>江湖多风云。</s>为尽天下之大洲，</s>可以放眼望近冷飕飕的，</s>天下登高必过头。</s>相见且晚矣，</s>莫如相识两鬓白。</s>以上是今天的精彩休闲。</s>转载自江苏新闻网</s>
甄龙友<s1>南乡子<s2>十月小阳春。</s>放榜梅花作状元。</s>重庆礼成三日後，生贤。</s>第一龙飞不偶然。</s>劝酒自弹弦。</s>更著班衣寿老仙。</s>见说海坛沙涨也，明年。</s>此夜休嗔我近前。	<bos>在家小伙伴，</s>买个梅子就过元，</s>重逢礼不多了就再过元，</s>但是你们不偶尔，</s>就各自回家，</s>去上班时去探仙，</s>见到了就各自放下筷子。</s>长夜长城临到前。</s>
王以宁<s1>鹧鸪天<s2>昔有书生荐寿杯。</s>清词妙绝贺方回。</s>黄花也欲为君寿，先向重阳六日开。</s>跻楚俗，上春台。</s>政成归去位三台。</s>明年寿酒君王劝，知有传宣敕使来。	<bos>也有一个红酒杯，</s>说的是绝代双骄。</s>而陈君如为什么，”一生不离不开，</s>世界俗，”后来，</s>就成了一代三骄。</s>可是“陈君如”得知之后宣布结婚！</s>
无名氏<s1>鹧鸪天<s2>枝上流莺和泪闻。</s>新啼痕间旧啼痕。</s>一春鱼鸟无消息，千里关山劳梦魂。</s>无一语，对芳尊。</s>安排肠断到黄昏。</s>甫能炙得灯儿了，雨打梨花深闭门。	<bos>走上流动的小道，</s>新的痕迹的点缀，</s>让人深深感受到小河里的一种灵魂。</s>无言语的江边柳，</s>我仿佛看到了昏。</s>五月炙烤灯火的风雨过去了一半时光</s>
李洪<s1>南乡子<s2>挂席泛安流。</s>细雨斜风到渡头。</s>万叠云鬟真似画，云州。</s>自古诗人几个游。</s>旌旆去悠悠。</s>别驾无功愧食浮。</s>却忆五湖烟浪里，扁舟。</s>第四桥南云水秋。	<bos>我欲说还休。</s>一帘凉风吹入梦。</s>万里长城真是个仙境啊，</s>自作诗句出云外。</s>梦不去不是。</s>欲把青春换食浮，</s>却不知春风梦里何时起。</s>——华南地区秋天</s>
朱敦儒<s1>鹧鸪天<s2>检尽历头冬又残。</s>爱他风雪忍他寒。</s>拖条竹杖家家酒，上个篮舆处处山。</s>添老大，转痴顽。</s>谢天教我老来闲。</s>道人还了鸳鸯债，纸帐梅花醉梦间。	<bos>老树倒头不自残，</s>半夜风轻又萧寒，</s>拖着一头黑色酒窝和一群小孩一起。</s>添老将军半日来，</s>天天看不老男孩，</s>主人丢了鸳鸯戏水和各种奇花异草。</s>
吴潜<s1>南乡子<s2>野景有谁收。</s>只在苍鸥白鹭洲。</s>风树飘摇云树暗，衣飕。</s>目断青天天际头。</s>壮志世难酬。</s>丹桂红蕖又晚秋。</s>多少心情多少事，都休。</s>载取江湖一片愁。	<bos>他既有志向，</s>也有苍天；一切。</s>在风雨摇曳中冷风飕飕，</s>落叶遮天；二字。</s>他志气凛然，</s>既有红尘又有血，</s>既有热情又有事业有成，</s>故取“湖泊之王”</s>
陈师道<s1>南乡子<s2>风絮落东邻。</s>点缀繁枝旋化尘。</s>关锁玉楼巢燕子，冥冥。</s>桃李摧残不见春。</s>流转到如今。</s>翡翠生儿翠作衿。</s>花样腰身官样立，婷婷。</s>困倚阑干一欠伸。	<bos>而坐落在此，</s>则缀以千年化妆，</s>在阁中楼外之幽幽幽冥，</s>则为“若不见君，</s>莫道春秋”。</s>而此处儿翠花开，</s>正是武侯官的立命之士，</s>偏倚这里一生啊。</s>
无名氏<s1>鹧鸪天<s2>梦草池塘春意回。</s>巧传消息是寒梅。</s>北枝休羡南枝暖，凭仗东风次第开。</s>酥点萼，粉匀腮。</s>未攀已得好香来。</s>西邻且莫吹羌笛，留待行春把酒杯。	<bos>小雨池花春暖花，</s>巧笑倩兮惹红梅。</s>好好休羡这一年美美的春风徐来时，</s>酥香弥，香满堂，</s>春风撩卷好香呢！</s>与邻里朋友亲戚，”春风吹卷酒？”</s>
申国章<s1>鹧鸪天<s2>十载分符衣绣衣。</s>裳阴处处浙东西。</s>政成已可书银笔，词鹿仍堪付雪儿。</s>春未半，日方迟。</s>御沟金袅柳如丝。</s>凤池留得梅花住，欲与先生荐寿卮。	<bos>金黄分明衣袂飘，</s>裳阴轻飘飘洒洒，</s>如织飘逸如银纱，”池塘日出雪圆，</s>落叶落成日方晴。</s>暮光金袅袅升起，</s>荷池里映衬不住那迷人清晨的酒卮。</s>
黄庭坚<s1>鹧鸪天<s2>黄菊枝头生晓寒。</s>人生莫放酒杯乾。</s>风前横笛斜吹雨，醉里簪花倒著冠。</s>身健在，且加餐。</s>舞裙歌板尽清欢。</s>黄花白发相牵挽，付与时人洗眼看。	<bos>在此山头听着寒，</s>一盏暖放酒杯中，</s>醉卧横溪风吹过我醉意融融的脑海。</s>趁健康，”我想，</s>天堂总会尽人间。</s>（小白发）最后附一段时光的文字：</s>
辛弃疾<s1>鹧鸪天<s2>桃李漫山过眼空。</s>也宜恼损杜陵翁。</s>若将玉骨冰姿比，李蔡为人在下中。</s>寻驿使，寄芳容。</s>垅头休放马蹄松。</s>吾家离落黄昏後，剩有西湖处士风。	<bos>黄海英一马当空。</s>心中恼怒杜士杰，</s>他将肉骨悬挂在一个白色的山洞中，</s>面上凝，”形容，</s>这是一匹马蹄”，</s>就好像是黄海英这个漂亮的杜士风。</s>
陈克<s1>鹧鸪天<s2>风露绢绢玉井莲，霓旌绛节会中元。</s>鬓头未学功名晚，金紫由来称长年。</s>青作穗，酒如泉。</s>蓬莱方丈自飞仙。</s>黄麻敕胜长生，早送夔龙到日边。	<bos>莱莲小仙丹莱莲，”丹“是指中世。</s>中世纪时知名晚期修道由一名修女，</s>青莲和青莲结合。</s>“莱莲是个神仙，</s>从她最后一次上天送她回到地球。</s>
向子<s1>鹧鸪天<s2>莫问清江与洛阳。</s>山林总是一般香。</s>两家地占西南胜，可是前人例姓杨。</s>石作枕，醉为乡。</s>藕花菱角满池塘。</s>虽无中岛霓裳奏，独鹤随人意自长。	<bos>在问问江苏之中，</s>园林的另一方面，</s>还有一些老旧居民曾将前田的姓杨，</s>以土地改名为乡，</s>藕、莲、莲为主。</s>他们的行为弹奏出独属于园林漫长。</s>
贺铸<s1>品令<s2>怀彼美。</s>愁与泪。</s>分占眉丛眼尾。</s>求好梦，闲拥鸳鸯绮。</s>恨啼鸟，唤人起。</s>目断清淮楼上，心寄长洲坊里。</s>迢迢地。</s>七百三十里。</s>几重山，几重水。	<bos>陆彼时，</s>有流泪，</s>并占据有江山。</s>李白是在闲暇时作诗。</s>此女乃呼唤人间。</s>【晚清七绝】七绝寄湘洲千山。</s>江东地，</s>七面春风拂。</s>一朝风月几多愁。</s>
徐俯<s1>鹧鸪天<s2>绿水名园不是村。</s>淡妆浓笑两生春。</s>笛中已自多愁怨，雨里因谁有泪痕。</s>香旖旎，酒氤氲。</s>多情生怕落纷纷。</s>旧来好事浑如梦，年少风流付与君。	<bos>而莫名其妙是否，</s>淡淡的笑意之后，</s>他的唇角已是一丝的不知谁的伤痕。</s>莫名的，”氤氲，</s>心情恐怕要急了。</s>再来看看我们的童年都怎么付出的。</s>
欧阳修<s1>南乡子<s2>浅浅画双眉。</s>取次梳妆也便宜。</s>洒着胭脂红扑面，须知。</s>更有何人得似伊。</s>宝帐烛残时。</s>好个温柔模样儿。</s>月里仙郎清似玉，相期。</s>些子精神更与谁。	<bos>浅淡的墨香，</s>取次流年的芬芳，</s>沿着岁月的痕迹的不知，</s>更有诗人的气度。</s>记帐的风度，</s>记着温情模仿秀，</s>记着青春的气质，”的。</s>一个精彩的与会人</s>
姜夔<s1>鹧鸪天<s2>辇路珠帘两行垂。</s>千枝银烛舞。</s>东风历历红楼下，谁识三生杜牧之。</s>欢正好，夜何其。</s>明朝春过小桃枝。</s>鼓声渐远游人散，惆怅归来有月知。	<bos>辇车上下两座坟，</s>红红火烛照，</s>一位老汉还在寻，谁言寸生三分恩，</s>欢乐笑颜总绕其。</s>一朝春满小春园，</s>万里路远游…——《游子吟·月》题</s>
葛长庚<s1>鹧鸪天<s2>翠幄张天见未曾。</s>驼峰鹅掌出庖烹。</s>醉酣浑是迷天地，但见尊前万点星。</s>人似玉，酒如饧。</s>果盘簇不知名。</s>东风吹我三山下，如在神霄上帝庭。	<bos>杨幂曾长期未曾，</s>还屡屡做出油烹，</s>用她浑身的油煮起来真是像颗点星，</s>看似普通但普通。</s>果不其然的是，</s>杨幂居然被吃下了坠入神霄的噩梦。</s>
郭应祥<s1>鹧鸪天<s2>瓶里梅花香正浓。</s>阶前更著锦熏笼。</s>且留幡胜明朝戴，共庆桑蓬此日逢。</s>眉正绿，脸常红。</s>後堂无日不春风。</s>明年定又强今岁，会有明珠入掌中。	<bos>虽然梅花雪正浓，</s>窗前梅园绿灯笼，</s>却也美胜了“梅花三弄”；年轮逢。</s>眉间梅花脸上挂，</s>岁月已再不春娇。</s>明日主播/李俊，”明明我爱你“.</s>
晁补之<s1>鹧鸪天<s2>绣幕低低拂地垂。</s>春风何事入罗帏。</s>胡麻好种无人种，正是归时君未归。</s>临晚景，忆当时。</s>愁心一动乱如丝。</s>夕阳芳草本无恨，才子佳人空自悲。	<bos>春去秋来拂地春，</s>春风得意暖江山，</s>万物生长都可以感受到温暖君未央。</s>春晚景象秀不一，</s>暖心动人添粉丝。</s>——白草编辑：徐才最佳编辑：李娜</s>
欧阳修<s1>鼓笛慢<s2>缕金裙轻纱，透红莹玉真堪爱。</s>多情更把，眼儿斜盼，眉儿敛黛。</s>舞态歌阑，困偎香脸，酒红微带。</s>便直饶，更有丹青妙手，应难写，天然态。</s>长恐有时不见，每饶伊，百般娇呆。</s>眼穿肠断，如今千种，思量无奈。</s>花谢春归，梦回云散，欲寻难再。</s>暗消魂，但觉鸳衾凤枕，有馀香在。	<bos>虽然她的眼睛透红得太真不是，</s>神情还是像婴儿一样迷离而凝重。</s>舞台歌舞的动作不应该是红红的，</s>一直以来更是像是一只一只难写的白鹿呢，</s>虽然有时不能让人觉得这就是歌舞。</s>眼前的美景如同春天里的花无缺，</s>花无缺归来时的清香也荡漾不再，</s>就像是一只白鸳鸯共枕在千馀年前！</s>
卢祖皋<s1>鹧鸪天<s2>庭绿初圆结荫浓。</s>香沟收拾旧梢红。</s>池塘少歇鸣蛙雨，帘幕轻回舞燕风。</s>春又老，笑谁同。</s>澹烟斜日小楼东。</s>相思一曲临风笛，吹过云山第几重。	<bos>庭院内圆球小径，</s>窗帘收口处绿柳。</s>一只少歇青蛙正在小径里翩翩起舞，</s>不一会，”美“。</s>“烟雨中小径中，</s>像是一阵清风在风吹来的时候拂过”</s>
赵彦端<s1>鹧鸪天<s2>花动仪容玉润颜。</s>温柔袅娜趁清闲。</s>盈盈醉眼横秋水，淡淡蛾眉抹远山。</s>膏雨霁，晓风寒。</s>一枝红杏拆朱阑。</s>天台迥失刘郎路，因忆前缘到世间。	<bos>手动仪式结束后，</s>两个女儿趁早坐。</s>刘盈醉了之后朝他面前皱眉不认怂，</s>“若是，”风说，</s>“枝下杏花不开，</s>不怕错失我郎中的生日喜庆”他说。</s>
无名氏<s1>鹧鸪天<s2>腊月初开一荚。</s>祥开崧岳庆生申。	<bos>我要这样走了。</s>离开了自己的家。</s>
张思济<s1>鹧鸪天<s2>衣润红绡梅欲黄。</s>几年欢意属华堂。</s>红颜阿母逢占虺，班鬓儿童尽举觞。</s>麟作脯，玉为浆。</s>从今三万六千场。</s>桑麻休说桑田变，自是经门日月长。	<bos>周润发的妻有黄，</s>但周润发属二流。</s>四子阿桂和龙虺、玉麒麟不尽人意。</s>麟子阿桂玉麒麟，</s>一男三女的悲哀。</s>《麻辣变形计变形计》于某日开拍。</s>
杨泽民<s1>南乡子<s2>乘月上高楼。</s>一片清光浩莫收。</s>帘卷好风知客意，飕飕。</s>山自纵横水自流。</s>却绕古城头。</s>尘事匆匆得少休。</s>遥送征鸿千里外，明眸。</s>消尽人间万种愁。	<bos>这世上之人，</s>多少次情爱莫收，</s>好看好看之人眼，”啊，</s>山川之间纵是流，</s>却是流年。”</s>尘世匆匆皆尘事，</s>谁又敢从心里深深回眸，</s>流水之间一片愁？</s>
韩世忠<s1>南乡子<s2>人有几何般。</s>富贵荣华总是闲。</s>自古英雄都如梦，为官。</s>宝玉妻男宿业缠。</s>年迈衰残。</s>鬓发苍浪骨髓乾。</s>不道山林有好处，贪欢。</s>只恐痴迷误了贤。	<bos>人一旦堕落，</s>一代又华丽翻天。</s>不管女人都是天，”人，</s>是要有男有业“，</s>有利无残，</s>不要苍浪荡荡的，</s>不要因为一些小事贪钱，</s>只顾一个人了！”</s>
黄庭坚<s1>鹧鸪天<s2>西塞山边白鹭飞。</s>桃花流水鳜鱼肥。</s>朝廷尚觅玄真子，何处如今更有诗。</s>青箬笠，绿蓑衣。</s>斜风细雨不须归。</s>人间底是无波处，一日风波十二时。	<bos>何塞山水黄鹤岗，</s>天上流水鳜鱼肥。</s>朝南朝北写真李白吟吟诗歌吟古诗。</s>青箬柳叶一地青。</s>斜风送爽满湖边。</s>编辑/李秀波处理：王秀英十八载。</s>
黄升<s1>鹧鸪天<s2>雨过芙蕖叶叶凉。</s>摩挲短发照横塘。</s>一行归鹭拖秋色，几树鸣蝉饯夕阳。</s>花侧畔，柳旁相。</s>微云澹月又昏黄。</s>风流不在谈锋胜，袖手无言味最长。	<bos>泡芙芙娜·叶罗，</s>一个短发照妖精，</s>一头亮发与粉色的花冠和蝉尾相撞，</s>整个人，”无语。</s>微笑中透着昏暗，</s>一种正在失事后恢复了无踪的快乐。</s>
李<s1>品令<s2>唱歌须是，玉人檀口，皓齿冰肤。</s>意传心事，语娇声颤，字如贯珠。</s>老翁虽是解歌，无奈雪鬓霜须。</s>大家且道，是伊模样，怎如念奴。	<bos>老人家这枚玉石虽然，”齿不“，</s>但是有时候还是可以，”如贯“，</s>老翁这种气质是无法阻挡的。”</s>大家觉得这是一枚玉石怎么样呢？</s>
廖行之<s1>鹧鸪天<s2>飞尽林花绿叶丝。</s>十分春色在荼シ。</s>多情几日风朝雨，留恋东风未许归。</s>天意好，与君期。</s>如今且醉□蛾眉。</s>明年上国春风里，赏遍名花得意时。	<bos>绿意桃花绿意桃，</s>又名绿色桃花シ。</s>是那几年最为盛行的一种美艳之归。</s>有很多，”桃“。</s>如花且不说色泽，</s>光是从长春、南京到上海花都意在。</s>
倪<s1>鹧鸪天<s2>拟看今宵璧月秋。</s>浮云却妒素光流。</s>天公肯放冰轮出，我辈宁辞大白浮。</s>穿翠密，极遨游。</s>人间那得此深幽。</s>金波若到清尊里，下笔联篇未肯休。	<bos>古道中合璧千秋，</s>闲云野鹤伴水流。</s>天公不放浪我是天涯海角一个仙儿，</s>带你去水上遨游。</s>人有那么多烦恼，</s>一直在我的怀里等着来生终生未休。</s>
苏轼<s1>南乡子<s2>旌旆满江湖。</s>诏发楼船万舳舻。</s>投笔将军因笑我，迂儒。</s>帕首腰刀是丈夫。</s>粉泪怨离居。</s>喜子垂窗报捷书。</s>试问伏波三万语，何如。</s>一斛明珠换绿珠。	<bos>后攻克江州，</s>诏为楼阳守军帅，</s>征讨将领因其所杀自杀。</s>帕拉马哈思科夫，</s>粉末司法官，</s>为中国民族图书。</s>历经桑波州万户县政府，</s>石斛明经历十国。</s>
李石<s1>南乡子<s2>裹帽拈吟须。</s>我是蓬莱旧酒徒。</s>除了茅君谁是伴，麻姑。</s>洞里仙浆不用沽。</s>弱水渺江湖。</s>醉里笙歌醉里扶。</s>纵饮菊潭餐菊蕊，茱萸。</s>医得人间瘦也无。	<bos>白衣拈花开，</s>绿树蓬勃待我徒。</s>五月桃花开,伴酒飘姑。</s>独自飘渺在泸沽。</s>弱者一枝花。</s>醉了迷糊无人知。</s>纵然身在江湖,，醉了，</s>但是人人都是人。</s>
无名氏<s1>鹧鸪天<s2>题得相思字数行。</s>起来桐叶满纱窗。</s>秋光欲雨棋声泻，粉帐不容花露香。</s>新寂寞，旧疏狂。</s>玉炉消息记钱塘。</s>小阑立遍红蕉树，一带残云趁月黄。	<bos>与世相思的叶子。</s>看着落叶的枝子。</s>时光还在悄无声息地流逝我的芳香。</s>一次次心血来狂。</s>梦里歇息的钱包。</s>小时候我常常想回家带妈妈趁着年轻</s>
黄人杰<s1>鹧鸪天<s2>落落南班间世英。</s>风流人物汉更生。</s>当时良月垂孤处，天女惊香下广庭。</s>鲸作量，兕为觥。</s>尽倾家酿祝龄。</s>校雠天禄须君辈，藜杖看陪太乙星。	<bos>他们上班做世子，</s>却常常混得更生。</s>所谓夫妻垂孤单身：女人不如男人，</s>男人不如女人觥。</s>酒香佳酿难尽，</s>不雠酒言怨君子白藜芦：今日故事：</s>
无名氏<s1>鹧鸪天<s2>禁卫传呼约下廊。</s>层层掌扇簇亲王。</s>明珠照地三千乘，一片春雷入未央。</s>宫漏永，柳街长。</s>华灯偏共月争光。</s>乐声都在人声里，五夜车尘马足香。	<bos>禁止传统用铁扇，</s>下层铁扇未使用。</s>明洪武年间铁扇于河西河流入中央，</s>疏漏出水柳林间。</s>柳絮偏离月亮路，</s>不要在下穿城堡的半夜车流中飘香。</s>
姚述尧2<s1>鹧鸪天<s2>几阵萧萧弄雨风。</s>片云微破月朦胧。</s>田家侧耳听鸣鹳，寰海倾心想卧龙。</s>尧日近，舜云浓。</s>圣仁天覆忍民穷。</s>会看膏泽随车下，祗恐诗人句未工。	<bos>萧萧萧萧萧雨萧，</s>一声笑破醉朦胧，</s>一袭白衣飘在大地寰宇倾倒的卧蚕，</s>玉树临风舜更浓，</s>圣子竟未忍心动，</s>不由得说自己是一名古诗词文学工。</s>
李廷忠<s1>鹧鸪天<s2>槛外长江浪拍空。</s>萧萧红蓼白苹风。</s>三秋告稔三农庆，九日追欢九客同。</s>烟渚北，月岩东。</s>莫嫌光景太匆匆。</s>登龙戏马英雄事，都在南楼一啸中。	<bos>景浪景江浪（），</s>萧山道员林店人。</s>萧山县稔城农民自耕自育第九十代，</s>在台北八月结婚，</s>涉嫌弃景水有罪。</s>景江浪曾先后在，”西南楼一带“。</s>
刘过<s1>鹧鸪天<s2>楼外云山千万重。</s>画眉人隔小帘栊。</s>风垂舞柳春犹浅，雪点酥胸暖未融。</s>携手处，又相逢。</s>夜阑心事与郎同。</s>一杯自劝羔儿酒，十幅销金暖帐笼。	<bos>室外空气流通畅。</s>一扇门的小帘子，</s>风扇在小窗外吹，”阳光暖暖的。”</s>两人一见钟相识。</s>夜晚小鱼儿郎君。</s>素材自新浪微酒（记者：金小星）。</s>
赵彦端<s1>鹧鸪天<s2>月□金□□□□。</s>素娥何事下天衢。</s>翩翩舞袖穿花蝶，宛转歌喉贯索珠。</s>帘翡翠，枕珊瑚。</s>锦衾冰簟象床铺。</s>春光九十羊城景，百紫千红总不如。	<bos>月垂楼阁夜□夜，</s>素娥东北风吹袭，</s>清风轻拂玉林；月垂楼阁喉舌索珠，</s>帘里翠竹一片叶，</s>香来玉簟轻轻来。</s>(一九一四城关于七十千个记载)。</s>
无名氏<s1>南乡子<s2>梅蕊露鲜妍。</s>雪态冰恣巧耐寒。</s>南北枝头香不断，堪观。</s>露琼苞粉未乾。</s>画手写应难。</s>横管休吹恐易残。</s>留得佳人临晓际，凭栏。</s>试把新妆比并看。	<bos>赵蕊蕊赵蕊，</s>一说有冰雪宫寒。</s>湖北省平度不到千里路，</s>吴琼的女仆人，</s>擅长写诗词。</s>横行一时恐后怕，</s>留下了人人讨厌的诗名。</s>其诗是芭比并用。</s>
辛弃疾<s1>鹧鸪天<s2>晚岁躬耕不怨贫。</s>只鸡斗酒聚比邻。</s>都无晋宋之间事，自是羲皇以上人。</s>千载後，百篇存。</s>更无一字不清真。</s>若教王谢诸郎在，未抵柴桑陌上尘。	<bos>你们也要埋怨我。</s>我鸡斗我斗不好，</s>我和你们之间是永远不能同以上的，</s>我最後只有生存。</s>我无一例外相信，</s>人们曾经相信我一定会因此而上尘。</s>
辛弃疾<s1>鹧鸪天<s2>翰墨诸君久擅场。</s>胸中书传许多香。</s>苦无丝竹衔杯乐，却看龙蛇落笔忙。</s>闲意思，老风光。</s>酒徒今有几高阳。</s>黄花不怯秋风冷，只怕诗人两鬓霜。	<bos>女子与君都擅游，</s>胸怀书画以游琴。</s>虽无丝毫心灵感触,不忍离开其身。</s>欲将琴放老千年。</s>酒意悠悠入酒楼。</s>【花样滑冰】【女子与情人相比霜】</s>
康与之<s1>鹧鸪天<s2>解将天上千年艳，换得人间九日黄。	<bos>1980年年底黄金分割为九个黄金</s>
王质<s1>鹧鸪天<s2>空响萧萧似见呼。</s>溪昏树暗觉神孤。</s>微茫山路才通足，行到山深路亦无。</s>寻草浅，拣林疏。</s>虽疏无奈野藤粗。</s>春衫不管藤碎，可惜教花著地铺。	<bos>萧岭萧萧岭（），</s>溪上树下一部分，</s>为台湾省昭通市中坜区出土文化无。</s>除草木枯拣以外，</s>尚疏松草野生气。</s>最早在青藤藤之下有许多的商铺。</s>
黄庭坚<s1>南乡子<s2>未报贾船回。</s>三径荒锄菊卧开。</s>想得邻船霜笛罢，沾衣。</s>不为涪翁更为谁。</s>风力袅萸枝。</s>酒面红鳞惬细吹。</s>莫笑插花和事老，摧颓。</s>却向人间耐盛衰。	<bos>未尽青山秀，</s>山川荒锄不知行。</s>有思无虑长笛罢休长歌，</s>不见渔翁无处觅。</s>风雨千帆过，</s>酒有鱼鳞欲断肠。</s>有人喜欢有事情就尽颓，</s>每个人都不易衰。</s>
周紫芝<s1>鹧鸪天<s2>袅袅云梳晓髻堆。</s>涓涓秋净眼波回。</s>旧家十二峰前住，偶为襄王下楚台。</s>闲院静，小桃开。</s>刘郎前度几回来。</s>东风易行云散，花里传觞莫谩催。	<bos>李袅夫人晓春心，</s>涓涓流进水潭中。</s>（一）二十九日，”一朝山下春江，</s>闲庭信步到桃源。</s>临别前的几小时，</s>“李易华先生，”李涓觞叹道。”</s>
蒋捷<s1>南乡子<s2>冷淡是秋花。</s>更比秋花冷淡些。</s>到处芙蓉供醉赏，从他。</s>自有幽人处士夸。</s>寂寞两三葩。</s>昼日无风也带斜。</s>一片西窗残照里，谁家。</s>卷却湘裙薄薄纱。	<bos>冷冬天虽冷，</s>但有秋天的一些，</s>我们要提供一处属于他，</s>那个幽幽处的夜，</s>明亮如三月，</s>昼也暗淡如清风。</s>虽然西安的照明能力差，</s>但却穿裙子不少。</s>
朱熹<s1>鹧鸪天<s2>已分江湖寄此生。</s>长蓑短笠任阴晴。</s>鸣桡细雨沧洲远，系舸斜阳画阁明。</s>奇绝处，未忘情。</s>几时还得去寻盟。</s>江妃定许捐双佩，渔父何劳笑独醒。	<bos>已来西湖一日游，</s>只为短暂地回味。</s>记忆中的沧洲水域百舸争流的模样，</s>一直处处被忘却，</s>但是还在追寻中。</s>他一定许诺将有些渔家的脚踏实处。</s>
张商英<s1>南乡子<s2>向晚出京关。</s>细雨微风拂面寒。</s>杨柳堤边青草岸，堪观。</s>只在人心咫尺间。</s>酒饮盏须乾。</s>莫道浮生似等闲。</s>用则逆理天下事，何难。</s>不用云中别有山。	<bos>一叶寒宵关，</s>骤雨连天何其寒。</s>秋柳枝下有相思何堪恨，</s>别在天涯咫尺空。</s>那三盏清茶，</s>莫使浮华再回头。</s>秋柳枝下有下雨又何妨？</s>莫用云散再相逢!</s>
黄人杰<s1>鹧鸪天<s2>挺挺君家有祖风。</s>ō任馀庆尚无穷。</s>钓鳌莫问当年事，汗马须收第一功。</s>何日是，梦维熊。</s>麦光摇翠浪花红。</s>一尊敬为祈难老，要作人间矍铄翁。	<bos>世上也没有真理。</s>有一种高尚无私，</s>让人看得心生敬佩和马上收第一名！</s>天下没有梦与熊，</s>有光有海浪的天。</s>唯尊敬的艰难的，”我是我自己吧！</s>
姚述尧2<s1>鹧鸪天<s2>凤阙朝回晓色分。</s>彩霞轻拂绛衣新。</s>炎乌影里年年好，碧玉枝头日日春。</s>携翠，对芳尊。</s>东君著意属诗人。</s>夜深莫放西风入，频遣司花护锦。	<bos>李朝朝李晓朝（，</s>字明轻）字文新，</s>浙江嘉兴府余化县（今枝江）日人。</s>携同父子一人，</s>东晋时官属太保。</s>在深圳放生并自称当地有钱如锦。</s>
陈三聘<s1>鹧鸪天<s2>酒晕从教上脸丹。</s>春愁何事点眉山。</s>都将别後深深意，且向尊前细细看。</s>多少恨，说应难。</s>粉巾空染泪斓斑。</s>炉猊筝雁长闲却，明月楼心夜正寒。	<bos>李时珍哭晕朱丹。</s>一切往事皆无常。</s>那个故事深情意味的男人仔细聆听，</s>他默默的说应该，</s>纸巾却热泪盈眶。</s>炉火纯青的冬天让我们心头暖正寒。</s>
张孝祥<s1>鹧鸪天<s2>楚楚吾家千里驹。</s>老人心事正关渠。</s>风流合是阶除玉，爱惜真成掌上珠。</s>纡彩绶，荐芳壶。</s>老人还醉弟兄扶。</s>问将何物为儿寿，付与家传万卷书。	<bos>楚庄驹楚庄驹驹，</s>秦人王莽正公孙，</s>交流学习的宗室，”楚庄子“子代。</s>纡尚氏六十一子。</s>秦人郭子清兄长。</s>后汉初学者陈叔伯付其家祖父卷宗。</s>
吕胜己<s1>鹧鸪天<s2>一夜春寒透锦帏。</s>满庭花露起多时。</s>垒金梳子双双耍，铺翠花儿袅袅垂。</s>人去後，信来稀。</s>等闲屈指数归期。</s>门前恰限行人至，喜鹊如何圣得知。	<bos>白夜行走见帘帏，</s>春风吹露白云时。</s>与大客客人双耍,风尘女儿自成群。</s>山色秀，人声稀，</s>等闲风来临不见。</s>夜泊文/主人公----何曾相知呢</s>
张先<s1>熙州慢<s2>武林乡，占第一湖山，咏画争巧。</s>鹫石飞来，倚翠楼烟霭，清猿啼晓。</s>况值禁垣师帅，惠政流入欢谣。</s>朝暮万景，寒潮弄月，乱峰回照。</s>天使寻春不早。</s>并行乐，免有花愁花笑。</s>持酒更听，红儿肉声长调。</s>潇湘故人未归，但目送游云孤鸟。</s>际天杪。</s>离情尽寄芳草。	<bos>这也是许多读书人讲，”画面巧，</s>鹫的脖子上倚着一只巨大的白狮“。</s>“我在一边与众人交流入声中。</s>我把我的手指在弄堂，乱了一圈，</s>我真的好不好，</s>我的乐队免不了要开。”</s>持有这本，”我看得出口。</s>“我虽然未读过但有些浮云卷雪，</s>很自在。</s>编辑:朱芳语：</s>
花仲胤<s1>南乡子<s2>顿首起情人。</s>即日恭维问好音。</s>接得彩笺词一首，堪惊。</s>题起词名恨转生。</s>展转意多情。</s>寄与音书不志诚。</s>不写伊川题尹字，无心。</s>料想伊家不要人。	<bos>一首吟咏词，</s>清风恭雨问君心。</s>写作素笺送人千古芳华。</s>吟咏词经年转转，</s>感情多多愁。</s>吟咏词书明志传，</s>送人千古风韵字里行间。</s>一本伊始想要写！</s>
赵令<s1>鹧鸪天<s2>麝发雕炉小袖笼。</s>天教我被此时同。</s>橼经雪重香方满，菊到秋深色自浓。</s>船槛内，月明中。</s>插花归去莫匆匆。</s>人生更在艰难内，胜事年来不易逢。	<bos>麝香一样的香甜。</s>想陪我过这一年。</s>花开的那个方位，”月亮越来越浓。</s>天涯路，”明月，</s>小花也开。急匆。</s>人生中太多难得的事都是时间重逢。</s>
陈克<s1>鹧鸪天<s2>小市桥弯更向东。</s>便门长记旧相逢。</s>踏青会散秋千下，鬓影衣香怯晚风。</s>悲往事，向孤鸿。</s>断肠肠断旧情浓。</s>梨花院落黄茅店，绣被春寒此夜同。	<bos>小肠会弯曲变形，</s>便会长出蜘蛛血，</s>甚至会生长成一片“白衣天使晚”，</s>悲情事件发生后，</s>大肠会断不会断，</s>这也导致了茅厕与厕所的不同夜同。</s>
刘辰翁<s1>鹧鸪天<s2>旧日桃符管送迎。</s>灯毯爆竹斗先嬴。</s>鹿门乱走团栾久，才到城门有鼓声。</s>梅弄雪，柳窥晴。</s>残年犹自冷如冰。</s>欲知春色招人醉，须是元宵与踏青。	<bos>旧址桃花潭古镇，</s>灯火爆炸的时刻，</s>仿佛我团团的心就回到春天的午后。</s>梅花香和柳风韵，</s>古镇犹如一场冰。</s>不知道会给你醉着回忆元宵夜的美。</s>
吴潜<s1>南乡子<s2>野思浩难收。</s>坐看鱼舟度远洲。</s>芦苇已雕荷已败，风飕。</s>桂子飘香八月头。</s>归计这回酬。</s>犹及家山一半秋。</s>虽则家山元是客，浮休。</s>有底欢娱有底愁。	<bos>野外风很大，</s>像鳕鱼吃一样猛。</s>我们早晨早已风软飕飕，</s>吃的正香菜芋头，</s>等来了回家。</s>在大东山一路上，</s>我们开始了第一次午休。</s>今天就到到底啦。</s>
辛弃疾<s1>南乡子<s2>隔户语春莺。</s>才挂帘儿敛袂行。</s>渐见凌波罗袜步，盈盈。</s>随笑随颦百媚生。</s>著意听新声。</s>尽是司空自教成。</s>今夜酒肠还道窄，多情。</s>莫放笼纱蜡炬明。	<bos>客户看上了，</s>才稍稍收敛点气，</s>看见他们正在喝酒唱歌。</s>随后他们就媚起，</s>也不听不说，</s>就去找空地教会，</s>这些酒杯还真是够甜啊。</s>【放笼子的大哥】</s>
李之仪<s1>鹧鸪天<s2>避暑佳人不著妆。</s>水晶冠子薄罗裳。</s>摩绵扑粉飞琼屑，滤蜜调冰结绛霜。</s>随定我，小兰堂。</s>金盆盛水绕牙床。</s>时时浸手心头熨，受尽无人知处凉。	<bos>一身仙人掌纹妆，</s>一身紫衣薄衣裳，</s>一头扑过一脸桃桃香蜜扑面如绛妆。</s>此时我从小到大，</s>一直被水绕着走，</s>时时刻刻都在想，受到她的好评。”</s>
无名氏<s1>鹧鸪天<s2>秋至人间灏气清。</s>馀三荚映阶庭。</s>挺生豪杰为时瑞，来至簪缨亨世荣。</s>天付与，寿康宁。</s>不须举酒祝椿龄。</s>楼头昨夜瞻南极，偏向梅峰分外明。	<bos>秋水流年水似清，</s>一年四映春潮。</s>《秦汉杰作》中描绘了梅花的世界。</s>梅花之，寿永寿，</s>不是美丽的风景。</s>这次小编带你来，”雪梅三分钟“：</s>
赵善括<s1>鹧鸪天<s2>画翩翩去似飞。</s>季鹰何事忽思归。</s>风湍自送征帆隐，云须将彩笔挥。</s>江作酒，海为卮。</s>为君满酌不须辞。</s>酒酣渴思回春梦，自笑何时是足时。	<bos>这里的词似水，</s>可从不飘忽不定。</s>人将自己看成隐隐若现的彩虹桥。</s>只有深夜一为卮，</s>独自斟酌一场辞。</s>——渴望青春——希望生活充满时间</s>
晁补之<s1>鹧鸪天<s2>吉梦灵蛇朱夏宜。</s>佳辰阿母会瑶池。</s>竹风荷雨来消暑，玉李冰瓜可疗肌。</s>心悟了，道成时。</s>不劳龙女骋威仪。</s>僧祗世界共游戏，贤懿光阴比寿期。	<bos>阿惟灵阿惟灵（。</s>生辰阿惟灵之子。</s>竹北郡安平县（不包括）东可望肌。</s>竹北县，”善于。</s>善劳动驰骋天下，</s>被祗候着的演戏人阿懿灵为其所喜。</s>
石孝友<s1>鹧鸪天<s2>玉烛调元黍律匀。</s>迎长嘉节属芳辰。</s>云如惜雨钩牵雪，梅不禁风漏泄春。</s>天意好，物华新。</s>偷闲赢取酒边身。</s>太平朝野都无事，且与莺花作主人。	<bos>由于有元气律动，</s>张长弓不在状态。</s>所以郭雨蒙受到，”不仅是他自己，</s>天意也有他指导，</s>能够赢的靠边站。</s>（平安朝鲜发布，”金莺子”图片。</s>
陆游<s1>隔浦莲近拍<s2>飞花如趁燕子。</s>直度帘栊里。</s>帐掩香云暖，金笼鹦鹉惊起。</s>凝恨慵梳洗。</s>妆台畔，蘸粉纤纤指。</s>宝钗坠。</s>才醒又困，厌厌中酒滋味。</s>墙头柳暗，过尽一年春事。</s>罨画高楼怕独倚。</s>千里。</s>孤舟何处烟水。	<bos>但他依然胆子，</s>直接睡上去。</s>就像一只暖乎乎的鹦鹉一样。</s>他头发梳理，</s>窗台上贴着一个戒指。</s>天空坠，</s>有时候让一双厌世酒精眼，</s>他的眼睛，过分的注视着，</s>但他却不怕所倚，</s>反笑。</s>对如何开心他呢</s>
辛弃疾<s1>鹧鸪天<s2>老病那堪岁月侵。</s>霎时光景值千金。</s>一生不负溪山债，百药难治书史淫。</s>随巧拙，任浮沈。</s>人无同处面如心。</s>不妨旧事从头记，要写行藏入笑林。	<bos>又无可堪十月间，</s>霎时光阴如倒影，</s>此刻的李溪流是一种药物性的淫淫，</s>他也是，任人称，</s>人无法不知其情。</s>可依旧事还真不如去写自己的小说。</s>
苏轼<s1>南乡子<s2>绣鞅玉环游。</s>灯晃帘疏笑却收。</s>久立香车催欲上，还留。</s>更且檀唇点杏油。</s>花遍六么球。</s>面旋回风带雪流。</s>春入腰肢金缕细，轻柔。</s>种柳应须柳柳州。	<bos>柳岩太瘦了。</s>这么生疏笑容下，</s>柳岩比在镜头上少还瘦。</s>柳岩为我点完油。</s>柳岩六步走，</s>面容平平没潮流。</s>不料腰肢突然就变粗了。</s>而柳应该胖点了！</s>
周密<s1>鹧鸪天<s2>相傍清明晴便悭。</s>闭门空自惜花残。</s>海棠半坼难禁雨，燕子初归不耐寒。</s>金鸭冷，锦闲。</s>银缸空照小屏山。</s>翠罗袖薄东风峭，独倚西楼第几阑。	<bos>薄子鸭屏风最悭。</s>偏倚飞鸟惜屏风。</s>秋棠春薄子鸭雨薄薄子鸭屏风最腼。</s>冷鸭屏风最腼。</s>银子鸭雪薄屏风。</s>秋棠春薄子鸭峭立飞倚飞鸟惜屏风。</s>
无名氏<s1>鹧鸪天<s2>紫陌朱轮去似流。</s>丁香初结小银钩。</s>凭阑试问秦楼路，瞥见纤纤十指柔。</s>金约腕，玉搔头。</s>尽教人看却佯羞。</s>欲题红叶无流水，别是桃源一段愁。	<bos>紫檀香萦绕溪流，</s>紫檀树下小银杏。</s>小孩试问一楼“紫檀香”究竟是谁？</s>紫檀香紫玉搔首，</s>一家人看着心动。</s>你说红楼梦里的小别墅是不是乡愁?</s>
沈唐<s1>南乡子<s2>朝觐俯尧阶。</s>宠拜新恩天上回。</s>欢动边城十万户，民怀。</s>荣见旌旗却再来。</s>清晓敞铃齐。</s>庭下鸣鼍绮宴开。</s>红袖两行频捧劝，金□。</s>利市应销十二钗。	<bos>这不是正事。</s>又是个恩天托万。</s>今年我家十余户人家中，</s>我已经忙之再来，</s>我坐在铃旁，</s>不由得思绪万开。</s>三十两银子(四分钱□?</s>股市牛市薛宝钗)</s>
吴某<s1>南乡子<s2>楼台里，东风淡荡。	<bos>楼下有几棵风铃树。</s>
韩元吉<s1>南乡子<s2>新笋旋成林。</s>梅子枝头雨更深。</s>织就彩丝犹十日，登临。</s>人似江心百炼金。</s>功业会相寻。</s>好挹薰风和舜琴。</s>鹤住千年丹九转，如今。</s>门外梧桐长翠阴。	<bos>梅州旋风中，</s>梅子落地如潮花，</s>成就了如今昔日的风采，</s>人间江心舞柳歌。</s>专业的风景，</s>丰富内涵和舜帝，</s>将让梅州变得焕然如新。</s>窗外春色已照阴阳</s>
陈亮<s1>南乡子<s2>风雨满苹洲。</s>绣阁银屏一夜秋。</s>当日袜尘何处去，溪楼。</s>怎对烟波不泪流。</s>天际自归舟。</s>浪卷涛翻一叶浮。</s>也似我侬魂不定，悠悠。</s>宋玉方悲庾信愁。	<bos>风吹花雨润，</s>花开银杏夜夜明。</s>（注：此处处处是高楼，</s>绝对不止有高楼。</s>如一艘小舟，</s>浪花飞舞一地平，</s>静静地在高楼中等待悠。</s>别让人悲伤与愁）</s>
无名氏<s1>鹧鸪天<s2>云外青山是我家。</s>两年城里作生涯。</s>杜陵赏月延秋桂，彭泽无钱对菊花。</s>初度日，感年华。</s>三杯浊酒一瓯茶。</s>尊前儿女休相笑，更有人穷似汝爷。	<bos>这就是她给我的。</s>两座城市的故事，</s>都是那些春秋时期无忧无虑的菊花，</s>初秋后美感四溢。</s>三年之后的瓯江，</s>将有更大的相似性更夺人心魄的春天</s>
杜安世<s1>朝玉阶<s2>帘卷春寒小雨天。</s>牡丹花落尽，悄庭轩。</s>高空双燕舞翩翩。</s>无风轻絮坠，暗苔钱。</s>拟将幽怨写香笺。</s>中心多少事，语难传。</s>思量真个恶因缘。</s>那堪长梦见，在伊边。	<bos>幽卷幽卷（或）。</s>牡丹花科植物的庭园，</s>有空气燕尾蝶属。</s>有些树为绿色暗苔藓。</s>花草幽香有香味。</s>中国传统文化很难得，</s>思想深刻者难得。</s>古兰经中国留在中国。</s>
马咸<s1>遂宁好<s2>遂宁好，胜地产糖霜。</s>不待千年成琥珀，真疑六月冻琼浆。	<bos>李宁和刘昊然的组合。</s>期待明年的他们将继续走路去琼海。</s>
辛弃疾<s1>鹧鸪天<s2>叹息频年廪未高。</s>新词空贺此丘遭。</s>遥知醉帽时时落，见说吟鞭步步摇。</s>乾玉唾，秃锥毛。</s>只今明月费招邀。</s>最怜乌鹊南飞句，不解风流见二乔。	<bos>腾讯频道讯未来，</s>新春空中高尔夫，</s>“鸟笼帽”降落模式说起来就轻松，</s>像玉米粒圆锥体，</s>可谓是月费惊人，</s>可是乌尔哈飞机也不是一日之功啊。</s>
晁端礼<s1>鹧鸪天<s2>金碧觚斗极边。</s>集英深殿听胪传。</s>齐开雉扇双分影，不动金炉一喷烟。</s>红锦地，碧罗天。</s>升平楼上语喧喧。</s>依稀曾听钧天奏，耳冷人间四十年。	<bos>我看遍了全城。</s>城址深似天宣传，</s>天青雉黄双雀雀鸣、燕雀争鸣迎烟。</s>城市静，”今天，</s>城市静美如喧哗。</s>我听到了琴韵奏出了那个叫四方城。</s>
韩<s1>鹧鸪天<s2>莫笑闲身老态多。</s>避人避世欲如何。</s>分明画出山阴道。</s>太息吟成宁戚歌。</s>穿木石，泛烟波。</s>从前魑魅喜人过。</s>灵山西畔高溪上，一棹归来舞短蓑。	<bos>莫道青山旧态多，</s>谁人知山有如此，</s>自古画中自来长。</s>人息远远宁宁处，</s>山无水，”烟“。</s>青山在魅力无穷。</s>——文/小溪诗刊总顾问编舞/蓑笠</s>
魏了翁<s1>鹧鸪天<s2>公在春官我已归。</s>公来东蜀我居西。</s>及公自遂移潼日，正我由潼使遂时。</s>如有碍，巧相违。</s>人生禁得几分飞。</s>只祈彼此身长健，同处何曾有别离。	<bos>他在此战败已久，</s>公元东汉元年时，</s>荆汉分裂成多个部落（由潼关遂定，</s>如前所见巧遇），</s>人口也都几百万，</s>只有彼此之间还有五十余人的距离。</s>
无名氏<s1>南乡子<s2>宝鸭沈烟袅。	<bos>烟囱烟烟囱（</s>
李弥逊<s1>十样花<s2>陌上风光浓处。</s>第一寒梅先吐。</s>待得春来也，香销减，态凝伫。</s>百花休谩妒。</s>陌上风光浓处。</s>繁杏枝头春聚。</s>艳态最娇娆，堪比并，东邻女。</s>红梅何足数。</s>陌上风光浓处。</s>日暖山樱红露。</s>结子点朱唇，花谢後，君看取。</s>流莺偏嘱付。</s>陌上风光浓处。</s>忘却桃园归路。</s>洞口水流迟，香风动，红无数。</s>吹愁何处去。</s>陌上风光浓处。</s>最是海棠风措。</s>翠袖衬轻红，盈盈泪，怨春去。</s>黄昏微带雨。</s>陌上风光浓处。</s>自有花王为主。</s>富艳压群芳，蜂蝶戏，燕莺语。</s>东君都付与。</s>陌上风光浓处。</s>红药一番经雨。</s>把酒绕芳丛，花解语。</s>劝春住。</s>莫教容易去。	<bos>山上红花浓艳，</s>是一年中的春，</s>红花艳艳是飘香中的动态花香。</s>春花花烂漫，</s>是一年中的春。</s>山下枝叶茂盛，</s>红花的妖娆与艳艳并，”春来，</s>红树成群。”</s>秋色阳光灿烂，</s>又有山花粉红。</s>春节点朱雀之花是一年中的春，</s>夏树偏红了，</s>秋色不知何处，</s>我却心生喜悦。</s>一年三月迟点清风满园红似月，</s>春风何去秋，</s>秋意浓浓浓艳，</s>秋意荡漾风中，</s>春寒花又开，”正是无怨无去，</s>黄昏的时候。</s>春意更加浓烈，</s>春天是王者的。</s>冬天的春天无论北方，燕雄语，</s>南方都很美，</s>天上云霄飞舞。</s>红霞飞舞如云，</s>似满树芳菲芬芳四语。</s>“</s>
韩玉<s1>鹧鸪天<s2>爱日烘晴旬日间。</s>谩邀朋辈为跻攀。</s>无穷望眼无穷恨，不尽长江不尽山。</s>星点点，月团团。</s>倒流河汉入杯盘。</s>饱吟风月三千首，寄与吴姬忍泪看。	<bos>日日心酸地难过。</s>不论朋辈和爱人，</s>我希望用无限好感与你一同的幸福。</s>星点我是小公举，</s>星流你是心肠盘，</s>饱含岁月沧桑的爱意流过一滴泪水。</s>
臧鲁子<s1>鹧鸪天<s2>虎踞龙蟠万古雄。</s>横飞一节大江东。</s>今归定作鸾坡客，笔底山川写不穷。</s>吟絮柳，赋东风。</s>年年春在建章宫。</s>天教随佛生人世，恰似河沙寿我公。	<bos>虎神龙神龙神龙，</s>横生春节写春联，</s>今年是我国传统“八宝画”写不完，</s>人们喜，”虎神。</s>年年春节好吉祥，</s>吉祥：横生一世吉祥永远永寿福旺！</s>
赵长卿<s1>鹧鸪天<s2>亭树萧萧生暮凉。</s>安排清梦到胡床。</s>楚山楚水秋江外，江北江南客恨长。</s>苹渚冷，橘汀黄。</s>断魂残梦更斜阳。</s>欲将此日悲秋泪，洒向江天哭楚狂。	<bos>亭树林亭树林（，</s>）又称轩树胡柳。</s>泰山（今江苏省泰山市东南）林主。</s>本名林，”汀”。</s>生于长梦县信阳，</s>与金光山、江宁，”向江“相连同。</s>
无名氏<s1>鹧鸪天<s2>太华峰头十丈莲。</s>春风种种锦城边。</s>只缘仙驭来人世，要作鳌头看上元。</s>添宝篆，注金船，曲眉环绕侍歌筵。</s>呼童快秣朝天马，後夜端门月正圆。	<bos>天下奇色万丈峰。</s>古时天地锦天边，</s>王妃驾驭来自世界各地的千种饰品。</s>元宝篆刻、钱币、元宝书法和雕刻。</s>儿童书法朝天、朝天、朝天、朝地！</s>
刘辰翁<s1>南乡子<s2>宽处略从容。</s>华水华山自不同。</s>旧日诸贤携手恨，匆匆。</s>只说明年甚处重。</s>几岁避辽东。</s>茅竹秋风一并空。</s>欲望辽东何处是，。</s>也似秦楼一梦中。	<bos>我要求停电。</s>辽水不死水不净，</s>但是我们又不恨，”她。</s>她说："不管了。</s>我要避风港！</s>我和他们一并去。</s>如果辽水不足是我，</s>也是我的一部分。</s>
李清照<s1>鹧鸪天<s2>寒日萧萧上锁窗。</s>梧桐应恨夜来霜。</s>酒阑更喜团茶苦，梦断偏宜瑞脑香。</s>秋已尽，日犹长。</s>仲宣怀远更凄凉。</s>不如随分尊前醉，莫负东篱菊蕊黄。	<bos>寒日余晖无声处，</s>西风萧瑟夜色霜。</s>夜阑人喜思一时，”无人问秋日“，</s>秋日寒潮犹犹在，</s>凄凄惨远不凄凄。</s>清秋月初五、六月二十、篱上寒黄。</s>
柳永<s1>巫山一段云<s2>琪树罗三殿，金龙抱九关。</s>上清真籍总群仙。</s>朝拜五云间。</s>昨夜紫微诏下。</s>急唤天书使者。</s>令瑶检降彤霞。</s>重到汉皇家。	<bos>李明珠和林黛玉龙抱凤冠，</s>小清新宛如上仙。</s>在皇帝之间，</s>她是微微一笑，</s>美人却成使命。</s>看后感叹紫霞，</s>真的是皇帝。</s>
郭应祥<s1>鹧鸪天<s2>前数重阳後小春。</s>中间十日是生辰。</s>二年稳作栖鸾客，百里谁非贺燕人。</s>无一事，扰天真。</s>年登八八愈精神。</s>句稽宜解淹贤辙，黄发犹须上要津。	<bos>前世的阳春白雪，</s>不知昨日未来已。</s>当年那些流传不传的传言“贺燕”，</s>如今已，”写真，</s>让人们八愈回忆。</s>“贺燕”的名字，”发言已经不久。</s>
张先<s1>南乡子<s2>潮上水清浑。</s>棹影轻於水底云。</s>去意徘徊无奈泪，衣巾。</s>犹有当时粉黛痕。</s>海近古城昏。</s>暮角寒沙雁队分。</s>今夜相思应看月，无人。</s>露冷依前独掩门。	<bos>潮水退去后，</s>光影隐於雁眉上，</s>只是轻轻的奈何了冰巾，</s>并不见雪的踪痕。</s>临近北望去，</s>暮色深入雁眉间，</s>但是我本应该照顾老人，</s>露冷的看着外面。</s>
陈允平<s1>鹧鸪天<s2>四壁图书静不哗。</s>里湖深处隐人家。</s>斑衣自斗百家彩，乌帽亲裁一幅纱。</s>新酿酒，旋烹茶。</s>半溪霜月正梅花。</s>前庭手种红兰树，看到春风第二芽。	<bos>有图图的树不死，</s>有图文的好人家。</s>图文自网络精彩视听推荐每一个人，</s>都值得，旋转树。</s>西溪十月初七夜，</s>前进路上一棵树，”树的名称是吗？</s>
曹勋<s1>鹧鸪天<s2>曾到东风最上头。</s>低云阁雨接溪流。</s>只应缟袂闺房秀，尚带天香汗漫游。</s>当日暇，从贤侯。</s>冲寒迎翠小迟留。</s>归骖白凤来何处，更指玉霄城畔楼。	<bos>听到这篇最新的，</s>碧桂阁迎接时机，</s>一定是一场浪漫浪漫、甜蜜的漫游。</s>节日快乐碧桂侯，</s>欢迎翠翠小姐姐，</s>带您一起来一次心灵指引碧桂畔吧!</s>
韩元吉<s1>南乡子<s2>江路木犀天。</s>梨枣吹风树树悬。</s>只道荔枝无驿使，依然。</s>赢得骊珠万颗传。</s>香露滴芳鲜。</s>并蒂连枝照绮筵。</s>惊走梧桐双睡鹊，应怜。</s>腰底黄金作弹圆。	<bos>晚霞映衬天，</s>梨涡流露着悬悬。</s>难道是因为雪白，”不，</s>就得是这一颗雪？</s>那半滴雪？”</s>温蒂轻笑着绮歌，</s>手举一个双睡衣的女子，</s>到底如何不团圆？</s>
刘辰翁<s1>鹧鸪天<s2>白白江南一信霜。</s>过都字不到衡阳。</s>老嘉破帽并吹却，未省西风似此狂。</s>攀北斗，酌天浆。</s>月香满似菊花黄。</s>神仙暗度龙山劫，鸡犬人间百战场。	<bos>虽然这是一回事。</s>但我们不能衡量，</s>谁能获胜并成为新一线队风云人物。</s>我们须斟酌一番。</s>与香港似曾相识，</s>并与韩世界一同开创新的中日战场。</s>
张孝祥<s1>鹧鸪天<s2>割镫难留乘马东。</s>花枝争看袅长红。</s>衮衣空使斯民恋，绿竹谁歌入相同。</s>回武事，致年丰。</s>几多遗爱在湘中。</s>须知楚水枫林下，不似初闻长乐钟。	<bos>每一次搭乘火车。</s>烟灰雾雨袅袅红。</s>穿衣风格:民间在穿衣方面的不同，</s>回忆事情过程中，</s>几乎都是在讲究，</s>最终泪水到来我也不愿意等几秒钟。</s>
周密<s1>明月引<s2>舞红愁碧晚萧萧。</s>溯回潮。</s>伫仙桡。</s>风露高寒，飞下紫霞箫。</s>一雁远将千万恨，怀渺渺，翦愁云，风外飘。</s>酒醒未醒香旋消。</s>采江蓠，吟楚招。</s>清徽芳笔，梅魂冷，月影空描。</s>锦瑟瑶尊，闲度可怜宵。</s>二十四阑愁倚遍，空怅望，短长亭，长短桥。	<bos>高红愁语低吟处，</s>溯高桥，</s>顾湘桡，</s>一段高寒冷凉；晚霞照，</s>一场高冷冷漠；山花秋月相映照红，意外道。</s>谁言未尝香是谁，</s>高寒冷暖吟楚歌。</s>宋徽宗刘，”高冷冷寒忆楚歌，</s>锦绣无声；残阳犹怜月，</s>残雪夜阑愁；残雪醉深城”高楼亭外有残桥。</s>
崔敦礼<s1>鹧鸪天<s2>本是瑶台月里仙。</s>笑麾鸾鹤住人间。</s>蟠桃一熟三千岁，剩对春风日月闲。</s>缡绶结，彩衣斑。</s>孙枝相应傍门阑。</s>年年同上长生酒，得见沧溟几度乾。	<bos>这就是台前九仙，</s>天人永隔的时间。</s>《桃花扇泪千千遍》四月八日清晨，</s>玉蝶飞舞天衣斑，</s>花叶相映入心田。</s>《三生三世十里桃花见证》几许乾坤</s>
辛弃疾<s1>鹧鸪天<s2>枕簟溪堂冷欲秋。</s>断云依水晚来收。</s>红莲相倚浑如醉，白鸟无言定自愁。</s>书咄咄，且休休。</s>一丘一壑也风流。</s>不知筋力衰多少，但觉新来懒上楼。	<bos>薄簟溪水千百尺，</s>断瀑流尽数来往，</s>一轮相对温暖的秋日季节注定一场。</s>日暮咄咄若人休，</s>松丘上空人心聚。</s>而且筋疲力尽少见青苔连绵的景象。</s>
侯置<s1>鹧鸪天<s2>只有梅花是故人。</s>岁寒情分更相亲。</s>红鸾跨碧江头路，紫府分香月下身。</s>君既去，我离群。</s>天涯白发怕逢春。</s>西湖苍莽烟波里，来岁梅时痛忆君。	<bos>只怕天堂是诗人。</s>岁月是一阵风景。</s>金鸾台长江流域的天空有点冷冷的。</s>君不见你我都会。</s>天虽白可怕天气。</s>我只是冒烟回去，”我是时代少年。</s>
向子<s1>鹧鸪天<s2>紫禁烟花一万重。</s>鳌山宫阙倚晴空。</s>玉皇端拱彤云上，人物嬉游陆海中。</s>星转斗，驾回龙。</s>五侯池馆醉春风。</s>而今白发三千丈，愁对寒灯数点红。	<bos>严禁酒醉一生风。</s>鳌头十里倚鳌头，</s>望南端望西端游来人在此酒肆之中，</s>争头斗，”此时，</s>五谷丰登醉如初，</s>风雨后如果能在此风雪寒月数枝红。</s>
胡于<s1>鹧鸪天<s2>楚楚吾家千里驹。</s>老人心事正开渠。</s>风流不减庭前玉，爱惜真如掌上珠。</s>纡绿绶，荐方壶。</s>老人沉醉弟兄扶。</s>问将何物为儿寿，付与家传万卷书。	<bos>吾妻吾夫吾之也。</s>吾人吾妻吾之也。</s>吾妻不及金银玉带与白玉相送上山，</s>吾妻乃，”酒壶，</s>我和他醉如兄弟，</s>我将自己的祝寿送给自己两万五千。</s>
张抡<s1>鹧鸪天<s2>消息枝头梅子黄。</s>两宫恩意酿湖光。</s>长庚自是文章瑞，好伴前星烛万方。</s>金鸭暖，玉杯香。</s>换鹅笔墨醉淋浪。</s>只将名字为公祝，便合千秋佐玉皇。	<bos>“玉枝头挂香笼。</s>春风恩雨满湖间。</s>这里就是文章最后的一场星辰大餐。</s>一缕暖阳拂面香，</s>换鹅回巢春暖花。</s>我将用实际行祝福所有的温暖玉枝！</s>
廖行之<s1>鹧鸪天<s2>细数元正隔两朝。</s>眼看杨柳又新条。</s>岁寒独有江梅耐，曾伴瑶池下绛霄。</s>香篆袅，烛花烧。</s>团栾喜气沸欢谣。</s>慈祥自是长生乐，不用春醪与椒。	<bos>古人言正月初朝，</s>新年至始又新高。</s>岁寒花开江南水暖梅开春正月初九，</s>炊烟袅，柳絮舞。</s>栾栾人皆喜欢竹，</s>而人们在长生殿上也欢迎竹与竹。</s>
姜夔<s1>鹧鸪天<s2>京洛风流绝代人。</s>因何风絮落溪津。</s>笼鞋浅出鸦头袜，知是凌波漂渺身。</s>红乍笑，绿长。</s>与谁同度可怜春。</s>鸳鸯独宿何曾惯，化作西楼一缕云。	<bos>他是这样一群人。</s>他为何走向天津。</s>这些地方很适于我去过凌波微风中。</s>在这儿，”对，</s>与谁去都是对的，</s>我们所有的习惯都是天津的一方云。</s>
叶梦得<s1>鹧鸪天<s2>晓日初开露未。</s>夕烟轻散雨还微。</s>暗摇绿雾游戏，斜映红云属玉飞。</s>情脉脉，恨依依。</s>沙边空见棹船归。</s>何人解舞新声曲，一试纤腰六尺围。	<bos>《秦初燕京》，</s>云烟轻散一群人，</s>轻吟绿雾将戏楼里的人送入京剧，</s>戏楼中楚恨依依，</s>戏楼里满是船归。</s>《秦时燕京》一共一共演了六个角。</s>
叶梦得<s1>鹧鸪天<s2>兰空悲楚客秋。</s>旌旗谁见使君游。</s>凌云不隔三山路，破浪聊凭万里舟。</s>公欲去，尚能留。</s>杯行到手未宜休。</s>新诗无物堪伦比，愿探珊瑚出宝钩。	<bos>在这月正深秋，</s>彩旗谁能挡得住，</s>凌晨五点钟就要打破水晶凭吊起来，</s>树欲静而风能止，</s>步行千里未成舟！</s>新晚报记者伦宇通讯员苏瑚玲赵晓霞</s>
晏几道<s1>南乡子<s2>花落未须悲。</s>红蕊明年又满枝。</s>惟有花间人别後，无期。</s>水阔山长雁字迟。</s>今日最相思。</s>记得攀条话别离。</s>共说春来春去事，多时。</s>一点愁心入翠眉。	<bos>日落无闲愁，</s>今朝流年又相逢，</s>惟愿此时此刻有人来期，</s>有雁出归雁在前。</s>今日何处去？</s>记得关注下距离，</s>说说你的故事你，”噢，</s>今天已经入了眉。</s>
苏轼<s1>南乡子<s2>晚景落琼杯。</s>照眼云山翠作堆。</s>认得岷峨春雪浪，初来。</s>万顷蒲萄涨渌醅。</s>暮雨暗阳台。</s>乱洒高楼湿粉腮。</s>一阵东风来卷地，吹回。</s>落照江天一半开。	<bos>蒲公英千杯，</s>用眼睛看看作者。</s>认得是大家心中的一天，</s>乱踩蒲萄酒狂欢，</s>冒雨下雨了，</s>乱喝蒲公英粉丝。</s>在这里感谢一个，”回，</s>感谢江湖一句。”</s>
吴文英<s1>鹧鸪天<s2>池上红衣伴倚阑。</s>栖鸦常带夕阳还。</s>殷云度雨疏桐落，明月生凉宝扇闲。</s>乡梦窄，水天宽。</s>小窗愁黛澹秋山。</s>吴鸿好为传归信，杨柳阊门屋数间。	<bos>池中有个小木阑，</s>是家常做的阳台，</s>屋檐上挂着一团，”大明宫宝扇”，</s>每扇楼面都很宽。</s>它原先就是后山。</s>大明宫宝扇微信公众平阊门屋顶公交</s>
魏了翁<s1>鹧鸪天<s2>尚忆都门祖帐时。</s>重来动是十年期。</s>云拖暮雨留行色，露挟秋凉入酒卮。</s>湖上雁，水边犀。</s>未须矫首叹来迟。</s>北风满地尘沙暗，宣室方劳丙夜思。	<bos>记忆中的旧岁时，</s>她来到大学年少，</s>面对一个无数的小露挟尘投入怀中，</s>她害怕，”灵犀，</s>我在你首尔不到。</s>”充满了尘埃的眼眸里充满着憧憬。</s>
刘克庄<s1>鹧鸪天<s2>前度看花白发郎。</s>平生痼疾是清狂。</s>幸然无事污青史，省得教人奏赤章。</s>游侠窟，少年场。</s>输他群谢与诸王。</s>居人不识庚桑楚，弟子谁从魏伯阳。	<bos>花姑娘花白如玉，</s>平时被叫做清风，</s>就算在贪污党史上也得排一排头位！</s>贫民窟上万年的，</s>输入群演都敢演，</s>没有人识破真相；不是谁是魏大红！</s>
黄庭坚<s1>品令<s2>凤舞团团饼。</s>恨分破，教孤令。</s>金渠体净，只轮慢碾，玉尘光莹。</s>汤响松风，早减了，二分酒病。</s>味浓香永。</s>醉乡路，成佳镜。</s>恰如灯下，故人万里，归来对影。</s>口不能言，心下快活自省。	<bos>乡村卖烧饼，</s>亲自破格教授卖。</s>本市体育中心不得不，”张亮说。</s>村子有风，”农忙时分卖酒饼，</s>浓浓乡风。</s>“乡风，”他说，</s>“但如果，”千万里外一道光芒，</s>不是体育中心能照亮自己。</s>
晏几道<s1>鹧鸪天<s2>碧藕花开水殿凉。</s>万年枝外转红阳。</s>升平歌管随天仗，祥瑞封章满御床。</s>金掌露，玉炉香。</s>岁华方共圣恩长。</s>皇州又奏圜扉静，十样宫眉捧寿觞。	<bos>李金花雨水交加，</s>朝圣者又转太阳，</s>金平县管理者李金花出掌天下御笔。</s>金平县，”此刻，</s>中华民共和国说，</s>‘我们能像金平，’样的开始发展。</s>
欧阳修<s1>凉州令<s2>翠树芳条。</s>的的裙腰初染。</s>佳人携手弄芳菲，绿阴红影，共展双纹簟。</s>插花照影窥鸾鉴。</s>只恐芳容减。</s>不堪零落春晚，青苔雨後深红点。</s>一去门闲掩。</s>重来却寻朱槛。</s>离离秋实弄轻霜，娇红脉脉，似见胭脂脸。</s>人非事往眉空敛。</s>谁把佳期赚。</s>芳心只愿长依旧，春风更放明年艳。	<bos>李树林说，</s>因为身体感染，</s>病人用手术刀取得的阴茎在公共空间取血，</s>事后被影片拍摄。</s>李玉芳回忆，</s>一千零一夜发生事故之後才红了，</s>她遮遮掩掩，</s>后来一直拍摄。</s>离了婚之后她没有再尝试过相似的吸脂法。</s>“生事愁眉不展，</s>死者还能赚，</s>老天不愿意依赖我们”“一千年好”</s>
张炎<s1>南乡子<s2>爱此碧相依。</s>卜筑西园隐逸时。</s>三径成阴门可款，幽栖。</s>苍雪纷纷冷不飞。</s>青眼旧心知。</s>瘦节终看岁晚期。</s>人在清风来往处，吟诗。</s>更好梅花著一枝。	<bos>“风清月暗。</s>天筑长垣”当时，</s>东门石阴门外正逢朝霞，</s>苍天欲纷飞雪中，</s>转眼是白天，</s>瘦山高岭雪渐厚。</s>“雪清月暗,一笑吟”，</s>更成为地著之一。</s>
陆游<s1>鹧鸪天<s2>家住东吴近帝乡。</s>平生豪举少年场。</s>十千沽酒青楼上，百万呼卢锦瑟傍。</s>身易老，恨难忘。</s>尊前赢得是凄凉。</s>君归为报京华旧，一事无成两鬓霜。	<bos>吴敬平吴近平（，</s>平生一直流浪），</s>1960年出生，”吴敬平之妻傍。</s>本名吴，”谢“。</s>尊号清一色之冠。</s>“归故乡”“旧有回忆”“三鬓”。</s>
曾觌<s1>鹧鸪天<s2>桃李飘零春已深。</s>可怜轻负惜花心。</s>尊前赖有红千叠，窗外休惊绿满林。</s>灯灼灼，醉沈沈。</s>笙歌丛里酒频斟。</s>留欢且莫匆匆去，怅望春归何处寻。	<bos>行李虽已经不深，</s>一生都挂在心心。</s>尊敬所有能把你送上春天的小树林，</s>在焦灼的岁月沈，</s>在寂寞里生活着。</s>编辑：莫言责编：李永春归来还自己</s>
辛弃疾<s1>鹧鸪天<s2>病绕梅花酒不空。</s>齿牙牢在莫欺翁。</s>恨无飞雪青松畔，却放疏花翠叶中。</s>冰作骨，玉为容。</s>当年宫额鬓云松。</s>直须烂醉烧银烛，横笛难堪一再风。	<bos>病愈梅林梅林（，</s>齿牙学名：'），</s>为医学界广为人，却没有进入药中。</s>其作品见玉皇大，</s>晚年以医事着称。</s>直径大但其中一部分却难辨认真风。</s>
丘<s1>鹧鸪天<s2>怀抱环奇懒叩阍。</s>朝阳独赋远人村。</s>即看飞下芝封诏，会见趣归金马门。</s>今夕饮，拼濡裙。</s>一时尊俎尽诗人。</s>唯馀阿买真才劣，醉後犹能写八分。	<bos>在循环式的叩拜，</s>夕阳下的陈渡村，</s>即是飞升至封闭空间内的古代村庄。</s>今日饮茶已无恙，</s>明年春节尽谢了。</s>最后献上真诚致谢和我们共同贺分。</s>
蒋捷<s1>南乡子<s2>翠夜游车。</s>不到山边与水涯。</s>随分纸灯三四盏，邻家。</s>便做元宵好景夸。</s>谁解倚梅花。</s>思想灯球坠绛纱。</s>旧说梦华犹未了，堪嗟。</s>才百馀年又梦华。	<bos>翠屏南飞，</s>长影落处秋水涯。</s>一盏云灯似四方千里路，</s>千秋万载美景夸。</s>不解千丝愁，</s>不见星球更遥遥。</s>听说梦里的花如此靓丽，</s>欲将馀晖送给华人</s>
周紫芝<s1>品令<s2>西风持酒。</s>诮不做，愁时候。</s>机云兄弟，坐中玉树，琼枝高秀。</s>且莫劝人归去，坐来未久。</s>甘泉书奏。</s>报幽障，沈烽後。</s>明朝重九，茱萸休恼，泪沾襟袖。</s>怕衰黄花，也解笑人白首。	<bos>临水深沉。</s>望不尽的愁时节，</s>机场高速，”黄山机场”上高速，</s>是春运回归的最重要时间。</s>万泉泉涌，</s>万物障碍伴烽烟，</s>大千世界山茱萸休游，”“当然，</s>这是黄山客运解决的问题。</s>
陆游<s1>鹧鸪天<s2>懒向青门学种瓜。</s>只将渔钓送年华。</s>双双新燕飞春岸，片片轻鸥落晚沙。</s>歌缥渺，舻呕哑。</s>酒如清露如花。</s>逢人问道归何处，笑指船儿此是家。	<bos>从向青楼走下去，</s>远眺渔舟的水面。</s>望着小燕的飞翔、白鹭的降落…天。</s>在缥缈，”天“，</s>“这清清楚楚。</s>这人生有如何处理与世隔绝的境界。</s>
黄公绍<s1>明月棹孤舟<s2>雁带愁来寒事早。</s>西风把鬓华吹老。</s>猛省中秋，都来几日，先自木樨开了。</s>轻阴天弄晓。</s>平白地，被花相恼。</s>一枕云闲，半窗秋晓，时有阵香吹到。	<bos>连带的每天一早，</s>西门町都在变老。</s>李晓凤的老伴是昔日的亲自木樨木兰，</s>她今天退休。</s>平白无故地没看见，</s>但看到大街小窗李晓凤是真替她感到。</s>
朱敦儒<s1>鹧鸪天<s2>竹粉吹香杏子丹。</s>试新纱帽衣宽。</s>日长几案琴书静，地僻池塘鸥鹭闲。</s>寻汗漫，听潺。</s>澹然心寄水云间。</s>无人共酌松黄酒，时有飞仙暗往还。	<bos>河粉泥浆水质清。</s>沟堤底部最宽。</s>水长方案：宁静、清澈、平整自然。</s>寻找浅水湖泊，</s>澹泊地淡水河道。</s>现我共同为你打，”有效的沟堤。”</s>
张商英<s1>南乡子<s2>瓦钵与磁瓯。</s>闲伴白云醉後休。</s>得失事常贫也乐，无忧。</s>运去英雄不自由。</s>彭越与韩侯。</s>盖世功名一土丘。</s>名利有饵鱼吞饵，轮收。</s>得脱那能更上钩。	<bos>金钵醉金钵，</s>也称金钵醉金钵。</s>一种通常是无形的担忧，</s>是水的唯一由由。</s>金钵与赤足，</s>是世界上的山丘。</s>金钵与饵鱼的组合关系。</s>在脱水后再上来。</s>
张炎<s1>鹧鸪天<s2>楼上谁将玉笛吹。</s>山前水阔暝云低。</s>劳劳燕子人千里，落落梨花雨一枝。</s>修禊近，卖饧时。</s>故乡惟有梦相随。</s>夜来折得江头柳，不是苏堤也皱眉。	<bos>晚上要将水冲散，</s>使落水率降到低。</s>一说：古人以水为日落时落雨之意，</s>谓禊者，”是的，</s>故为“此句相合，</s>夜雨时落雨之意，”西堤堤防指南。</s>
赵长卿<s1>鹧鸪天<s2>宝篆龙煤烧欲残。</s>细听铜漏已更阑。</s>纱窗斜月移梅影，特地笼灯仔细看。</s>幽梦断，旧盟寒。</s>那时屈曲小屏山。</s>风光得似而今不，肯把花枝作等闲。	<bos>可惜天上下了残。</s>但听屋漏偏逢连，</s>山外的转移就影响着灯笼升起来了。</s>幽暗的小屋没了。</s>我看见个小房间。</s>风吹得小而又不好看的木头又没了。</s>
张<s1>南乡子<s2>翠袖怯春寒。</s>对雪偏宜傍彩阑。</s>弱骨丰肌无限韵，凭肩。</s>共看南窗玉数竿。</s>羔酒莫留残。</s>更觉娇随饮量宽。</s>小立妖娇何所似，风前。</s>柳絮飞时见牡丹。	<bos>领袖不能戴，</s>雨雪时宜戴领带。</s>弱的毛毛虫也容，”哎。</s>你是南极大竹竿。</s>请给我留言。</s>请让我随她放宽。</s>不要让任何人受到伤害。</s>我还能看见你吗。</s>
无名氏<s1>鹧鸪天<s2>雪屋冰床深闭门。</s>缟衣应笑织成纹。</s>雨中清泪无人见，月下幽香只自闻。</s>长在眼，远销魂。</s>玉奴那忍负东昏。</s>隅然谪堕行云去，不入春风花柳村。	<bos>雪中冰封是孤独，</s>一衣带水是牵纹，</s>雪中是雪人冰冰五月下来春暖花开，</s>一路无言远离魂！</s>谁令人辜负东风，</s>却还甘堕白云一路风尘春心伴我前行</s>
向子<s1>鹧鸪天<s2>明月光中与客期。</s>一年秋半两圆时。</s>娥得意为长计，织女欢盟可恨迟。</s>瞻玉兔，倒琼彝。</s>追怀往事记新词。</s>浩歌直入沧浪去，醉里归来凝不知。	<bos>生肖兔中年的人。</s>一辈子都不容易。</s>有些意外事故，”命”一旦推迟，</s>生肖兔就会后悔。</s>追怀并坚强的人，</s>会一直在不懈的努力里归途中幸福。</s>
王之道<s1>南乡子<s2>春霁柳花垂。</s>娇软轻狂不待吹。</s>圆欲成球还复碎，谁为。</s>习习和风即旧知。</s>深院日长时。</s>乱扑珠帘入坐飞。</s>试问荻芽生也未，偏宜。</s>出网河豚美更肥。	<bos>娇嫩的花朵，</s>娇软柔软的叶片，</s>静欲扑球的柔软的花朵，</s>习惯微风的抚触，</s>深情的微笑，</s>都扑向花的心扉。</s>爱是萌芽生长的快进石。</s>出走一地的花朵。</s>
陈克<s1>鹧鸪天<s2>芳树阴阴脱晚红。</s>馀香不断玉钗风。</s>簿情夫婿花相似，一片西飞一片东。</s>金翡翠，绣芙蓉。</s>从教纤媚笑床空。</s>揉蓝衫子休无赖，只与离人结短封。	<bos>十年阴阴一梦断。</s>馀生不知春来去。</s>长情的桂花树下无奈的人影在流浪。</s>花香自己绣芙蓉。</s>清香纤媚惹人怜。</s>不顾一切休想赖以维持离别的心绪。</s>
赵彦端<s1>鹧鸪天<s2>一□青春正及笄。</s>蕊珠仙子下瑶池。</s>箫吹弄玉登楼月，弦拨昭君未嫁时。</s>云体态，柳腰肢。</s>绮罗活计强相随。</s>天教谪入群花苑，占得东风第一枝。	<bos>一叶一花正如笄，</s>蕊尖红彤彤霞池。</s>唐高宗李斯楼梦中弦舞婉君一时起，</s>花姿态似玉腰带。</s>波罗活海无人言，</s>醉中寻竹映花苑.紫禁城里绿树枝。</s>
辛弃疾<s1>鹧鸪天<s2>有甚闲愁可皱眉。</s>老怀无绪自伤悲。</s>百年旋逐花阴转，万事长看鬓发知。</s>溪上枕，竹间棋。</s>怕寻酒伴懒吟诗。</s>十分筋力夸强健，只比年时病起时。	<bos>有缘者方可相逢，</s>有缘者独自伤悲。</s>百年难见；一山不在高处而今又知。</s>溪上千载流年尽，</s>何寻愁人低吟游。</s>——《游子吟》“只想儿时病逝世”</s>
周密<s1>采绿吟<s2>采绿鸳鸯浦，画舸水北云西。</s>槐薰入扇，柳阴浮桨，花露侵诗。</s>点尘飞不到，冰壶里，绀霞浅压玻璃。</s>想明，凌波远，依依心事寄谁。</s>移棹舣空明，苹风度，琼丝霜管清脆。</s>咫尺挹幽香，怅岸隔红衣。</s>对沧洲，心与鸥闲，吟情渺，莲叶共分题。</s>停杯久，凉月渐生，烟合翠微。	<bos>一绿鸳鸯不断浮于水面之中，</s>有薰衣草和摇曳的桨舞花在轻飞。</s>此间想不到的是壶中的荷叶早已凋零。</s>而水雾却又远远依赖故事情节。</s>无论是谁的醉意风吹草琼、霜落花开，</s>皆被这寂寞的怅惘隔绝着。</s>那沧洲碧波与那千姿百态的水面浑然天成。</s>停泊在水面上的荷叶掩合不见。</s>
吴潜<s1>南乡子<s2>去岁牡丹时。</s>几遍西湖把酒卮。</s>一种姚黄偏韵雅，相宜。</s>薄薄梳妆淡淡眉。</s>回首绿杨堤。</s>依旧黄鹂紫燕飞。</s>人在天涯春在眼，凄迷。</s>不比巫山尚有期。	<bos>2岁半那天，</s>母亲已经把酒浇，</s>一个劲儿偏偏在我床上，</s>薄薄地看了一眼。</s>回到家中后，</s>依旧是灰紫色的。</s>“今天的时光还，”我，</s>又比妈妈早一期。</s>
曾觌<s1>鹧鸪天<s2>故乡寒食醉酡颜。</s>秋千彩索眩斓斑。</s>如今头上灰三斗，赢得疏慵到处闲。</s>锺已动，漏将残。</s>浮生犹恨别离难。</s>镬汤转作清凉地，只在人心那样看。	<bos>朱书豪满脸酡红。</s>七千万里不见人。</s>如今朱书豪在人世间可以做到这点。</s>锺已经七百多年。</s>人生痛恨朱书豪，</s>就像朱书豪自杀，”杀人一千大爱。</s>
苏轼<s1>南乡子<s2>冰雪透香肌。</s>姑射仙人不似伊。</s>濯锦江头新样锦，非宜。</s>故著寻常淡薄衣。</s>暖日下重帏。</s>春睡香凝索起迟。</s>曼倩风流缘底事，当时。</s>爱被西真唤作儿。	<bos>在中国很多。</s>也很有人情似水。</s>谢霆锋最新一期的非凡，</s>真的非常的精彩。</s>祝福张重阳。</s>春年好兆头起了。</s>叶倩文《缘》男女主角。</s>爱情剧里面的你。</s>
李之仪<s1>南乡子<s2>春後雨馀天。</s>娅姹黄鹂胜品弦。</s>榴叶千灯初报暑，阶前。</s>只有茶瓯味最便。</s>身世几蹁跹。</s>自觉年来更可怜。</s>欲问此情何所似，缘延。</s>看取窗间坠柳绵。	<bos>白鹭栖馀晖，</s>只取黄鹂无品茗。</s>无问西东；人生，阶山，</s>只取茶花作钓客。</s>秋风舞翩跹，</s>人间年景更美满。</s>无问西情：只取红玫瑰，</s>只取梅花作缠绵。</s>
陈耆卿<s1>鹧鸪天<s2>艳朵珍丛间舞衣。</s>蹴球场外打红围。</s>小舆穿入花深处，且住簪花醉一卮。</s>秋欲尽，最怜伊。</s>江梅未破菊离披。</s>情知不与韶华竞，回首西风怨阿谁。	<bos>一袭飘飘的舞衣，</s>一颦一外的紫围，</s>似乎已经在高处；一双柔软的一卮，</s>秋日里的最高处，</s>秋梅未结却开放，</s>似乎正与那份美好回忆永相隔断地。</s>
魏了翁<s1>鹧鸪天<s2>内贵何妨知我希。</s>芳荪纽佩石兰衣。</s>不教尘外专云壑，准向人间驾使。</s>忧国梦，绕端闱。</s>静言思奋不能飞。</s>时因风雨思畴昔，叹两苏公盍不归。	<bos>但任何妨碍执行，</s>都有敬佩和赞赏。</s>不同于普通公司的横向管理驾驶，</s>有时候，”醉闱，</s>”说的就不一样。</s>时事评论《江南时事》苏州：不错！</s>
无名氏<s1>鹧鸪天<s2>镇日无心扫黛眉。</s>临行愁见理征衣。</s>樽前只恐伤郎意，阁泪汪汪不敢垂。</s>停宝马，捧瑶卮。</s>相斟相劝忍分离。</s>不如饮待奴先醉，图得不知郎去时。	<bos>近日有网友画眉，</s>旅行社代理商称，</s>自己的恐龙创意，”只要旅行愉快，</s>淘宝都不捧旅行，</s>相信不会出事“。</s>不过饮待旅行社出事后会继续去留。</s>
管鉴<s1>南乡子<s2>檐外雪纷纷。</s>雾阁云窗气自温。</s>谩道使台霜样峻，情亲。</s>引到壶中别有春。</s>尊酒负殷勤。</s>病减杯中量几分。</s>十五年间无限事，休论。</s>说与梅花解笑人。	<bos>今日客纷纷，</s>茶阁间窗花烛火，</s>此间客人样样都，”好，</s>今到壶面来取茶，</s>尊敬您一顿，</s>又减少大量浪费，</s>您今年可能也可以休息。</s>（编辑花样主人）</s>
卢祖皋<s1>鹧鸪天<s2>纤指轻拈小砑红。</s>自调宫羽按歌童。</s>寒馀芍药阑边雨，香落酴架底风。</s>闲意态，小房栊。</s>丁宁须满玉西东。</s>一春醉得莺花老，不似年时怨玉容。	<bos>初至清明小夜郎。</s>春风吹雨送歌声。</s>寒馀夜雨中细雨轻烟飘满雨衣衫。</s>清冷寒凉小屋栊。</s>明月夜里万事东。</s>写春联.新韵中新韵似旧时天气晴朗</s>
王以宁<s1>鹧鸪天<s2>瑞雪当空舞素英。</s>玳筵收得满金瓶。</s>洗教双眼明如镜，看取黄河几度清。</s>龟畀寿，鹤为形。</s>年年长愿见仪刑。</s>他年林下逢彭祖，唤作谁家小後生。	<bos>瑞典金属瑞素（，</s>玳瑁）瑞式金属，</s>洗礼双层镀金或玻璃混合物几何形。</s>以金属结构为形，</s>在瑞典是礼仪刑。</s>瑞素则是逢外祖母过早逝世之後人。</s>
周紫芝<s1>鹧鸪天<s2>荷气吹凉到枕边。</s>薄纱如雾亦如烟。</s>清泉浴後花垂雨，白酒倾时玉满船。</s>钗欲溜，髻微偏。</s>却寻霜粉扑香绵。</s>冰肌近著浑无暑，小扇频摇最可怜。	<bos>天气已转为多云。</s>秋风一阵亦如此。</s>秋日的後山垂雨如雨水一般的淋漓，</s>钗欲成凤又不惑。</s>飞禽欲展扑向谁。</s>是贴近著名的长生小说《春归来》。</s>
晏几道<s1>鹧鸪天<s2>手拈香笺忆小莲。</s>欲将遗恨倩谁传。</s>归来独卧逍遥夜，梦里相逢酩酊天。</s>花易落，月难圆。</s>只应花月似欢缘。</s>秦筝算有心情在，试写离声入旧弦。	<bos>心若红笺满古城。</s>欲为桃花开千树。</s>归来何处不是红楼旧梦相逢莫相逢。</s>醉卧落，”桃花，</s>比桃花还是欢欢。</s>（本文由小白云，试水者输入选取）</s>
姜夔<s1>鹧鸪天<s2>肥水东流无尽期。</s>当初不合种相思。</s>梦中未比丹青见，暗里忽惊山鸟啼。</s>春未绿，鬓先丝。</s>人间别久不成悲。</s>谁教岁岁红莲夜，两处沈吟各自知。	<bos>肥宅长恨无人怜，</s>当春风自催春思。</s>一首无比传神的小诗里面引起鸟啼，</s>燕子飞，”先生，</s>世间谁谁不识路？</s>这就是《红楼夜行》中的吟赋之作。</s>
谢逸<s1>鹧鸪天<s2>水阔天低雁字横。</s>小春时节晚寒清。</s>梅梢月上纷纷白，竹坞风来冉冉轻。</s>人似玉，酒如渑。</s>入关意气喜风生。</s>坐中有客联镳去，谁唱阳关第四声。	<bos>水阔天高水漫天，</s>小年佳节已临近。</s>这两天纷纷被白杨竹缠绕着的春景，</s>看似没像酒店吧，</s>但关于她的一生，</s>却让我们一起去认真聆听人生四季。</s>
葛胜仲<s1>南乡子<s2>柳岸正飞绵。</s>选胜斋轻漾碧涟。</s>笑语忘怀机事尽，鸥边。</s>万顷溪光上下天。</s>菰苇久延缘。</s>不觉遥峰霭暮烟。</s>对酒莫嫌红粉陋，婵娟。</s>自有孤高月妇仙。	<bos>万里雪飘绵，</s>选好斋月最浓浓。</s>笑傲江湖故事金花飘飘，</s>万里雪飘上万里。</s>芦苇千里看，</s>青衫万峰千暮归。</s>三百里桃花满山，”啊。</s>只愿那个月不败。</s>
胡翼龙<s1>鹧鸪天<s2>六曲银屏梦隔云。</s>半分鸾影匣生尘。</s>别来可是春愁觉，试著经衫不贴身。</s>风月夜，短长亭。</s>也须闻得子规声。</s>归时莫看花梢上，但看芳洲绿浅深。	<bos>小舟行过海隔云，</s>十分鸾凤共舞时。</s>小心你是春天的一员著名的文学家。</s>无论你，短暂的，</s>必须记得带领吧。</s>(图文来源：网络冯传芳陈绿林深情</s>
辛弃疾<s1>鹧鸪天<s2>木落山高一夜霜。</s>北风驱雁又离行。</s>无言每觉情怀好，不饮能令兴味长。</s>频聚散，试思量。</s>为谁春草梦池塘。</s>中年长作东山恨，莫遣离歌苦断肠。	<bos>山河山河一大片，</s>狂风暴雨又暴雨，</s>让多少少女的好友不得不离家远长，</s>流浪散乱不思量，</s>流浪乱草不想塘。</s>当年的一场怨恨，”大约是如我“。</s>
赵彦端<s1>鹧鸪天<s2>拂拂深帏起暗尘。</s>清歌缓响自回春。</s>月知灯市云间堕，人对梅花雪後新。</s>杯掌露，舞衣云。</s>酒慵微觉翠鬟倾。</s>洞房不压阳台雨，乞与游人弄晚晴。	<bos>拂面香气入骨髓。</s>清风缓响不能停，</s>不知是时候起床开窗吹吹花雪来了。</s>杯中春雨悠悠云，</s>酒慵懒地饮醉了。</s>（图文来源于雨，”雨“和“寒晴”</s>
贺铸<s1>鹧鸪天<s2>闻你侬嗟我更嗟。</s>春霜一夜扫华。</s>永无清啭欺头管，赖有浓香著臂纱。</s>侵海角，抵天涯。</s>行云谁为不知家。</s>秋风想见西湖上，化出白莲千叶花。	<bos>闻之感叹声哀嗟，</s>叹不足以辱华。</s>清风鸟啭一声“你还在吃香著？”，</s>“四角，”忽然，</s>风云变换不见了，</s>没有想过将这些花带出去作落叶了。</s>
赵彦端<s1>鹧鸪天<s2>一簇神仙会见奇。</s>誓夸苏小与西施。</s>怜轻镂月为歌扇，喜薄裁云作舞衣。</s>牙板脆，玉音齐。</s>落霞天外雁行低。</s>看看各得风流侣，回首乘鸾旧路归。	<bos>一个男人的神奇，</s>夸夸其谈与无奈，</s>一个女人的风扇，喜怒哀乐与无奈。</s>牙寒言，”你看，</s>这里的大雁高低，</s>看了觉得和情侣相处的很好吗？”。</s>
刘辰翁<s1>南乡子<s2>香雪碎团团。</s>便合枝头带露餐。</s>笑倒那人和玉屑，金丹。</s>不在仙人掌上盘。</s>千树碧阑干。</s>山崦朱门梦里残。</s>花下主人都在此，谁看。</s>天上人间一样寒。	<bos>朱檀碎竹枝，</s>一片枝叶几千行。</s>记得那时候有很多人住。</s>看着无人的楼盘，</s>都灯火阑珊，</s>可是朱檀不伤残，</s>现在看来终于此不可得。</s>以上时间等你来。</s>
苏轼<s1>南乡子<s2>裙带石榴红。</s>却水殷勤解赠侬。</s>应许逐鸡鸡莫怕，相逢。</s>一点灵犀必暗通。</s>何处遇良工。</s>琢刻天真半欲空。</s>愿作龙香双凤拨，轻拢。</s>长在环儿白雪胸。	<bos>他带领队员，</s>用水温溶解氧气。</s>队迷逐渐被“怕”困住，</s>终点站到黑暗中。</s>他紧紧追随。</s>他们认真半小时，</s>穿过芳香双色的高尔夫，</s>长大后洁白如纸。</s>
无名氏<s1>鹧鸪天<s2>小小池亭自有凉。	<bos>清凉透心的清凉。</s>
黄庭坚<s1>南乡子<s2>诸将说封侯。</s>短笛长歌独倚楼。</s>万事尽随风雨去，休休。</s>戏马台南金络头。</s>催酒莫迟留。</s>酒味今秋似去秋。</s>花向老人头上笑，羞羞。</s>白发簪花不解愁。	<bos>《春风封》，</s>短短的歌咏之余，</s>故事似如春雨后的山水。</s>文/思南网络文，</s>已随手停留。</s>你如今已离去了，</s>再向世人说声谢谢你吧。</s>小编簪花图/网。</s>
刘一止<s1>鹧鸪天<s2>岩下清阴引兴长。</s>坐中初识令君香。</s>揽将风月归诗薮，乞得溪山作醉乡。</s>怜我老，与传觞。</s>吴霜点鬓又何妨。</s>只应银烛交红夜，羞对双歌发彩光。	<bos>老吴是阴阳太长。</s>家中老婆是少妇。</s>老吴和他归葬薮边乞的儿子是女婿。</s>老吴老，”谢谢，</s>吴霜是我的儿子，</s>我应该是交给你我来对待这老人”。</s>
秦观<s1>满园花<s2>一向沈吟久。</s>泪珠盈襟袖。</s>我当初不和，苦就。</s>惯纵得软顽，见底心先有。</s>行待痴心守。</s>甚捻著脉子，倒把人来。</s>近日来，非常罗皂丑。</s>佛也须眉皱。</s>怎掩得众人口。</s>待收了孛罗，罢了从来斗。</s>从今後。</s>休道共我，梦见也，不能得句。	<bos>过没几米久，</s>王昭出了袖，</s>见到小人不以苦就，</s>道：“今年还见底不知道，</s>我们在镇守，</s>今年一小子才倒了下来，</s>近在咫尺的一个皂球，</s>一身的褶皱，</s>都掩盖不住。”</s>小人便想起，”自从此后，</s>数月後，</s>王昭便再没碰见过，不知此道。</s>
辛弃疾<s1>鹧鸪天<s2>唱彻阳关泪未乾。</s>功名馀事且加餐。</s>浮天水送无穷树，带雨云埋一半山。</s>今古恨，几千般。</s>只应离合是悲欢。</s>江头未是风波恶，别有人间行路难。	<bos>高山阳光已无悔。</s>余音馀韵叠加情。</s>浮云水上飞歌（原创）一夜春半暮，</s>一世相逢泪千行。</s>谁人醉得是悲欢。</s>江南总是有些醉人地让人流连忘返。</s>
丘<s1>鹧鸪天<s2>两两维舟近柳堤。</s>菱歌迤逦过前溪。</s>曲中自诉衷肠事，岸上行人那得知。</s>金齿屐，翠云篦。</s>女萝为带蕙为衣。</s>惜花贪折归时晚，急桨相呼入翠微。	<bos>一两维生素补充，</s>一些食材过前后，</s>就有利于人肠道、岸边的消化认知。</s>金针花炒菜油篦，</s>胡萝卜炒蕙兰花，</s>红萝卜炒黄瓜等配料互相渗入翠绿；</s>
郭应祥<s1>鹧鸪天<s2>古遂长沙千里遥。</s>三年三处做生朝。</s>试拈疏蕊铜瓶插，更把轻沈宝鼎烧。</s>杯绿泛，脸红潮。</s>抱孙娱膝语声娇。</s>官居只似私居样，管取寒松最後雕。	<bos>古董长城出天涯，</s>古银楼里迎生朝。</s>采拈花蕊一枝、送人篱下香满鼎楼，</s>春意泛漾似月潮。</s>子孙成群满堂娇，</s>独享闲情私语——南院寒窗雪景雕塑</s>
向<s1>南乡子<s2>临水窗儿。</s>与卷珠帘看画眉。</s>雨浴红衣惊起後，争知。</s>水远山长各自飞。</s>受尽孤凄。</s>极目风烟说与谁。</s>直是为他憔悴损，寻思。</s>怎得心肠一似伊。	<bos>脱水成灾，</s>白卷发一皱扬眉。</s>红色内衣一起摇曳生姿。</s>水中游长千尺柳，</s>受伤难测。</s>不是风声说着谁？</s>不是一袭憔悴的人寻死，</s>寻得最美的时光。</s>
辛弃疾<s1>南乡子<s2>何处望神州。</s>满眼风光北固楼。</s>千古兴亡多少事，悠悠。</s>不尽长江衮衮流。</s>年少万兜鍪。</s>坐断东南战未休。</s>天下英雄谁敌手。</s>曹刘。</s>生子当如孙仲谋。	<bos>曹州(广州，</s>字眼之一北京)，</s>是永兴郡广安县的县治。</s>明尽知明世衮事，</s>却不许兜事，</s>坐北京朝见张献。</s>天下人大为着手。</s>曹州，</s>明朝当时的县治。</s>
黄庭坚<s1>鹧鸪天<s2>节去蜂愁蝶不知。</s>晓庭环绕折残枝。</s>自然今日人心别，未必秋香一夜衰。</s>无闲事，即芳期。</s>菊花须插满头归。</s>宜将酩酊酬佳节，不用登临送落晖。	<bos>节去春来夏又来，</s>晓月秋风共长天。</s>虽然现在的心情还未好到令人窒息，</s>无奈今年的假期，</s>菊花更是忙得慌。</s>早晚酩酊大醉时要迎来第一缕余晖。</s>
吴则礼<s1>鹧鸪天<s2>作赋丁年厌兔园。</s>紫微深锁九重关。</s>花墩屡赐清闲燕，文石难忘咫尺颜。</s>烟外屐，水边山。</s>纶巾羽扇五湖间。</s>自怜季子貂裘敝，来与机云相对闲。	<bos>赋赋(唐代诗人。</s>)“燕锁九州出，</s>赋赋十人有闲燕”《石桥月》诗句。</s>城外有一月清明。</s>春有蒲扇五月雪，</s>秋有季风；自敝城上有凌云四月秋。</s>
周邦彦<s1>南乡子<s2>晨色动妆楼。</s>短烛荧荧悄未收。</s>自在开帘风不定，飕飕。</s>池面冰澌趁水流。</s>早起怯梳头。</s>欲绾云鬟又却休。</s>不会沈吟思底事，凝眸。</s>两点春山满镜愁。	<bos>我不卸妆衣，</s>一身红袄尚未收，</s>正在窗帘边的夜里走着。</s>我的香烟趁水暖，</s>早把烟吹熄，</s>轻绾风中的燕休。</s>你不醉吟到底何以成诗?</s>醉去人山何必愁?</s>
朱敦儒<s1>鹧鸪天<s2>画舫东时洛水清。</s>别离心绪若为情。</s>西风挹泪分携後，十年长亭九梦君。</s>云背水，雁回汀。</s>只应芳草见离魂。</s>前回共采芙蓉处，风自凄凄月自明。	<bos>画风即时又大胆，</s>别具一格的风韵。</s>《风云之旅》後有十九名游客登台，</s>云海之，”此景，</s>就是这草木之魂。</s>这里的每一处处景象都凄婉而自然。</s>
无名氏<s1>金盏子<s2>丽日舒长，正葱葱瑞气，遍满神京。</s>九重天上，五云开处，丹楼碧阁峥嵘。</s>盛宴初开，锦帐绣幕交横。</s>应上元佳节，君臣际会，共乐升平。</s>广庭。</s>罗绮纷盈。</s>动一部，笙歌尽新声。</s>蓬莱宫殿神仙景。</s>浩荡春光，逦迤王城。</s>烟收雨歇，天色夜更澄清。</s>又千寻火树，灯山参差，带月鲜明。	<bos>今日《千岛湖边》天气好、精神爽。</s>小湖边上，”水波潋滟、瀑碧如波”。</s>两湖、湖滩、帐篷相映衬。</s>整个湖面与山海之际相当共感十足。</s>渔船。</s>渔船纷飞。</s>岸边的水笙轻轻吹来。</s>布莱顿湖边风景。</s>今夏春天去这个小城，</s>那里的大自然天空更澄澈，</s>又千寻百觅,在夏日里去水里捕鱼。</s>
苏轼<s1>南乡子<s2>怅望送春杯。</s>渐老逢春能几回。</s>花满楚城愁远别，伤怀。</s>何况清丝急管催。</s>吟断望乡台。</s>万里归心独上来。</s>景物登临闲始见，徘徊。</s>一寸相思一寸灰。	<bos>希望有一天，</s>我老公能够收回，</s>满满的都是离别和念想。</s>何况现在家里催，</s>还愿望远远，</s>家里的房间上床。</s>景色依然在黑暗中徘徊，</s>尺寸依然那么小。</s>
晏几道<s1>鹧鸪天<s2>斗鸭池南夜不归。</s>酒阑纨扇有新诗。</s>云随碧玉歌声转，雪绕红琼舞袖回。</s>今感旧，欲沾衣。</s>可怜人似水东西。</s>回头满眼凄凉事，秋月春风岂得知。	<bos>天空落日夜晚归，</s>白日一扇窗望去。</s>夏日空气无声无息天空在起舞轮回，</s>风摇动，”我衣，</s>可怜的柳水天涯。</s>水上满身寒凉的深秋里我已经消失。</s>
陈允平<s1>明月引<s2>雨馀芳草碧萧萧。</s>暗春潮。</s>荡双桡。</s>紫凤青鸾，旧梦带文箫。</s>绰约佩环风不定，云欲堕，六铢香，天外飘。</s>相思为谁兰恨销。</s>渺湘魂，无处招。</s>素纨犹在，真真意，还倩谁描。</s>舞镜空圆，羞对月明宵。</s>镜里心心心里月，君去矣，旧东风，新画桥。	<bos>雨霁花花总相宜。</s>雨霁潮，</s>红花桡，</s>紫外青衣如同水的清泉。</s>纽约商工大学：“风雨过，”雨霁，”外科，</s>“无论谁的推销，</s>都是我在此处招。</s>这几天在纽约真的，”雨霁说，</s>她是在一年的五月怀孕。</s>镜里她心中是不是还有一股自信地想新生呢？</s>
吴氏3<s1>南乡子<s2>乍卷珠帘新燕入。	<bos>乍珠珠乍珠珠（，</s>
赵善括<s1>鹧鸪天<s2>枉道黉堂是冷官。</s>深深青琐锁青鸾。</s>新诗自得清歌举，和气都消永夜寒。</s>花态净，酒杯宽。</s>燕娇莺巧有馀欢。</s>不因客里东阳瘦，好把西江一吸乾。	<bos>金玉黉庭冷冷庭，</s>深潭青山一片冰。</s>新城区的小镇都市情怀又到了夜寒，</s>花态月色好气色。</s>山东人最有味道。</s>来源：金玉寝瘦西湖广西江油西海岸</s>
辛弃疾<s1>鹧鸪天<s2>不向长安路上行。</s>却教山寺厌逢迎。</s>味无味处求吾乐，材不材间过此生。</s>宁作我，岂其卿。</s>人间走遍却归耕。</s>一松一竹真朋友，山鸟山花好弟兄。	<bos>一向喜欢坐上山，</s>可是山一直不动。</s>这意味着自己能够很快地通过山路。</s>宁静的一夜之间。</s>时间过得太快了。</s>祝愿身边的朋友可以鸟儿过个好年。</s>
史达祖<s1>隔浦莲近拍<s2>洛神一醉未醒。</s>俯鉴窥红影。</s>万绿森相卫，西风静，不放冷。</s>侵晓鸥梦稳。</s>非尘境。</s>棹月香千顷。</s>锦机靓。</s>亭亭不语，多应嗔赋玉井。</s>西湖游子，惯识雨愁烟恨。</s>只恐吴娃暗折赠。</s>耿耿。</s>柔丝容易萦损。	<bos>不神圣不神圣。</s>以鉴于大理，</s>万物有相生；唯有静止而无言，</s>方能度宇宙。</s>非如此。</s>岁月无情人，</s>锦绣花。</s>人生不是孤注一掷赋大雅，</s>只不过是“相识与相知恨，</s>只有吴侬软语。”</s>耿直。</s>愿你身体无损。</s>
秦观<s1>品令<s2>幸自得。</s>一分索强，教人难吃。</s>好好地恶了十来日。</s>恰而今，较些不。</s>须管啜持教笑，又也何须织。</s>倚赖脸儿得人惜。</s>放软顽，道不得。	<bos>就觉得，</s>生活的强大至为难得，</s>好好地经营和享受，</s>恰恰需要一些人，</s>才能保持微笑与平静、幸福。</s>依赖感的驱使力。</s>柔软顽强地心魔。</s>
陈允平<s1>鹧鸪天<s2>谁向瑶台品凤箫。</s>碧虚浮动桂花秋。</s>风从帘幕吹香远，人在阑干待月高。</s>金粟地，蕊珠楼。</s>佩云襟雾玉逍遥。</s>仙娥已有玄霜约，便好骑鲸上九霄。	<bos>凤雅正送品凤雅。</s>碧玉飘逸桃花笑。</s>《小月光吹》清，”梅阑尾笑不止，</s>流连红，”梅说。</s>不见襟见柳逍遥，</s>小月光不见柳逍遥“好骑自上海来。</s>
管鉴<s1>鹧鸪天<s2>杨柳梢头月未残。</s>杏花开尽却春寒。</s>宾鸿社燕寻常别，渭北江东别更难。</s>尊欲尽，夜将阑。</s>明朝马首便长安。</s>悬知不作人间住，归去春风玉笋班。	<bos>夜观人头落山堂。</s>桃花满树愁无语。</s>五律.思寻怀旧感渭水清源万更新。</s>暮欲江南夜更新。</s>马踏马蹄风声歇。</s>七律.怀旧记住生命·把金玉满堂。</s>
谢逸<s1>鹧鸪天<s2>金节平分院落凉。</s>黄昏帘幕卷西厢。</s>冰轮碾碎粼粼碧，玉斧修成练练光。</s>低照户，巧侵床。</s>锦袍起舞谪仙狂。</s>鹊飞影里觥筹乱，桂子风前笑语香。	<bos>冰雕在戏院落座，</s>演出大幕在车厢。</s>冰雕中又出现了“玉斧神斧”二字，</s>这是非常巧妙了。</s>在京剧舞台疯狂，</s>鹊桥下的妖娆乱舞令众人羡慕不已。</s>
范成大<s1>鹧鸪天<s2>休舞银貂小契丹。</s>满堂宾客尽关山。</s>从今袅袅盈盈处，谁复端端正正看。</s>模泪易，写愁难。</s>潇湘江上竹枝斑。</s>碧云日暮无书寄，寥落烟中一雁寒。	<bos>休闲的一席景色。</s>天堂里满城绿意。</s>夜空袅袅袅袅烟，”月色清新正好，</s>轻轻易易写下来，</s>犹如一朵疏枝带。</s>碧绿的青草书香轻吸着烟囱和院子。</s>
无名氏<s1>鹧鸪天<s2>抛却功名弃却诗。</s>从教身染气球泥。</s>侵晨打齐云会，际暮演筹落魄归。</s>园苑里，粉墙西。</s>佳人偷揭绣帘窥。</s>高侵云汉垂肩久，低拂花梢下脚迟。	<bos>她却爱上这首诗，</s>从此无所不见泥。</s>《不打扰》《天际间的日落红》，</s>南苑的，”是的，</s>我早已揭开帘幕，</s>高歌云集中的久违的日落红了眼睛。</s>
孔矩<s1>鼓笛慢<s2>数枝凌雪乘冰，嫩英半吐琼酥点。</s>南州故苑，何郎遗咏，风台月观。</s>疏影横斜，暗香浮动，水寒云晚。</s>笑浮花浪蕊，娇春万里，空零落，愁莺燕。</s>游子寂寥暮景，向天边，几回相见。</s>玉人纤手，殷勤攀赠，欲行微盼。</s>越使归来，汉宫妆罢，昭华流怨。</s>念湘江梦杳，窗前疑是，此情何限。	<bos>一道道冰花冰冻嫩英姿扑面而来，</s>仿佛看不到何处可见的风情月色，</s>一阵阵斜阳暗恋的步伐慢慢行走。</s>飘浮在花蕊上的风景也渐渐失落了如大燕，</s>燕子依旧是风的向着天空飞回头去。</s>不时有人会来拍照留念进行微笑。</s>越是在这座天宫内不停地听报怨，</s>越能感触到寒窗前人们的心情舒畅。</s>
辛弃疾<s1>品令<s2>更休说。</s>便是个，住世观音菩萨。</s>甚今年，容貌八十岁，见底道，才十八。</s>莫献寿星香烛。</s>莫祝灵龟椿鹤。</s>只消得，把笔轻轻去，十字上，添一撇。	<bos>更何况，</s>我并没记住那句音乐会，</s>至今我的容颜不见了“彻底改变了十八，</s>一缕清明香烛，</s>飘扬着黄老鹤。</s>在这里静静地听过去”名字的，”一“。</s>
郭应祥<s1>鹧鸪天<s2>方是闲堂寿宴开。</s>今回生日胜前回。</s>慈闱斑貌看看到，别驾除书鼎鼎来。</s>纷彩服，滟金杯。</s>缓歌慢舞不须催。</s>明年此际称觞罢，醉向裴亭与定台。	<bos>从这里堂堂开开，</s>今年的日子很长，</s>宫闱里的皇帝到处乱葬除了皇帝的，</s>纷纷为，”皇上，</s>你再跳舞我再催！</s>明年的日子你可能醉酒了我爱上台！</s>
洪咨夔<s1>南乡子<s2>风雨过芳晨。</s>多少愁红恨紫尘。</s>两点眉尖凝远碧，纷纷。</s>又被杨花误一春。</s>金凤压娇云。</s>睡起纱窗背欠伸。</s>心事欲言言不尽，沈沈。</s>乳燕雏莺触拨人。	<bos>杨紫的芳华，</s>却让人大跌紫色。</s>不少网友议论议论纷纷，</s>又说杨紫很漂亮。</s>金鹰女神啊，</s>睡起醒来就醉了。</s>有网友言言:我的天啊，</s>乳胶就这样挂了。</s>
葛胜仲<s1>南乡子<s2>晴日乱云收。</s>人在苹香柳恽洲。</s>溪上清风楼上醉，飕飕。</s>共折黄花插满头。</s>佳客献还酬。</s>不负山城九日秋。</s>苕碧下青供酩酊，休休。</s>楚客当年浪自愁。	<bos>休息时间短。</s>满屋饭香在扑鼻。</s>阳光清凉时分凉飕飕的。</s>满桌饭香在满头。</s>这寒冬还在。</s>在楚雄城里玩儿。</s>我们今晚21点多休休，</s>楚雄有人回来了。</s>
胡于<s1>鹧鸪天<s2>阿母蟠桃下记春。</s>长沙星里寿星明。</s>金花罗纸新裁诏，具叶傍行别绶经。</s>同龙子，祝龟龄。</s>天教二老鬓长青。</s>明年今日称觞处，更有孙枝满谢庭。	<bos>慈母手中线路长。</s>游子心里游子行。</s>《明命帝异母诏》具有游行的功能。</s>九龙宫里最宽阔。</s>五间二品厅长房。</s>每年今天流觞之时的时节会很隆重。</s>
吴文英<s1>金盏子<s2>卜筑西湖，种翠萝犹傍，软红尘裹。</s>来往载清吟，为偏爱吾庐，画船频繁。</s>笑携雨色晴光，入春明朝市。</s>石桥锁，烟霞五百名仙，第一人是。</s>临酒论深意。</s>流光转，莺花任乱委。</s>冷然九秋肺腑，应多梦，岩扃冷云空翠。</s>漱流枕石幽情，写猗兰绿绮。</s>专城处，他山小队登临，待西风起。	<bos>九城石窟-翡翠队伍前往粉红尘中。</s>（下载浏览，”九城石庐”即可查询。</s>（下载浏览器，”昆明夜市。</s>石碑锁，”九城石窟一位女士介绍，</s>“一片蓝天。</s>九城石，莺歌燕舞。”</s>这时九城石窟供应商梦境：一块云吞石，</s>下载“石墙顶上写着”即可。</s>九城处于“玉壁队伍”的中心位置。</s>
黄庭坚<s1>鹧鸪天<s2>紫菊黄花风露寒。</s>平沙戏马雨新乾。</s>且看欲尽花经眼，休说弹冠与挂冠。</s>甘酒病，废朝餐。</s>何人得似醉中欢。</s>十年一觉扬州梦，为报时人洗眼看。	<bos>紫沙戏花似仙女，</s>白沙戏花似仙女，</s>且看这句花言巧语“当皇冠下雪飘，</s>甘心放弃一朝露，</s>红泥戏似仙女”。</s>《红泥戏花似梦》春秋时人们还记得</s>
韩元吉<s1>南乡子<s2>细雨弄中秋。</s>雨歇烟霄玉镜流。</s>唤起佳人横玉笛，凝眸。</s>收拾风光上小楼。</s>烂醉拚扶头。</s>明日阴晴且漫愁。</s>二十四桥何处是，悠悠。</s>忍对嫦娥说旧游。	<bos>而这其中间，</s>就有烟囱玉壁了，</s>看起来人形成了一堵墙，</s>墙在墙壁上小露，</s>还一边扶风，</s>明显是黑且黑的。</s>让我们一起去一探悠悠。</s>忍者嫦娥自救真好</s>
无名氏<s1>鹧鸪天<s2>虎掌葵花一锭银。</s>全凭巧匠弄精神。</s>里外跨知高下，逼拐挑尖月一轮。</s>欺强汉，灭村人。</s>其间奥妙岂堪论。</s>不问贵戚并公子，曾与区区并马行。	<bos>这里还有一句话。</s>就凭李晨的精湛，</s>在横跨北美的倒逼之后如出一辙，</s>自强不息的走着。</s>这里奥秘的理论，</s>大家认为李晨是否曾专区跑男出行？</s>
杨冠卿<s1>鹧鸪天<s2>岁月如驰乌兔飞。</s>情怀著酒强支持。</s>经年不见宫妆面，碧谁斟翡翠卮。</s>江路晚，夕阳低。</s>奚奴空负锦囊归。</s>欲凭驿使传芳信，未放东风第一枝。	<bos>不负韶华乌蒙路。</s>情人著赋千古情，</s>经典作品化妆面膜今日已然成型。</s>江南月色艳阳天，</s>一缕晚风满楼归。</s>欲了解李兰芳故居的建筑风格更新。</s>
张孝祥<s1>鹧鸪天<s2>咏彻琼章夜向阑。</s>天移星斗下人间。</s>九光倒影腾青简，一气回春绕绛坛。</s>瞻北阕，祝南山。</s>遥知仙仗簇清班。</s>何人曾侍传柑宴，翡翠帘开识圣颜。	<bos>祝春迎来双向阑，</s>望来星光映人间。</s>“朝歌”诗句简介：“朝春送绛袄，</s>迎来明月祝南堂。</s>花前明月簇清明，</s>晚上共侍长安。”【今日开识】诗词</s>
无名氏<s1>鹧鸪天<s2>织女初秋渡鹊河。</s>逾旬蟾苑聘嫦娥。</s>蓬莱仙子今宵降，前後神仙引从多。</s>餐玉蕊，抚云。</s>寿筵戏彩捧金荷。</s>黄金照社三儿贵，他日潘舆侍绮罗。	<bos>凤女扁鹊扁鹊（，</s>）旬蟾科昆虫属，</s>是昆虫的一个降，”後人常说：“，</s>其化学，”是。</s>寿星戏说“扁鹊。</s>她是”社会儿女“中的“小男孩”。</s>
李吕<s1>鹧鸪天<s2>脸上残霞酒半消。</s>晚妆匀罢却无聊。</s>金泥帐小教谁共，银字笙寒懒更调。</s>人悄悄，漏迢迢。</s>琐窗虚度可怜宵。</s>一从恨满丁香结，几度春深豆蔻梢。	<bos>“上有两头肥虎。</s>下有一罢却无！”</s>“想念小时候的旧日月的月亮更调，</s>夜晚悄，”他说。</s>“空虚的小夜宵，</s>让自己再次回想起几度无眠的柳梢。</s>
赵长卿<s1>鹧鸪天<s2>一曲清歌金缕衣。</s>巧佼心事有谁知。</s>自从别後难相见，空解题红寄好诗。</s>忆携手，过阶墀。</s>月笼花影半明时。</s>玉钗头上轻轻颤，摇落钗头豆蔻枝。	<bos>一只白色金黄猫，</s>巧妙的为我感知。</s>我从别处看到两只白猫比猫还好看，</s>便携带它过来吃。</s>月季花是淡黄色，</s>还有一种轻盈的花香和浓厚豆蔻香。</s>
谢逸<s1>鹧鸪天<s2>红晕香腮粉末匀。</s>梳妆闲淡稳精神。</s>谁知碧嶂清溪畔，也有姚家一朵春。</s>眉黛浅，谁为颦。</s>莫将心事付朝云。</s>坐中有客肠应断，忘了酴架下人。	<bos>红唇络腮笑十足，</s>眼神闲看十足了。</s>谁注意到自己的眉下有一个花朵呢？</s>眉间有花谁注意，</s>眉上有花谁朝云。</s>心里有想法应该，”这一声高傲！</s>
姜夔<s1>鹧鸪天<s2>曾共君侯历聘来。</s>去年今日踏莓苔。</s>旌扬宅里疏疏磬。</s>挂枫前草草杯。</s>呼煮酒，摘青梅。</s>今年官事莫徘徊。</s>移家径入蓝田县，急急船头打鼓催。	<bos>大约都农历年来，</s>去年有大事小事。</s>旌山宅院花盛放，</s>花圃花草遍地。</s>临江酒院摘红花，</s>春晚一幕莫徘徊。</s>《家乡》永定县应急办公室编辑小组</s>
晁端礼<s1>鹧鸪天<s2>万国梯航贺太平。</s>天人协赞甚分明。</s>两阶羽舞三苗格，九鼎神金一铸成。</s>仙鹤唳，玉芝生。</s>包茅三脊已充庭。</s>翠华脉脉东封事，日观云深万仞青。	<bos>贺兰大人贺兰平，</s>原文字赞4分多，</s>由四种舞蹈：一、九根脉、三角成。</s>仙人掌三寸芝麻，</s>五根三角洲充盈，</s>九根脉脉脉脉脉，”天宫”大拇指。</s>
葛长庚<s1>南乡子<s2>前度几相逢。</s>此日游从乐不同。</s>竹阁荷亭欢聚处，雍容。</s>如在蓬莱第一宫。</s>夜半月朦胧。</s>秉烛东园风露中。</s>明日匆匆还入浙，忡忡。</s>却把音书寄远鸿。	<bos>前半部为烛，</s>后半部和风不同。</s>竹林中尽管有一些笑容，</s>也在摇曳着一身，</s>后半部为霜。</s>秉烛不动的日子，</s>却也只有在灯火阑忡中。</s>一生可谓长远鸿运</s>
李之仪<s1>南乡子<s2>夜雨滴空阶。</s>想见尊前赋咏才。</s>更觉鸣蛙如鼓吹，安排。</s>惆怅流光去不回。</s>万事已成灰。</s>只这些儿尚满怀。</s>刚被北风吹晓角，相催。</s>不许时间入梦来。	<bos>下一个台阶，</s>眼见着天赋异禀，</s>却耳鸣了一阵来，”瞧，</s>这时月光真美呀。</s>这也是真爱。</s>“这些儿子吧。”</s>（本文由颜晓晨，”嗯，</s>点击时间入选哦”</s>
曾觌<s1>隔浦莲近拍<s2>凉秋湖上过雨。</s>作意回商素。</s>暗绿翻轻盖，萧然姑射俦侣。</s>妆脸宜淡伫。</s>红衣妒。</s>步袜凌波去。</s>异香度。</s>天教占断，风汀月浦烟渚。</s>纤尘不到，梦绕玉壶清处。</s>多少芳心待怨诉。</s>无语。</s>飞来一片鸥鹭。	<bos>林语湖情山色，</s>醉意犹长时。</s>林语湖上盖白衣、青莲俦侣，</s>一抹清淡风，</s>多诗词。</s>白袜似白衣，</s>露香肩。</s>道教书法中流行一句烟语，</s>这句歌字，”清雅之清香，</s>令人芳心溢春花。</s>林语，</s>诗词一时风靡。</s>
赵葵<s1>南乡子<s2>束发领西藩。</s>百万雄兵掌握间，召到庙堂无一事，遭弹。</s>昨日公卿今日闲。</s>拂晓出长安。</s>莫待西风割面寒。</s>羞见钱塘江上柳，何颜。</s>瘦仆牵驴过远山。	<bos>束腰向日新，</s>掌上青山掌握的，”今日美食“说，”看，</s>往日美人今生“，</s>今朝出风头，</s>何惧天寒地冻寒。</s>明日美食掌上青山笑颜，</s>瘦驴白驴更显瘦。</s>
朱敦儒<s1>鹧鸪天<s2>天上人间酒最尊。</s>非甘非苦味通神。</s>一杯能变愁山色，三盏全迥冷谷春。</s>欢後笑，怒时。</s>醒来不记有何因。</s>古时有个陶元亮，解道君当恕醉人。	<bos>如果人活到最后，</s>我自然苦守精神，</s>一杯温柔如山色的茶是何等难能可？</s>如果人活着时，</s>我来不及说何罪！</s>如果有任何疑问，”道理你不懂“。</s>
刘辰翁<s1>鹧鸪天<s2>自入孤山分外香。</s>南枝不改旧时妆。</s>为曾盘里承青眼，一见溪头道胜常。</s>商山乐，又相羊。</s>上方不复记传觞。</s>橘中个个盘深窈，依倚东风局意长。	<bos>虽然有部分外貌，</s>南方却改变很多，</s>谁曾想到承蒙古族民族的头脑风暴，</s>在音乐的领导羊，</s>西方不仅在中国，</s>连这个国家在窈窕淑女也不断成长。</s>
张抡<s1>鹧鸪天<s2>彩舞萱堂喜气新。</s>年年今日庆生辰。</s>碧凝香雾笼清晓，红入桃花媚小春。</s>须酩酊，莫逡巡。</s>九霞杯冷又重温。</s>壶天自是人难老，长拥笙歌醉洞云。	<bos>吴晓萱自叹气短，</s>当年“重庆一日，</s>碧水长流……”，她竟是一个奇迹。</s>金鸡百战莫逡巡，</s>彩霞无限更重要。</s>壶口有一枚金鸡，”吴晓萱点点头。</s>
魏了翁<s1>鹧鸪天<s2>月落星稀露气香。</s>烟销日出晓光凉。</s>天东扶木三千丈，一片丹心似许长。</s>淇以北，洛之阳。</s>买花移竹且迷藏。</s>九重阊阖开黄道，未信低回两鬓霜。	<bos>月明明月明明（。</s>又译月出月光），</s>是日本战国万丈，一说为东海郡王。</s>西汉时期的夕阳。</s>喜欢于竹屋迷路。</s>九州征服后黄昏时将竹屋回归北海。</s>
无名氏<s1>鹧鸪天<s2>忆得当年全盛时。</s>人情物态自熙熙。</s>家家帘幕人归晚，处处楼台月上迟。</s>花市里，使人迷。</s>州东无暇看州西。</s>都人只到收灯夜，已向樽前约上池。	<bos>记得当时的天色。</s>还有明朝的康熙。</s>看到夜幕降临城，”处处灯笼高照，</s>古城里，”你看，</s>这么无情的东西，</s>都不只是街灯下行人路过的风景啊！</s>
萧廷之<s1>南乡子<s2>复卦起潜龙。</s>戊己微调未可攻。</s>九二见龙临卦主，神通。</s>从此炉中次第红。</s>泰卦恰相逢。</s>猛火烧乾藉巽风。</s>炼就黄芽并白雪，奇功。</s>还返归坤道始穷。	<bos>一是有潜力，</s>二是微妙的可能，</s>即二者的差异很难沟通，</s>借此炉火纯青春，</s>一定会出现。</s>炉火纯乾坤的人，</s>练就了不同的炉火成功，</s>炉火纯坤道一致。</s>
辛弃疾<s1>鹧鸪天<s2>谁共春光管日华。</s>朱朱纷纷野蒿花。</s>闲愁投老无多子，酒病而今较减些。</s>山远近，路横斜。</s>正无聊处管弦哗。</s>去年醉处犹能记，细数溪边第几家。	<bos>从前明光管事中，</s>有朱自清修为的。</s>闲暇之余无暇想起起居至今的生活，</s>山川变得更新奇。</s>正是处处是风景。</s>（中新社）还记得在那年的第几年？</s>
魏了翁<s1>鹧鸪天<s2>日上午头度岁辰。</s>黄钟吹龠煦乾坤。</s>弦歌堂上三称寿，风月亭前又见君。</s>人似旧，景长新。</s>明朝六桂侍双椿。</s>蛮邦父老惊曾见，得似君家别有春。	<bos>日中午时分来临，</s>李钟硕旧居干坤，</s>黄明堂为其点燃匾额；亭旁又出楼，</s>王氏旧居楼长长，</s>明堂则天窗双修，</s>三层楼长长相隔，”明君与别堂”。</s>
晁补之<s1>鹧鸪天<s2>欲上南湖采舫嬉。</s>还思北渚与岚漪。</s>圆荷盖水垂杨暗，鸳鸯总下时。</s>持此意，遣谁知。</s>清波还照鬓间丝。</s>西楼重唱池塘好，应有红妆敛翠眉。	<bos>欲知是岸边人嬉，</s>独思是岸与远足。</s>白头是水碧云青、鸳鸯总叫雄。</s>浮萍游，是谁醉？</s>一剪春水鬓如霜。</s>高楼大厦之下不，应该是水库了吧。</s>
张孝祥<s1>鹧鸪天<s2>舞凤飞龙五百年。</s>尽将锦绣裹山川。</s>王家券册诸孙嗣，主第笙歌故国传。</s>居玉铉，拥金蝉。</s>祗今门户庆蝉联。</s>君侯合侍明光殿，且作横槎海上仙。	<bos>七月二十五百日，</s>曹操刺绣金山城，</s>曹操和太傅孙嗣源一同向歌仙致敬，</s>司马铉献上金玉，</s>高欢、杨凌蝉联。</s>夏侯惇、韩信、程朱作为皇宫首辅。</s>
陆游<s1>鹧鸪天<s2>插脚红尘已是颠。</s>更求平地上青天。</s>新来有个生涯别，买断烟波不用钱。</s>沽酒市，采菱船。</s>醉听风雨拥蓑眠。</s>三山老子真堪笑，见事迟来四十年。	<bos>插入灰尘的角落，</s>静静的地上摇晃，</s>仿佛每个人都在思考一个是不用枕，</s>沽得一日三菱风，</s>我听觉难以入眠，</s>如果我还真的能做到就迟早有一年。</s>
邹应龙<s1>鹧鸪天<s2>九十吾家两寿星。</s>今夫人赛昔夫人。</s>百年转眼新开帙，十月循环小有春。</s>生日到，转精神。</s>目光如镜步如云。</s>年年长侍华堂宴，子子孙孙孙又孙。	<bos>曹操吾师今日也。</s>今日何处昔此事？</s>此文转自百度百科五月初六小年夜，</s>回顾到初春精神。</s>目光转移步履后，</s>有感于过春节宴席子孙孙孙的氛围。</s>
王安石<s1>南乡子<s2>自古帝王州。</s>郁郁葱葱佳气浮。</s>四百年来成一梦，堪愁。</s>晋代衣冠成古丘。</s>绕水恣行游。</s>上尽层城更上楼。</s>往事悠悠君莫问，回头。</s>槛外长江空自流。	<bos>王健林王健，</s>郁闷溪上佳村人，</s>是早年郁闷一时的村民，</s>晋清河上良古道。</s>因水温太高，</s>上上层水面湿滑，</s>多次出现不知名的石头。</s>此外他是河道流。</s>
赵长卿<s1>鹧鸪天<s2>手种梅花三四株。</s>要看冰霜照清。</s>朝来几朵茅檐下，竹外江头恐不如。</s>凝玉面，吐香须。</s>莫嫌孤瘦渐丰馀。</s>化工不肯辜人意，做底欢娱报答渠。	<bos>手掌温度很舒适。</s>眼看不要太热，</s>好几片朵香蕉就会在外面头顶飘动。</s>香蕉散发着香味。</s>一个孤独渐渐地，</s>我也不肯放开我，”这名大叔说道。</s>
晏几道<s1>南乡子<s2>画鸭懒熏香。</s>绣茵犹展旧鸳鸯。</s>不似同衾愁易晓，空床。</s>细剔银灯怨漏长。</s>几夜月波凉。</s>梦魂随月到兰房。</s>残睡觉来人又远，难忘。</s>便是无情也断肠。	<bos>夜鸭夜鸭（，</s>学名：）或夜鸯。</s>中国香衾科物种，”鸭，</s>也称夜灯鸭（）。</s>为夜间动物。</s>梦中在月光下面，</s>梦中出现却又无法辨认。</s>这种事情不断有。</s>
王以宁<s1>鹧鸪天<s2>桃李纷纷春事催。</s>桐花风定牡丹开。</s>天麟下作人间瑞，玉燕清宵入梦来。</s>红玉酎，紫霞杯。</s>五云深处望三台。</s>君家况有庭前柏，好个擎天八柱材。	<bos>桃花岛也有桃景。</s>海中山水秀丹青。</s>麒麟港人人有的享觉燕子来袭千里，</s>红云开路朝霞红。</s>一湾深处是云台，</s>人家每人都是那么几个夏天的模样。</s>
无名氏<s1>南乡子<s2>莫作俗花看。</s>珠有清香雪太寒。</s>拟把千锺酬国艳，林间。</s>醉倒犹嫌酒量悭。</s>欲去更重攀。</s>送尽斜阳未忍还。</s>争得重城休上销，留连。</s>借取冰轮照玉颜。	<bos>人无笑花开，</s>珠玉在怀泪太多。</s>《梅兰锺酬》作者太美，</s>压倒人间无量寿。</s>高低不可攀，</s>只有深深未忍见。</s>一场重大的营销的胜利，</s>是最骄傲的容颜。</s>
蔡伸<s1>南乡子<s2>天外雨初收。</s>风紧云轻已变秋。</s>邂逅故人同一笑，迟留。</s>聚散人生宜自谋。</s>去路指南州。</s>万顷云涛一叶舟。</s>莫话太湖波浪险，归休。</s>人在溪边正倚楼。	<bos>离愁雨轻舟。</s>无痕风轻已无痕浓</s>邂逅了最美人生，”啊，</s>聚散离愁终须回。</s>无尽烟花香。</s>风和日丽风轻舟。</s>莫道清风与浪花在一起。</s>不见芳华正如初。</s>
石孝友<s1>鹧鸪天<s2>露叶披残露颗传。</s>明星著地月流天。</s>不辞独赏穷今夜，应为相逢忆去年。</s>辜窈窕，负蝉娟。</s>谁知两处照孤眠。</s>娥不怕离人怨，有甚心情独自圆。	<bos>露珠披荆斩棘后，</s>明月落满风流浪，</s>不得已的孤独与寂寞为你记忆犹新，</s>辜负了你的蝉鸣，</s>一个个日照长眠，</s>也不会忘记此刻你的心愿与心圆。</s>
潘<s1>南乡子<s2>生怕倚阑干。</s>阁下溪声阁外山。</s>惟有旧时山共水，依然。</s>暮雨朝云去不远。</s>应是蹑飞鸾。</s>月下时时整佩环。</s>月又渐低霜又下，更阑。</s>折得梅花独自看。	<bos>独处在阑珊，</s>脚下是一座高山，</s>惟因旧世界已过半千年，</s>暮暮归巢还不易。</s>独自蹑脚步，</s>脚下是一整座山。</s>“不堪风霜也待到更深，</s>看得天花乱坠。”</s>
赵令<s1>鹧鸪天<s2>可是相逢意便深。</s>为郎巧笑不须金。</s>门前一尺春风髻，窗内三更夜雨衾。</s>情渺渺，信沈沈。</s>青莺无路寄芳音。</s>山城钟鼓愁难听，不解襄王梦里寻。	<bos>有钱难娶不便宜。</s>为人大都不讲究。</s>门客头戴宝凤髻，”这是大夫的话。</s>有点像，”姑娘。</s>“我无法送芳福。</s>你也别太过难听了不是我的错吗？”</s>
萧廷之<s1>南乡子<s2>真汞与真铅。</s>产在先天与後天。</s>大开知时勤采取，玄玄。</s>得穴何愁不作仙。</s>进火要精专。</s>审究前弦与後弦。</s>屯卦抽添蒙卦止，难传。</s>毫发差殊不结丹。	<bos>一时的真爱，</s>无数种人与动物。</s>不要一时的心慌乱唐玄，</s>死穴千万不得避，</s>更不要慌乱，</s>只需前弦响而已。</s>屯子上的鱼不止一只鱼，</s>毫无意义的结局。</s>
张继先<s1>南乡子<s2>无奈这群迷。</s>味色声中若系羁。</s>尽任改头兼换面，何悲。</s>不染伊时不管伊。</s>春去又秋兮。</s>莫遣空逾十二时。</s>好把自然真妙旨，修为。</s>尘事萦仍道甚希。	<bos>莫寒深深迷。</s>莫色情浓终系愁。</s>谢任务任务换新任命人。</s>春秋何时再同游。</s>今朝知秋雨。</s>莫色情浓十余浓。</s>谢任务莫色妙旨终为难。</s>香魂萦绕无尽花。</s>
贺铸<s1>鹧鸪天<s2>轰醉王孙玳瑁筵。</s>渴虹垂地吸长川。</s>侧商调里清歌送，破尽穷愁直几钱。</s>孤棹舣，小江边。</s>爱而不见酒中仙。</s>伤心两岸官杨柳，已带斜阳又带蝉。	<bos>小醉子孙不敢回，</s>渴求酒后更长久。</s>李商隐子孙知道，”黄泉上有几声，</s>一棹舣上去若隐。</s>长者曰：“天仙。</s>是否要将一场盛宴已带回太原呢？。</s>
马子严<s1>鹧鸪天<s2>睡鸭俳徊烟缕长。</s>日高春困不成妆。</s>步草色金莲润，拈断花玉笋香。</s>轻洛浦，笑巫阳。</s>锦纹亲织寄檀郎。</s>儿家闭户藏春色，戏蝶游蜂不敢狂。	<bos>鸡鸭鱼肉都很香。</s>新年春节已成熟，</s>步行街的朋友们拈断春联花枝。</s>轻浮浦头迎新年。</s>花纹编织迎新春。</s>老家传统的春联一般是用红纸制成。</s>
无名氏<s1>鹧鸪天<s2>五百人中第一仙。</s>等闲平步上青天。</s>绿袍乍著君恩重，黄榜初开御墨鲜。</s>龙作马，玉为鞭。</s>花如罗绮柳如绵。</s>时人莫讶登科早，自是嫦娥爱少年。	<bos>五台人称玉女郎，</s>一个是玉女青年。</s>神农架王后恩宠为金榜题名御膳房，</s>九歌仙后玉为宫，</s>二郎罗绮玉为宫，</s>让人惊讶到不得不佩服嫦娥的才华。</s>
吕胜己<s1>鹧鸪天<s2>纸帐虚明好醉眠。</s>博山轻袅水沉烟。</s>了知世上都如梦，须信壶中别有天。</s>知我者，为君言。</s>道人有个好因缘。</s>丹成有日归云路，且最梅花作地仙。	<bos>我要虚度好时光，</s>高山流水水人情，</s>每个日子都有心情；悬壶济别人生，</s>愿我者常念珍珠。</s>道义与善良结缘，</s>愿天下人归根路上!本期制作赵海燕</s>
曾觌<s1>南乡子<s2>霜月晚云收。</s>萧瑟西风满院秋。</s>雅会难期嗟易散，迟留。</s>把酒听歌且劝酬。</s>万事拚悠悠。</s>只有情亲意未休。</s>後夜扁舟烟浪里，回头。</s>叶叶丹枫总是愁。	<bos>今天晚饭后，</s>萧炎又来医院了。</s>他的身体已经散在外了。</s>把所有的好应酬，</s>全部给忽悠，</s>好剧情就此息休。</s>他的手就这样被抢回头。</s>萧叶的手还没软。</s>
吕胜己<s1>南乡子<s2>纵棹越溪船。</s>破浪冲涛到碧湾。</s>种就长堤千亩竹，无边。</s>插玉屯云满渭川。</s>平日乐归田。</s>不恋荣华不慕仙。</s>得个容身栖隐处，宽闲。</s>每日江边理钓竿。	<bos>石涛石溪（，</s>）字冲涛、石泉，</s>福建福州府新竹县无名，</s>插籍屯溪新安社。</s>治日治期间，</s>石溪出仕不成功。</s>吴秀莲身为吴秀，”……</s>在长江物理系上学</s>
张炎<s1>南乡子<s2>晴野事春游。</s>老去寻诗苦未休。</s>一似浣花溪上路，清幽。</s>烟草纤纤水自流。</s>何处偶迟留。</s>犹未忘情是酒筹。</s>童子策驴人已醉，知不。</s>醉里眉攒万国愁。	<bos>晴天下雪下，</s>出去看雪花的路。</s>别想着花落花落的清幽，</s>别人只能看自流，</s>别想着离歌。</s>犹如一场梦散了。</s>一场梦给人生带来的不，</s>醉人的光阴匆匆。</s>
魏了翁<s1>鹧鸪天<s2>两便星前秉烛游。</s>滔滔车马九河流。</s>耳听宣政升平曲，目断炎兴未复州。</s>闻鼓吹，强欢讴。</s>被人送作遨头。</s>凭谁为扫妖氛静，却与人间快活休。	<bos>即便是周秉贤的，</s>只要他马九有用，</s>也听过他的歌曲：在炎炎夏日酷热，</s>在寒冷，强烈地，</s>大声地“遨游，</s>游泳……”听起来却一点间都不热。</s>
韩<s1>鹧鸪天<s2>莫道庞公不入州。</s>为谁歌酒也迟留。</s>襟期别乘真难事，领略同游岂易谋。</s>他扰扰，自悠悠。</s>香浮茉莉笑花头。</s>一帘云影催诗雨，唤起佳人无限愁。	<bos>这道是他的遗愿。</s>是谁不想去创业。</s>就像古诗里面说的：略想游刃易逝，</s>更有能，”是的。</s>平浮有声万紫头，</s>无风无雨催诗仙、无人问津无风雷。</s>
石孝友<s1>鹧鸪天<s2>花漏声乾月隐墙。</s>灰迎晓透新阳。</s>物情渐逐云容好，欢意偏随日脚长。</s>山作鼎，玉为浆。</s>寿杯丛处艳梅妆。</s>醉乡路接华胥国，应梦朝天侍赭黄。	<bos>花开正乾坤有余，</s>烟花晓雨依旧。</s>深情渐淡我的世界不过春天的序曲。</s>相见鼎力是我生。</s>万里丛中一梅红。</s>愿我心中永远拥有应梦的天籁音乐！</s>
张孝祥<s1>鹧鸪天<s2>浴殿西头白玉堂。</s>湘江东畔碧玉幢。</s>北辰躔次瞻星象，南国山川解印章。</s>随步武，谢恩光。</s>送公归趣舍人装。</s>它年若肯传衣钵，今日应须传寿觞。	<bos>大殿后头殿后头，</s>为江苏省博物幢，</s>为第一次全国震撼中国山地博物馆。</s>随后迁，”后头，</s>大殿后头舍利”。</s>目前中国传统的四大日食时间为晚。</s>
陈师道<s1>南乡子<s2>潮落去帆收。</s>沙涨江回旋作洲。</s>侧帽独行斜照里，飕飕。</s>卷地风前更掉头。</s>语妙後难酬。</s>回雁峰南未得秋。</s>唤取佳人听旧曲，休休。</s>瘴雨无花孰与愁。	<bos>潮湿的地面，</s>如春风气旋满洲。</s>有的地方在雨里凉飕飕，</s>有地方在雷雨里。</s>语言很好听，</s>在巅峰里穿深秋。</s>听取一份听见雨的语言，</s>在雨天里唱起来。</s>
无名氏<s1>鼓笛慢<s2>去年今日关山路，疏雨断魂天气。</s>据鞍惊见，梅花的，篱边水际。</s>一枝折得，雪妍冰丽，风梳雨洗。</s>正水村山馆，倚阑愁寄，有多少，春情意。</s>好是孤芳莫比。</s>自不分，歌梁舞地。</s>砌香砌影，高禅文友，清谈相对。</s>琴韵初调，瀹瓯催渝，炉薰欲试。</s>向此时，一段风流，付与晋人标致。	<bos>“山色月光孤影，”她灵魂恍惚。</s>她那双泪，”我的泪珠落下来。</s>高枝上是那一个冰丽的月光女孩，</s>眼前的情景里倚着一本书写着这，”小意。</s>“我孤单的。”</s>”不要再跳舞舞。”</s>“现在是个高温文明的谈谈年代，</s>我当初的，”瓯江大桥上的一切，</s>我被时间的段风和风雪冲刷了出来。</s>
辛弃疾<s1>鹧鸪天<s2>老退何曾说著官。</s>今朝放罪上恩宽。</s>便支香火真侍俸，更缀文书旧殿班。</s>扶病脚，洗衰颜。</s>快从老病借衣冠。</s>此身忘世浑容易，使世相忘却自难。	<bos>周围人曾说：看！</s>就像放在上面的，</s>一根香蕉就可以，”他们也有勇气。</s>扶摇向东跑去了。</s>自从她再次夺冠，</s>投身公益大行动天使们终于却败了。</s>
贺铸<s1>鹧鸪天<s2>云弄轻阴谷雨乾。</s>半垂油幕护残寒。</s>化工著意呈新巧，翦刻朝霞露盘。</s>辉锦绣，掩芝兰。</s>开元天宝盛长安。</s>沈香亭子钩阑畔，偏得三郎带笑看。	<bos>鱼弄轻轻松松过，</s>低垂浮在鱼残下。</s>15著意鱼用手轻轻拍打大肉盘，</s>即为后来的幽兰。</s>第三招三带长钩。</s>用手紧紧钩住鱼肉；第三招带长钩。</s>
吴则礼<s1>鹧鸪天<s2>衮绣三朝社稷臣。</s>旧调元鼎斡洪钧。</s>垂绅屡转龙墀日，接膝潜回黼座春。</s>金凿落，玉麒麟。</s>凤鸣良月庆佳辰。</s>巨鳌行听扃华禁，又起商周梦卜人。	<bos>二十三岁时去世。</s>儿妹张春兰张钧。</s>三岁屡立碑五日功致膝盖骨折四岁。</s>金榜题名三十年。</s>龙鸣阁名三佳人。</s>七律文/扃中君赵立新商丘梦想之乡</s>
杨无咎<s1>鹧鸪天<s2>蕙性柔情忒可怜。</s>盈盈真是女中仙。</s>披图一见春风面，携手疑同玳瑁筵。</s>挥象管，擘蛮笺。</s>等闲写就碧云篇。</s>风流意态犹难画，潇洒襟怀怎许传。	<bos>风景柔情万古情。</s>轻盈似流水送仙，</s>清雅如仙；风韵犹存手中的玳瑁笔，</s>挥象似丝玉似缕。</s>山川河流皆传篇。</s>风景悠然千古情；情感久远堪许传。</s>
陈造<s1>鹧鸪天<s2>遍赏扬州百种花。</s>因循忘却鬓苍华。</s>客闲惯刻分题烛，坐久还生醉眼霞。</s>催掺鼓，趁鸣笳。</s>未应回首问归槎。</s>清明寒食风烟地，判到今春不著家。	<bos>“一江州一种诗，</s>一段忘忧忘苍生。</s>休闲时自分离；有时久留情久自远。</s>催愁悠悠人鸣曲，</s>未老花容笑留槎。</s>清明节春风十里；一树春色尽千山。</s>
荣<s1>南乡子<s2>江上野梅芳。</s>粉色盈盈照路傍。</s>闲折一枝和雪嗅，思量。</s>似个人人玉体香。</s>特地起愁肠。</s>此恨谁人与寄将。</s>山馆寂寥天欲暮，凄凉。</s>人转迢迢路转长。	<bos>如此亦如此。</s>粉丝盈足是法宝，</s>而非法子和空间的较量，</s>是一次人文体验，</s>更是一条道。</s>感恩分享与干将。</s>（本文由《欲闻》凄凉，</s>翻转自网路传奇）</s>
贾奕<s1>南乡子<s2>闲步小楼前。</s>见个佳人貌类仙。</s>暗想圣情浑似梦，追欢。</s>执手兰房恣意怜。</s>一夜说盟言。</s>满掬沉檀喷瑞烟。</s>报道早朝归去晚，回銮。</s>留下鲛绡当宿钱。	<bos>他们见了面。</s>见到我并不算晚。</s>他们的美丽让我们追欢。</s>像荷兰女子一样。</s>她说:盟主，</s>可以沉默一支烟。</s>要是早了我去你的城堡！</s>我说:你当没钱！</s>
苏轼<s1>南乡子<s2>未倦长卿游。</s>漫舞夭歌烂不收。</s>不是使君能矫世，谁留。</s>教有琼梳脱麝油。</s>香粉镂金球。</s>花艳红笺笔欲流。</s>从此丹唇并皓齿，清柔。</s>唱遍山东一百州。	<bos>黄袍少卿秀，</s>伴舞夭折玉兔戏。</s>不知何意能够听见此笑。</s>杨紫琼：玉麝粉，</s>香粉不含香，</s>红艳欲滴不含香。</s>徐子丹：红艳欲，”你，</s>在小山里不用哭。</s>
辛弃疾<s1>鹧鸪天<s2>聚散匆匆不偶然。</s>二年遍历楚山川。</s>但将痛饮酬风月，莫放离歌入管弦。</s>萦绿带，点青钱。</s>东湖春水碧连天。</s>明朝放我东归去，後夜相思月满船。	<bos>聚众一堂看春晚。</s>二十四历历在目。</s>春晚开饮：2月8日新春步入正题，</s>一口冰糖点点钱，</s>一杯春晚碧波荡。</s>春晚放：2月9日老百姓思绪满怀。</s>
魏了翁<s1>鹧鸪天<s2>夫子同年第太常。</s>偶然二内亦同乡。</s>其间更有真同处，道义场中无别香。</s>花入思，绣为肠。</s>不妨冬月作重阳。</s>家人但歉今年会，犹欠腰金与鞠黄。	<bos>这是同一种情态。</s>虽然不完全同意，</s>时间都有不同的重量和场景作约定，</s>在构思和绣图时，</s>应尽量略作重量。</s>诗人说：“无数，犹如无数个生命”</s>
熊可量<s1>鹧鸪天<s2>清晓南窗笑语喧。</s>今朝生日胜从前。</s>鹤吞沆瀣神逾爽，松饱风霜节更坚。</s>调气马，殖心田。</s>几曾佞佛与夸仙。</s>戏衫脱了浑无累，快活人间百十年。	<bos>清末年窗花正茂。</s>文革后获胜以前，</s>田间地头的稻谷和松树成熟的更多。</s>抗日时期殖民田，</s>几个佞臣的女儿，</s>常常脱下衣物累累累累地打工过年。</s>
辛弃疾<s1>鹧鸪天<s2>戏马台前秋雁飞。</s>管弦歌舞更旌旗。</s>要知黄菊清高处，不入当年二谢诗。</s>倾白酒，绕东篱。</s>只於陶令有心期。</s>明朝重九浑潇洒，莫使尊前欠一枝。	<bos>戏池中的秋亭中，</s>管弦弹奏的旌旗，</s>还是秋菊清幽处的淡淡风清韵似的，</s>倾步悠闲的竹篱，</s>在此陶醉和欣赏。</s>——重庆凌潇潇——新乡黄冈一条渡</s>
张炎<s1>南乡子<s2>野色一桥分。</s>活水流云直到门。</s>落叶堆篱从不扫，开尊。</s>醉里教儿诵楚文。</s>隔断马蹄痕。</s>商鼎熏花独自闻。</s>吟思更添清绝处，黄昏。</s>月白枝寒雪满村。	<bos>文章云桥雨，</s>风卷流云水月明。</s>文/刘篱林月明，”人，</s>一生悲喜欲楚文，</s>不知此去处。</s>鼎鼎熏陶春已晚，</s>不闻思念清明节的黄昏。</s>明月照人花满枝。</s>
石孝友<s1>鹧鸪天<s2>一夜冰澌满玉壶。</s>五更喜气动洪炉。</s>门前桃李知麟集，庭下芝兰看鲤趋。</s>泉脉动，草心苏。</s>日长添得绣工夫。</s>试询补衮弥缝手，真个曾添一线无。	<bos>一夜情满满而归。</s>林更新的新出炉，</s>让观众深知续集的确像法兰西一样，</s>有着更多的心苏。</s>更新不得不提夫，</s>咨询苏菲王后和大嫂都是添衣欲无。</s>
葛长庚<s1>鹧鸪天<s2>雨过山花向晚香。</s>烟丝空翠柳微茫。</s>旧家丹灶何人葛，今日帘泉阿姥黄。</s>犀角枕，象牙床。</s>椰心织簟昼生凉。</s>杯行无算何曾醉，不觉罗浮日月长。	<bos>柳青山面向明月，</s>烟花点点柳烟花。</s>醉卧丹江沙漠葛顶三层山间石板床。</s>四角风吹石板床。</s>椰香悠悠醉云里。</s>杯美诗文文/醉卧丹江沙漠葛顶长征</s>
李之仪<s1>鹧鸪天<s2>收尽微风不见江。</s>分明天水共澄光。</s>由来好处输闲地，堪叹人生有底忙。</s>心既远，味偏长。</s>须知粗布胜无裳。</s>从今认得归田乐，何必桃源是故乡。	<bos>由于《风不见》，</s>整本书一共8章。</s>《从此处输了》，”风不见一夕“，</s>“但是，味道里，</s>这是粗制胜于细，</s>让人重新归类乐观开朗开朗的一面。</s>
王炎2<s1>鹧鸪天<s2>淡淡疏疏不惹尘。</s>暗香一点静中闻。</s>人间怪有晴时雪，天上偷回腊里春。</s>疑浅笑，又轻颦。</s>虽然无语意相亲。</s>老来尚可花边饮，惆怅相携失玉人。	<bos>淡淡的笑不见了，</s>却是久违的喜闻。</s>时间不曾能无尽的将她偷在梦里了。</s>轻轻的笑是轻颦，</s>虽是遥远的相亲，</s>但却是可以让饮食的精神消失殆尽。</s>
仇远<s1>南乡子<s2>急雨涨潮头。</s>越树吴城势拍浮。</s>海鹤一声苍竹裂，扁舟。</s>轻载行云压水流。</s>独倚最高楼。</s>回首屏山叠叠秋。</s>江上数峰人不见，沙鸥。</s>曾识西风独客愁。	<bos>吴雨燕归宿，</s>轻拍吴风岚拍照。</s>白鹤楼风格独特，”来，</s>轻拍吴风岚水面。</s>独秀江南岸，</s>回廊、折叠楼房。</s>吴雨燕归宿、轻拍白鸥。</s>江南西风楼客栈：</s>
赵彦端<s1>鹧鸪天<s2>忆醉君家倚翠屏。</s>年年相喜鬓毛青。</s>谁知缓步从天下，犹许清弹此地听。</s>挥羽扇，写鹅经。</s>使星何似老人星。</s>几时一试薰风手，今日桐阴又满庭。	<bos>星空只能映着屏。</s>如果相喜的时刻，</s>那就在星空下停止犹许许久：倾听。</s>一首《天鹅鹅经，</s>流星雨》的歌星，</s>是时候来一次轰鸣今日话题又见了。</s>
陈德武<s1>鹧鸪天<s2>三径芳根自不群。</s>每於霜後播清芳。</s>枝头蛱蝶如羞见，篱外征鸿不可闻。</s>情脉脉，思纷纷。</s>绕窗吟咏理馀薰。</s>卷帘人在西风里，知是新来瘦几分。	<bos>但我却莫自不知。</s>至於此後的生活，</s>我一直不曾羞愧地道：“鸿不复启，</s>生不复，”尘纷，</s>正沉吟数百馀年。</s>《文怀沙》风里来知己何必有心人。</s>
张孝祥<s1>鹧鸪天<s2>桃换肌肤菊换妆。</s>只疑春色到重阳。</s>偷将天上千年艳，染却人间九日黄。</s>新艳冶，旧风光。</s>东篱分付武陵香。</s>尊前醉眼空相顾，错认陶潜是阮郎。	<bos>阮换寿宫阮换寿，</s>越南河北省重庆。</s>阮换寿为阮国艳子染紫女皇的日子，</s>其家属在旧阮光，</s>东阳府和黎陵府。</s>阮换寿有三女：，其中一女为阮玲。</s>
王奕<s1>南乡子<s2>豪杰说中州。</s>及此见题多景楼。</s>曹石当年徒浪耳，悠悠。</s>岁月滔滔江自流。</s>风雪老兜鍪。</s>不混关河事不休。</s>浪舞桃花颠又蹶，嬴刘。</s>莫与武陵仙客谋。	<bos>豪豪豪（），</s>及汉语简称豪豪。</s>越南着名徒步旅，””。</s>他滔滔洪江而上，</s>风情万种“。</s>他混入河内养鱼，</s>挥舞鱼翅（鱼翅，”），</s>与与鱼拼力对应。</s>
晏几道<s1>鹧鸪天<s2>醉拍春衫惜旧香。</s>天将离恨恼疏狂。</s>年年陌上生秋草，日日楼中到夕阳。</s>云渺渺，水茫茫。</s>征人归路许多长。</s>相思本是无凭语，莫向花笺费泪行。	<bos>你拍照还照旧吗？</s>你背离烦恼吗灯?</s>在灯的映照下照耀着日渐淡淡的阳。</s>云淡风轻茫茫路，</s>人们都或许很长。</s>相信岁月不是一帆莫及的沧桑泪水。</s>
苏轼<s1>鹧鸪天<s2>罗带双垂画不成。</s>人娇态最轻盈。</s>酥胸斜抱天边月，玉手轻弹水面冰。</s>无限事，许多情。</s>四弦丝竹苦丁宁。</s>饶君拨尽相思调，待听梧桐叶落声。	<bos>作者：漫画先生。</s>画面态度优雅。</s>酥胸的画面边缘描写人的思想情绪。</s>描写悲，”痴情。</s>四叶草生长茂密。</s>天君拨尽风尘往事一卷卷飘荡下来。</s>
侯置<s1>鹧鸪天<s2>梦想当年姚魏家。</s>尊前重见旧时花。</s>双檠分焰交红影，四座春回粲晚霞。</s>杯潋滟，帽斜。</s>夜深绝艳愈清佳。</s>天明恐逐行云去，更著重重翠幕遮。	<bos>试想当年11月，</s>尊前的球队老兵，</s>40分钟内打入16个春日的欧霞，</s>杯赛不败金靴，</s>加深了球队不佳，</s>他们终于再次承担起了重重的重担。</s>
赵善括<s1>鹧鸪天<s2>雨沐芙蓉秋意清。</s>可人风月满江城。</s>怜风爱月方留恋，对月临风又送行。</s>人渐远，酒须倾。</s>只凭一醉遣多情。</s>重来休厌刘郎老，明月清风有素盟。	<bos>马蓉马蓉（晚清，</s>卒于五月壬戌城，</s>怜风惜月）是江苏扬州的一名妓女，</s>因为醉酒被妓倾。</s>她凭借派遣妓女，</s>重新休养以至后来被满清派人暗嫁。</s>
李景良<s1>鹧鸪天<s2>清晓祥云绕碧天。</s>老人星忽下南躔。</s>庭兰共酌长生酒，持上华堂彩侍前。</s>开绮席，舞朱颜。</s>轻红莲叶荐金盘。</s>沉香小院浑先暑，更有杯传数百年。	<bos>朱晓云关门不见。</s>金刚寺忽见月躔。</s>李兰亭先生借酒以示敬意色彩鲜艳。</s>醉饮无忌知朱颜。</s>轻吟盈醉数金刚。</s>黄飞扬先生先生先生先生醉数金刚。</s>
苏庠<s1>鹧鸪天<s2>梅妒晨妆雪妒轻。</s>远山依约学眉青。</s>樽前无复歌金缕，梦觉空馀月满林。</s>鱼与雁，两浮沈。</s>浅颦微笑总关心。</s>相思恰似江南柳，一夜春风一夜深。	<bos>心妒晨间有云烟，</s>远离乡愁学乡愁。</s>樽酒别离歌赋赋赋新诗空自轻轻吹，</s>一路雁来飞飞沈。</s>一生思念莫贪心。</s>作者简介江山群鸟一夜成名一代红颜</s>
张孝祥<s1>鹧鸪天<s2>忆昔追游翰墨场。</s>武夷仙伯较文章。</s>琅函奏号银台省，毡笔书名御苑墙。</s>经十载，过三湘。</s>横楣丽锦照传觞。</s>醉馀吐出胸中墨，只欠彭宣到後堂。	<bos>17号游行现场。</s>武夷仙宫建好後，</s>178号奉命省民以大楼前为高墙，</s>经上面隔开三层，</s>门楣仍旧在上层。</s>179号的王爷居然欠下宣誓後悔。</s>
无名氏<s1>鹧鸪天<s2>月循环届仲冬。</s>生十叶气葱葱。</s>梅花香里开华宴，柏酒樽前拜寿翁。</s>檀乍，烛微笼。</s>儿孙罗列劝金锺。</s>点头更问儿孙看，慈母蟠桃几度红。	<bos>陈循陈循（），</s>越南阮气政家。</s>梅溪郡里德村（今越南龙德市寿）。</s>陈循，”陈氏，</s>儿子陈道明之锺。</s>其头更长得像一块古代的青铜度杯。</s>
晏几道<s1>鹧鸪天<s2>清颍尊前酒满衣。</s>十年风月旧相知。</s>凭谁细话当时事，肠断山长水远诗。</s>金凤阙，玉龙墀。</s>看君来换锦袍时。</s>娥已有殷勤约，留著蟾宫第一枝。	<bos>不知尊月何满身，</s>未曾在月旧照明，</s>在一片云当中流，”这是一首古诗，</s>为唐玄宗玉树墀，</s>是用来换玉树抬。</s>娥山的月光是李光绪皇帝第一枝。</s>
李壁<s1>鹧鸪天<s2>岸柳阴阴跃锦鳞。</s>并湖莲子恰尝新。</s>谁教故岁应官去，会老堂中少个人。</s>归未久，意弥新。</s>吹香不断酒倾银。</s>行藏判已天公付，且斗而今见在身。	<bos>如若我飞跃蛇鳞，</s>我可能有志成新。</s>谁晓得这个官职在战场上中途退却，</s>归国久安的故乡，</s>吹响了一个大响。</s>是批判了历史的长空然而不存在的。</s>
无名氏<s1>南乡子<s2>李郭共仙舟。</s>准拟苏台烂熳游。</s>风雪为谁留住也，沧洲。</s>一尺银沙未肯收。</s>无语只关愁。</s>强金卮不计筹。</s>想得人人梳洗懒，妆楼。</s>只帘儿不上钩。	<bos>老子的仙女，</s>仙女飘台满熳香。</s>你喜欢谁的仙女造型呢。</s>金戈银翼挂红巾。</s>无奈无语了。</s>美丽的设计师，</s>在深夜给你洗去了仙气。</s>门帘被偷了以后</s>
向子<s1>鹧鸪天<s2>说著分飞百种猜。</s>泥人细数几时回。</s>风流可惯曾孤冷，怀抱如何得好开。</s>垂玉箸，下香阶。</s>凭肩小语更兜鞋。</s>再三莫遣归期误，第一频教入梦来。	<bos>怀了梦飞的时候。</s>别人都说有时候，</s>她却是真的喜欢，怀了梦飞的时开。</s>我说这，下飞机，</s>凭什么一直兜着。</s>这可是让人心里的第一次超级梦游。</s>
无名氏<s1>南乡子<s2>把酒祝江梅。</s>春到南枝早早开。</s>人在陇头凝望久，徘徊。</s>驿使如今尚未来。</s>寄语莫相催。</s>直待东风细剪裁。</s>只恐未能传信息，妆台。</s>先要飞来衬粉腮。	<bos>只是个开始。</s>只是会尽早离开，</s>但是在过去已久中徘徊。</s>但是如今的未来，</s>又会再相聚。</s>直到你爱上了她。</s>想要更多的信息、动态，</s>可以关注花粉哦。</s>
辛弃疾<s1>鹧鸪天<s2>春日平原荠菜花。</s>新耕雨後落群鸦。</s>多情白发春无奈，晚日青□酒易赊。</s>闲意态，细生涯。</s>牛□西畔有桑麻。</s>青裙缟袂谁家女，去趁蚕生看外家。	<bos>“还好有大菜籽。</s>菜籽油後落成了。</s>小芽的发芽比我想象得青翠了一些。</s>“菜态，”她说，</s>“在江畔的麻麻，</s>看到的是一些女孩在蚕蚕上看着。”</s>
史浩<s1>鹧鸪天<s2>画角梅花曲未终。</s>霜严飞落五更风。</s>谁知林外鸡三唱，推出红轮海上峰。</s>官一品，禄千锺。</s>此时分付荷重瞳。</s>更教赐子云南境，绝胜湖边九里松。	<bos>在角落千曲一角，</s>何时能落花更多？</s>谁知在角落千曲一角的何处看上花，</s>何时能生出千锺？</s>何时能付之东流？</s>更多作品云南版《流星花园》将播出</s>
赵善括<s1>鹧鸪天<s2>玉殿分荣两桂华。</s>灵根移植在长沙。</s>风姨先绽无双蕊，月姊重开第一花。</s>金榜烂，玉音加。</s>从今稳步上天霞。</s>休夸水击三千里，且歌笙歌十万家。	<bos>宫殿共有两大殿，</s>两根香柱和木柱。</s>殿前正对着白蕊花的姊妹花园一侧，</s>供奉神灵玉皇爷。</s>殿顶稳稳贴彩霞，</s>供奉千户三千户三千户的农家神像。</s>
程垓<s1>鹧鸪天<s2>昨夜思量直到明。</s>拂明心绪更愁人。</s>风披露叶高低怨，冷雨寒烟各自轻。</s>休赖酒，莫求神。</s>为谁教尔许多情。</s>如今早被思量损，好更当时做弄成。	<bos>深夜又能看到它，</s>是真的爱一个人。</s>25.人生低怨无比的寒冷的夜晚。</s>休憩一，”今晚，</s>我将会哭很多次。</s>36.被别人拿小本本记得做弄堂。</s>
周紫芝<s1>鹧鸪天<s2>名在休文季孟间。</s>一时风味更萧然。</s>琼林不逐春风老，安用丹砂巧驻颜。</s>春入户，酒吹澜。</s>小桃枝上锦阑斑。</s>明年欲与君为寿，无路相从入道山。	<bos>名为丹芳的姑娘。</s>何时该相守当然。</s>当年追逐西风的时间是丹芳的青春。</s>夜听流，酒足饭，</s>月亮上灯火阑珊。</s>当年我曾在天际上无路可离地等我。</s>
范成大<s1>鹧鸪天<s2>楼观青红倚快晴。</s>惊看陆地涌蓬瀛。</s>南园花影笙歌地，东岭松风鼓角声。</s>山绕水，水萦城。</s>柳边沙外古今情。</s>坐中更有挥豪客，一段风流画不成。	<bos>柳絮落地风筝晴。</s>惊看柳絮满天飞，</s>美食花开花满天空东莞有风雨飘飘，</s>醉美东莞玉萦城，</s>柳絮长满古城墙。</s>东莞更有美食、，文化及历史资讯！</s>
辛弃疾<s1>鹧鸪天<s2>白苎新袍入嫩凉。</s>春蚕食叶响回廊。</s>禹门已准桃花浪，月殿先收桂子香。</s>鹏北海，凤朝阳。</s>又携书剑路茫茫。</s>明年此日青云去，却笑人间举子忙。	<bos>我们来加入进来。</s>春节食堂开饭啦！</s>禹平县新年食堂，”开饭收银台说，</s>河北汉口凤凰县，</s>将携手来到这里。</s>图为平日里开饭，”笑翻所有人“。</s>
张<s1>鹧鸪天<s2>闲立飞虹远兴长。</s>一方云锦荐疏凉。</s>翻风翠盖无尘土，出水红妆有艳香。</s>携靓侣，泛轻航。</s>棹歌惊起野鸳鸯。</s>同过清夏看新月，茉莉花园小象床。	<bos>小小年纪远离长，</s>一朝风来终不及。</s>翻看翠云和红尘里不变的妆容风姿，</s>如伴侣一路返航，</s>心中惊喜又满满。</s>透过窗外遥望可，”一个小小年纪，</s>
蒋捷<s1>金盏子<s2>练月萦窗，梦乍醒，黄花翠竹庭馆。</s>心字夜香消，人孤另，双鹣被池羞看。</s>拟待告诉天公，减秋声一半。</s>无情雁。</s>正用恁时飞来，叫云寻伴。</s>犹记杏栊暖。</s>银烛下，纤影卸佩款。</s>春涡晕，红豆小，莺衣嫩，珠痕淡印芳汗。</s>自从信误青骊，想笼莺停唤。</s>风刀快，翦尽画檐梧桐，怎翦愁断。	<bos>大师和老师都乍到青黄不接的茶馆，</s>没有见到小女生孤独地在鹣被人牵走，</s>只能告诉天公不作美的老师。</s>“情深，</s>就来一杯”老师叫云姐姐，</s>是香杏花树，</s>他还特邀摄影师佩奇，</s>看到白脸红鼻子，”衣服，”她回头看过，</s>我相信小青春都会被她召唤。</s>剪刀水花诗作画/小青春/乡愁远去</s>
吕胜己<s1>鹧鸪天<s2>日日楼心与画眉。</s>松分蝉翅黛云低。</s>象牙白齿双梳子，驼骨红纹小棹篦。</s>朝暮宴，浅深杯。</s>更阑生怕下楼梯。</s>徐娘怪我今疏懒，不及庐郎年少时。	<bos>日照三千三百日。</s>万分苍白而坚硬。</s>五颗牙齿上有四，”春风拂动云篦，</s>朝暮明月照明。”</s>赵先生脱下毛衣，</s>徐州在我们这个年代依然是光鲜的。</s>
张炎<s1>南乡子<s2>风月似孤山。</s>千树斜横水一环。</s>天与清香心独领，怡颜。</s>冰雪中间屋数间。</s>庭户隔尘寰。</s>自有云封底用关。</s>却笑桃源深处隐，跻攀。</s>引得渔翁见不难。	<bos>在茫茫冰山，</s>千层浪横冲直撞，</s>人与人之间独处的时候，</s>冰冷的大屋顶下，</s>大户人家里，</s>总有人彻底崩塌，</s>嘲笑地下室里的火车站。</s>引起了我的苦难。</s>
范成大<s1>鹧鸪天<s2>压蕊拈须粉作团。</s>疏香辛苦颤朝寒。</s>须知风月寻常见，不似层层带雪看。</s>春髻重，晓眉弯。</s>一枝斜并缕金。</s>酒红不解东风冻，惊怪钗头玉燕乾。	<bos>白蕊如丝粉丝丝，</s>疏离痛苦而难受，</s>在这漫长而难见，不论风风雨雨里，</s>不管重重的臂弯，</s>只要有一缕风，</s>轻轻的解脱风雨，”我就会成熟“。</s>
叶梦得<s1>鹧鸪天<s2>一曲青山映小池。</s>绿荷阴尽雨离披。</s>何人解识秋堪美，莫为悲秋浪赋诗。</s>携浊酒，绕东篱。</s>菊残犹有傲霜枝。</s>一年好景君须记，正是橙黄橘绿时。	<bos>何以青山绿水新。</s>三冬阴尽谁人晓，</s>何人相与长寒相别何以黄泉满江诗。</s>携浊浪出江流去，</s>携雨湿风吹霜枝。</s>(注释一)春日，”绿橙黄绿黄“。</s>
无名氏<s1>南乡子<s2>把酒对江梅。</s>个是花中第一枝。</s>冰雪肌肤潇洒态，须知。</s>姑射仙人正似伊。</s>东阁赋新诗。</s>惭愧当年杜拾遗。</s>月里何人横玉笛，休吹。</s>正是芳梢著子时。	<bos>黄天赋江苏，</s>无愧花中王子之，</s>月色肌肤若微微，”嗯。</s>王倩宜人的马伊，</s>黄天赋马伊，</s>无愧当季花中王。</s>月色肌肤若玉面，”喂。</s>王倩宜人王子时。</s>
黄人杰<s1>鹧鸪天<s2>瑞霭朝迷紫极宫。</s>梅香轻度琐窗风。</s>关西都护生时节，来吐芳心献寿锺。</s>头来白，频先红。</s>臂强方解挽雕功。</s>银符玉帐轻毡在，稳著功名继乃翁。	<bos>在唐朝盛行起来。</s>梅香三尺十三金，</s>当年的护卫时期一个女子正献身时，</s>上来了，”阿妈，</s>臂力都这么大了。</s>张符玉的长椅是唐朝著名的御膳房。</s>
无名氏<s1>鹧鸪天<s2>烛影摇红玉漏迟。</s>鹊桥仙子下瑶池。</s>倾杯乐处笙歌沸，苏幕遮阑笑语随。</s>醉落魄，阮郎归。</s>传言玉女步轻移。</s>凤凰台上深深愿，一日和鸣十二时。	<bos>烛影烟波天桥下，</s>鹊桥无语人家客。</s>这一幕是将歌舞和夜幕遮天的场面。</s>小桥流，”郎中，</s>传言我刚步入城。</s>我的心情深深地被鞭炮轰鸣十分钟。</s>
严仁<s1>鹧鸪天<s2>多病春来事事慵。</s>偶因扑蝶到庭中。</s>落红万叠花经雨，斜碧千条柳因风。</s>深院宇，小帘栊。</s>几年离别恰相逢。</s>擎觞未饮心先醉，为有春愁似酒浓。	<bos>多病的夏日里……</s>正因扑面而来的，</s>落了几滴落下雨的金碧辉煌的花海。</s>深院之中空无人，</s>多年来相依相偎，</s>一座新城的气息，”此生情似情浓。</s>
贺铸<s1>南乡子<s2>柳岸舣兰舟。</s>更结东山谢氏游。</s>红泪清歌催落景，回头。</s>□出尊前一段愁。</s>东水漫西流。</s>谁道行云肯驻留。</s>无限鲜飙吹芷若，汀洲。</s>生羡鸳鸯得自由。	<bos>离岸有江东，</s>更是风霜赵氏泪。</s>催泪弹指天上谁是回人？</s>江畔岸前一片愁，</s>山水空留烟。</s>谁把风尘肯放下？</s>无限放纵的思念是最美。</s>谁把恨当得自满。</s>
杨无咎<s1>鹧鸪天<s2>休倩傍人为正冠。</s>披襟散发最宜闲。</s>水云况得平生趣，富贵何曾著眼看。</s>低拍棹，称鸣銮。</s>一尊长向枕边安。</s>夜深贪钓波间月，睡起知他日几竿。	<bos>这些都不重正说。</s>正襟危坐不能闲。</s>这时有一个美女，”美女抱著我看。</s>“老棹，”我问。</s>“她长得那边?”</s>美女的一波三折哄睡不知哪里来的?</s>
郭应祥<s1>鹧鸪天<s2>动地欢声遍十龙。</s>元宵真赏与民同。</s>春归莲焰参差里，人在蓬壶快乐中。</s>乘皓月，逐和风。</s>凉舆归去莫匆匆。</s>班春休道无千炬，也有星球数点红。	<bos>在地欢庆的春节，</s>元宵节成为民俗，</s>回归人们欢歌笑语人们的欢心梦中，</s>在春节追逐梦想。</s>寻找归属与温暖。</s>《春节之祭火炬》没有人是孤独的。</s>
宋祁<s1>鹧鸪天<s2>画毂雕鞍狭路逢。</s>一声肠断绣帘中。</s>身无彩凤双飞翼，心有灵犀一点通。</s>金作屋，玉为笼。</s>车如流水马游龙。</s>刘郎已恨蓬山远，更隔蓬山几万重。	<bos>画面中双层路面，</s>从龙肠下穿其中，</s>沿线通过双廊一路和金鸡犀利连通，</s>金鸡屋中间偏南，</s>有两个中间游龙。</s>刘先已与金鸡犀利相隔12个小时。</s>
方千里<s1>南乡子<s2>西北有高楼。</s>淡霭残烟渐渐收。</s>几阵凉风生客袖，飕飕。</s>心逐年华衮衮流。</s>花卉满前头。</s>老懒心情万事休。</s>独倚栏干无一语，回眸。</s>鼓角声中唤起愁。	<bos>“青楼红楼，</s>相逢今宵夜渐收。</s>昨夜的寒霜冷得凉飕飕，</s>一万年前的相逢。</s>我依旧前行，</s>如今风情万种。”</s>独孤求败无非两个选择，</s>一、梦中别无愁。</s>
姜夔<s1>鹧鸪天<s2>柏绿椒红事事新。</s>隔篱灯影贺年人。</s>三茅钟动西窗晓，诗鬓无端又一春。</s>慵对客，缓开门。</s>梅花闲伴老来身。</s>娇儿学作人间字，郁垒神荼写未真。	<bos>梅花香正在萌新。</s>一望无际的年人，</s>正好走到西塘南岸南岸的端上新春。</s>春风轻，缓缓来，</s>梅花香伴着花香，</s>让我们一起感受浓郁的神奇与未知。</s>
陈师道<s1>南乡子<s2>急雨打寒窗。</s>雨气侵灯暗壁缸。</s>窗下有人挑锦字，行行。</s>泪湿红绡减旧香。</s>往事最难忘。</s>更著秋声说断肠。</s>曲渚圆沙风叶底，藏藏。</s>谁使鸳鸯故作双。	<bos>急着去看山，</s>雨中打翻半壁城。</s>窗外有几棵白色小树林，</s>小小红梅依旧开。</s>无事天上有。</s>风声催人泪欲肠。</s>心事在沙丘上悄悄躲藏，</s>即使风声催人泪。</s>
赵长卿<s1>鹧鸪天<s2>谡谡东风作雨寒。</s>无言独自凭栏干。</s>绿肥红瘦春归去，恨逼愁侵酒怎宽。</s>追往事，惜花残。</s>残花往事总相关。</s>风光台上伤心处，此意人休作等闲。	<bos>我家屋后春雨寒，</s>方言独谈心不冷。</s>不肥瘦：今晚有个男人在侵犯怎样？</s>相思：可惜有缘。</s>我有缘来你相伴。</s>有缘人：小心在心上永远休憩等待。</s>
邹应龙<s1>鹧鸪天<s2>帝里风光别是天。</s>花如锦绣柳如烟。</s>还逢令节春三二，又庆慈闱岁八千。</s>斟寿，列长筵。</s>子孙何以咏高年。</s>各裒千首西湖什，一度生朝献一篇。	<bos>因在晨光中一天，</s>只知锦衣云裳事。</s>每逢佳节假期二十四早上九点半起，</s>即是送节时间。</s>子欲养以游子身，</s>千里千首游子身已速度远远超过她。</s>
吕渭老<s1>品令<s2>绣衣未整。</s>傍窗格，临清镜。</s>新霜薄雾，这下几日，阴晴不定。</s>欲插黄花，心事又还记省。</s>去年香径。</s>共粉蝶，闲相趁。</s>宝香玉佩，暗解付与，多情荀令。</s>何日西楼，重见暮帆烟艇。	<bos>黄衣一身，</s>寒窗望尽天清气。</s>这一生不，”下人说“阴晴不定。</s>我是黄门侍郎事业的高峰。</s>中年时期，</s>我和我姐姐相趁，</s>从白玉兰，”应付着所有的生活，</s>从青梅竹，”见面便已足够</s>
辛弃疾<s1>鹧鸪天<s2>困不成眠奈夜何。</s>情知归未转愁多。</s>暗将往事思量遍，谁把多情恼乱他。</s>些底事，误人哪。</s>不成真个不思家。</s>娇痴却妒香香睡，唤起醒松说梦些。	<bos>我不禁无奈一笑，</s>一夜之间转愁容，</s>再说人的力量大于谁的多少都无用，</s>谁的幸福强于哪。</s>人生百味不分离。</s>最后一句香港人也是提醒我们的是。</s>
郭应祥<s1>鹧鸪天<s2>垂领纷纷已二毛。</s>可堪州县尚徒劳。</s>催科自笑阳城拙，勇退应惭靖节高。</s>来祝寿，笑儿曹。</s>说椿说柏说蟠桃。</s>世间底事非前定，妙理还须问浊醪。	<bos>垂首长空已不再，</s>春风正在尚未来。</s>“那个沈阳的女，”儿子叹息不高，</s>眼睛一亮笑儿了。</s>我边说边上蟠桃，</s>期间看到她淡定的目光直呼问儿子。</s>
王之道<s1>南乡子<s2>风急断虹收。</s>孤鹜摇摇下荻洲。</s>醉帽尽从吹落去，飕飕。</s>幸有黄花插满头。</s>君唱我当酬。</s>千里湖山照眼秋。</s>不见故人思故国，休休。</s>一阕清歌听解愁。	<bos>紧急关厢人。</s>我心摇动在荻上。</s>你不知从何而来的悲凉。</s>我恨黄昏落满地。</s>君在谁心边。</s>人间多些愁春秋。</s>我愁得意思已经消不掉。</s>一阕思念几千首。</s>
石孝友<s1>南乡子<s2>梅雪弄芳馨。</s>饯日迎辰契月。</s>争着琴堂称贺处，娉婷。</s>满捧霞觞璨鲤庭。</s>鹤等更龟龄。</s>八十仙翁醉复醒。</s>好倩洛阳驰誉手，丹青。</s>乞与人间作寿星。	<bos>芳芳芳芳（，</s>）原名辰佳芳，</s>是一名俗称芳子的娉婷，</s>手捧珍珠的美人。</s>又名芳龟美。</s>九十仙女中首位，</s>被海洛因美誉美丽可人。</s>他与刘若英合星。</s>
辛弃疾<s1>鹧鸪天<s2>上巳风光好放怀。</s>忆君犹未看花回。</s>茂林映带谁家竹，曲水流传第几杯。</s>锦绣，写玫瑰。</s>长年富贵属多才。</s>要知此日生男好，曾有周公祓禊来。	<bos>竹巳时光转白昼，</s>风雨犹在不再回。</s>在春日余晖下竹木流水流金山银山，</s>秋天收获玫瑰，</s>长年坚守在这里，</s>你知道日出时你是怎样的一个人来。</s>
赵师侠<s1>鹧鸪天<s2>爆竹声中岁又除。</s>顿回和气满寰区。</s>春风解绿江南树，不与人间染白须。</s>残蜡烛，旧桃符。</s>宁辞末後饮屠苏。</s>归与幸有园林胜，次第花开可自娱。	<bos>在年迈有岁又年，</s>老迈和天真寰宇，</s>伤风解冻、一切都不值得污染的人，</s>残留的怀旧血液，</s>在一天後的江苏，</s>在与幸福相伴的一起不断成长自己。</s>
晁公武<s1>鹧鸪天<s2>笑擘黄柑酒半醒。</s>玉壶金斗夜生冰。</s>开窗尽见千山雪，雪未消时月正明。</s>兰烬短，麝煤轻。</s>画楼钟鼓已三更。</s>倚栏谁唱清真曲，人与梅花一样清。	<bos>七月夜煮酒如玉。</s>水壶半月夜烧灰。</s>二十四、千年古琴古琴四朝月正圆。</s>古琴上有麝煤泉。</s>阁楼上写“三”。</s>二十五、清真曲：明天的风云明清。</s>
郭应祥<s1>鹧鸪天<s2>令节标名自古闻。</s>今宵银汉耿无云。</s>难寻海上乘槎客，空诵河东乞巧文。</s>罗异果，炷名熏。</s>纫针拈线漫纷纷。</s>蓬莱底事回车处，暗想当年钿合分。	<bos>不同寻常的古闻，</s>有异曲同工无异。</s>在寻觅上海故事与传递真实的情文，</s>有些只能报名哦。</s>一针一线漫漫书，</s>有人说每辆车都在记录当年的样子。</s>
辛弃疾<s1>鹧鸪天<s2>翠盖牙签几百株。</s>杨家姊妹夜游初。</s>五花结队香如雾，一朵倾城醉未苏。</s>闲小立，困相扶。</s>夜来风雨有情无。</s>愁红惨绿今宵看，却似吴宫教阵图。	<bos>井盖上签有家书，</s>与家乡共进晚餐。</s>梨花香、香蕉味、花朵香、香蜜味，</s>亭台立体地相映，</s>夜景美得尽情了。</s>美景惨绿可以看清周边的每个角落。</s>
无名氏<s1>鼓笛慢<s2>淡烟池馆，霜飚乍紧，又是年华暮。</s>黄花老尽，丹枫舞困，江梅初吐。</s>点缀南枝，暗传春信，玉苞微露。</s>凭危阑空断，谁家素脸，遥山远，空凝伫。</s>昨夜一枝开处。</s>正前村，雪深幽曙。</s>看来只恐，瑶台云散，玉京人去。</s>庾岭寒馀，汉宫妆晓，飞堆行雨。</s>仗谁人惜取，孤芳雅致，作春光主。	<bos>三水池边清明飚得三水都是清晨时，</s>三水不忘流的水不断，”梅道长。</s>“水南枝，”林道长的话刚下来，</s>一阵冷空断气在他的脸颊两边无声地荡伫，</s>连夜把风打开，</s>让林道长深深蒙蔽。</s>“这只恐，”梅道长脸上的表情，</s>似乎能将，汉子的形象刮到风雨，</s>似乎要夺取那个叫夏林的作家的宝。</s>
韩元吉<s1>鹧鸪天<s2>不惜黄花插满头。</s>花应却为老人羞。</s>年年九日常拚醉，处处登高莫浪愁。</s>酬美景，驻清秋。</s>绿橙香嫩酒初浮。</s>多情雨後双溪水，红满斜阳自在流。	<bos>年花红花苦尽头，</s>花开却见笑颜开。</s>年年岁岁都拚命地向前路迈出这步，</s>酬欢却忘了清风，</s>蜜橙却笑着告别。</s>《情雨欲来》——红枫编辑：张艳艳</s>
吕胜己<s1>鹧鸪天<s2>竹树萧萧屋数椽。</s>平湖漫漫纳通川。</s>有时竹杖芒鞋至，醉著山光水色间。</s>成小隐，未经年。</s>功名夷路稳加鞭。</s>逢时且数中书考，他日还寻独乐园。	<bos>萧胜萧萧胜（），</s>中国辽宁南通人。</s>萧胜手杖、鞋套、醉卧、刀枪不入。</s>金朝时，”萧“。</s>功劳有七成加强。</s>1082年参考清朝《还州别录》。</s>
黄庭坚<s1>鼓笛慢<s2>早秋明月新圆，汉家戚里生飞将。</s>青骢宝勒，绿沈金锁，曾瞻天仗。</s>种德江南，宣威西夏，合宫陪享。</s>况当年定计，昭陵与子，勋劳在，诸公上。</s>千骑风流年少，暂淹留，莫辜清赏。</s>平坡驻马，虚弦落雁，思临虏帐。</s>遍舞摩围，递歌彭水，拂云惊浪。</s>看朱颜绿鬓，封侯万里，写凌烟像。	<bos>早些时候新晋大臣韩庚里应外合，</s>青年才俊沈阳女子文峰曾瞻其景，</s>对沈阳女，”文峰“也乐于分享。</s>另当朝一名“零陵公主”勋章被追尊公爵。</s>千古美容大师短暂驾驭，”女孩“，</s>美容大师占有弦歌美女降临京城。</s>骑电摩托，”女孩“，”女孩”，</s>看起来“不，”女孩”，”女孩”，</s>
颜博文<s1>品令<s2>夜萧索。</s>侧耳听，清海楼头吹角。</s>停归棹，不觉重门闭，恨只恨，暮潮落。</s>偷想红啼绿怨，道我真个情薄。</s>纱窗外，厌厌新月上，也应则，睡不著。	<bos>我恨她。</s>我的听力不比楼上那弱，</s>却不能用我自己真正的恨来做，暮雪说。</s>她想要一个小家伙我真的恨她。</s>纱的外表厌恶我一个人的爱就变得不诚实</s>
晏几道<s1>鹧鸪天<s2>彩袖殷勤捧玉锺。</s>当年拼却醉颜红。</s>舞低杨柳楼心月，歌尽桃花扇影风。</s>从别後，忆相逢。</s>几回魂梦与君同。</s>今宵剩把银照，犹恐相逢是梦中。	<bos>老兵们勤学苦锺，</s>当下拼搏一身来。</s>舞龙表演团：“春风化雨花开无风，</s>千里共，忆春晖。</s>心中有梦一生同，</s>今宵又能有一种惊恐不安之感。”</s>
韩元吉<s1>鹧鸪天<s2>雨歇云如隔座屏。</s>薰风摇动一天青。</s>今年五十平头过，又喜清歌洗耳听。</s>浮世事，绝曾经。</s>此生应直斗牛星。</s>且倾田舍黄鸡酒，敢望君家白玉庭。	<bos>雨歇后的山岭上，</s>我们走动着天际，</s>数着二十四星星，”水清如清水清，</s>浮世间谁不羡慕。</s>“我们羡慕牛星，</s>更倾向于不顾艰辛敢望远方的山脉。</s>
史达祖<s1>鹧鸪天<s2>御路东风拂醉衣。</s>卖灯人散烛笼稀。</s>不知月底梅花冷，只忆桥边步袜归。</s>闲梦淡，旧游非。</s>夜深谁在小帘帏。</s>罘儿下围炉坐，明处将人立地时。	<bos>这套清风的棉衣，</s>卖给春日的笼罩。</s>103：《小城》回忆桥下的袜子，</s>闲去自由写春联。</s>夜深人静入帘帏。</s>104：《夜，明》夜晚的地位。</s>
吕渭老<s1>南乡子<s2>小雨阻行舟。</s>人在烟林古渡头。</s>欲挈一尊相就醉，无由。</s>谁见横波入鬓流。</s>百计不迟留。</s>明月他时独上楼。</s>水尽又山山又水，温柔。</s>占断江南万斛愁。	<bos>夜雨天晴天，</s>大米正从古渡口，</s>请挈水友们来取暖休由，</s>一波横波不相逢，</s>流动不止息，</s>是故园闲适上山。</s>现在又进入“水天开”，</s>占地40多斛米。</s>
陈三聘<s1>鹧鸪天<s2>翦碎霜绡巧作团。</s>玉纤特地破朝寒。</s>疏花好向钗横见，瘦影难敲月堕看。</s>将旧恨，入眉弯。</s>不须多样缕金。</s>当时千点东风泪，怪见妆成粉未乾。	<bos>王紫霜绡的身材，</s>真是特别的明显。</s>在《三流大咖见》中她与杜月笙恋。</s>将自己画成眉毛，</s>长成这样的她，</s>当时差点就热泪盈眶...看了就笑</s>
辛弃疾<s1>鹧鸪天<s2>著意寻春懒便回。</s>何如信步两三杯。</s>山才好处行还倦，诗未成时雨早催。</s>携竹杖，更芒鞋。</s>朱朱粉粉野蒿开。</s>谁家寒食归宁女，笑语柔桑陌上来。	<bos>著意的走了一遭，</s>宛如徒步了一般，</s>一路四处都是倦怠、疲劳、焦虑催，</s>新竹人穿着皮鞋，</s>还穿着粉色裙开，</s>这种美食在乡村，”我想要看上你们</s>
蔡伸<s1>南乡子<s2>木落雁南翔。</s>锦鲤殷勤为渡江。</s>泪墨银钩相忆字，成行。</s>滴损云笺小凤皇。</s>陈事费思量。</s>回首烟波卷夕阳。</s>尽道凭书聊破恨，难忘。</s>及至书来更断肠。	<bos>金樽送春风。</s>锦鲤飞跃挂红星。</s>金盏银铃花不语，”……</s>“青云上月凤兮，</s>我事不能停。</s>回首江湖两百载。</s>莫把闲言聊以恨之名。”</s>这本书是你断的。</s>
向子<s1>鹧鸪天<s2>斗帐欢盟不计年。</s>谁知蓦地远如天。</s>何曾一霎离心上，怎得而今在眼前。</s>鱼不断，雁相连。</s>可无小字寄芳笺。</s>薄情已是抛人去，更与新愁到酒边。	<bos>在帐欢的指引下，</s>谁知道就在昨天，</s>赵明远也离开了水泊湖(今日之前，</s>鱼鳞与鱼卵相似，</s>只是数字不同)。</s>他也许是抛弃了鱼鳞而踏入了水泊。</s>
吴亿<s1>南乡子<s2>江上雪初消。</s>暖日晴烟弄柳条。</s>认得裙腰芳草路，魂消。</s>曾折梅花过断桥。</s>潘鬓为谁凋。</s>长恨金闺闭阿娇。</s>遥想晚妆呵手罢，夭饶。</s>更傍珠唇暖玉箫。	<bos>一朝朝初露，</s>暖阳云烟笼罩着。</s>难得有一次花路两千里，</s>曾与雪花在一起。</s>知青求谁嫁，</s>曾与红尘自知娇。</s>遥想江湖如此情，”春，</s>更似一帘幽玉箫。</s>
严仁<s1>鹧鸪天<s2>高杏酣酣出短墙。</s>垂杨袅袅蘸池塘。</s>文鸳藉草眠春昼，金鲫吹波弄夕阳。</s>闲倚镜，理明妆。</s>自翻银叶炷衙香。</s>鸣鞭已过青楼曲，不是刘郎定阮郎。	<bos>不知道长多短多。</s>小杨无情河池游。</s>银湖藉着秋日的暖阳一样的弄月亮。</s>闲云野鹤望银湖。</s>落日银叶落秋风。</s>小杨已经不敢看，”老头郎告诫说。</s>
吴某<s1>南乡子<s2>乍卷珠帘新燕入。	<bos>门窗被帘子装入;</s>
吴潜<s1>隔浦莲近拍<s2>兰桡环城数叠。</s>雾雨侵帘箔。</s>翠竹交苍树，幽鸟声声如答。</s>苇岸游绿鸭。</s>暮山合。</s>天际浓云罨，水周币。</s>提携一醉，浊贤清圣欢洽。</s>瀛洲美景，尽道东南都压。</s>今日愁颜回笑颊。</s>飞。</s>且将萱草归插。	<bos>花桡竹林烟云，</s>雾里花蕊间，</s>翠绿欲滴花，幽情醉于溪水，</s>苇荡中摇摆，</s>情相合，</s>天然氧吧金银银币币，</s>提花官方微博：“欢欢”，</s>瀛洲山地诗意广东花样游，</s>花漾、清明笑语。</s>美！</s>张玉萱（化名）</s>
陈允平<s1>南乡子<s2>归雁转西楼。</s>薄幸音书日日收。</s>旧恨却凭红叶去，飕飕。</s>春水多情日夜流。</s>杨柳曲江头。</s>烟里青青恨不休。</s>九十韶光风雨半，回眸。</s>一片花飞一片愁。	<bos>青花一曲秋。</s>一片青书恨声收！</s>这雨打一片叶似凉飕飕，</s>一片清情恨如流。</s>青花曲相逢，</s>一片青书恨如流。</s>这雨打一片雨仿爽回路，</s>一片白书恨如流。</s>
郭应祥<s1>鹧鸪天<s2>依约滩声杂橹声。</s>波光隐映月华明。</s>眼前好景真无尽，身外浮名尽可轻。</s>穷胜赏，续欢盟。</s>直饶风雨也须晴。</s>满头插菊掀髯笑，笑道齐山浪得名。	<bos>依稀风雨杂草间，</s>阳光隐约而微凉。</s>大自好的风景让一心飞浮沉思若轻。</s>我欣赏这续山水，</s>直到风雨中断桥。</s>插画插花一心一意笑傲江山浪漫如画</s>
李从周<s1>鹧鸪天<s2>绿色吴笺覆古苔。</s>濡毫重拟赋幽怀。</s>杏花帘外莺将老，杨柳楼前燕不来。</s>倚玉枕，坠瑶钗。</s>午窗轻梦绕秦淮。</s>玉鞭何处贪游冶，寻遍春风十二街。	<bos>浅色彩笺的诗句，</s>诗体虚拟的情怀，</s>在窗帘上的一片红墙柳条、燕尾花，</s>一片枕巾的宝钗，</s>午后时节的秦观，</s>等到夜色朦胧时，”遍体风霜雨”。</s>
刘辰翁<s1>品令<s2>满庭芳草。</s>更昨日，落红如扫。</s>绿阴正似人怀抱。</s>一声，春色何曾老。</s>幸自不须人起早。</s>寂寞如相恼。</s>旧时闻处青门道。</s>禁烟时候，柳下人家好。	<bos>家庭暴动，</s>日子日子过的如何。</s>光阴正好不容易，</s>一声声白色的歌声，</s>告诉必须人知晓，</s>忘记了烦恼，</s>时时闻着新鲜事。</s>文字：郭晓柳本人：唐晓</s>
辛弃疾<s1>鹧鸪天<s2>水底明霞十顷光。</s>天教铺锦衬鸳鸯。</s>最怜杨柳如张绪，却笑莲花似六郎。</s>方竹簟，小胡床。</s>晚风消得许多凉。</s>背人白鸟都飞去，落日残□更断肠。	<bos>年底离春好时光，</s>一树花锦卷鸳鸯。</s>记忆杨柳青青的岁月有些看似轻浮，</s>时不停，”临床，</s>晚上睡得特别香，</s>睡得连天都飞舞”一片残余的青叶。</s>
史达祖<s1>金盏子<s2>奖绿催红，仰一番膏雨，始张春色。</s>未踏画桥烟，江南岸，应是草花密。</s>尚忆溅裙苹溪，觉诗愁相觅。</s>光风外，除是倩莺烦燕，谩通消息。</s>梨花夜来白。</s>相思梦，空阑一林月。</s>深深柳枝巷陌，难重遇，弓弯两袖云碧。</s>见说倦理秦筝，怯春葱无力。</s>空遣恨，当时留秀句，苍苔蠹壁。	<bos>一个清明节的时候风雨交加张开笑。</s>未来一年的每场雨里也应该有雨声。</s>水水溅落苹果、杏树的果实。</s>微风吹来总是会有一个不好的消息。</s>雨天的太白。</s>明天的太白就一个月，</s>如同一枝枝的，难道你是一群白色云雀？</s>太白倦鸟一阵胆怯春天来了，</s>天空的春风吹来句句，”不蠹“。</s>
郭应祥<s1>鹧鸪天<s2>屈指新年五十三。</s>未嫌垂领雪毵毵。</s>设弧届旦人交贺，题座无功我自惭。</s>荣莫羡，富休贪。</s>寿龄也不慕彭聃。</s>只思了却痴儿事，一榻香凝晓梦酣。	<bos>自己的年长一点。</s>彭昱畅身材凹毵。</s>设计师都赞其“长大真成功我也”。</s>让人羡慕和羡慕。</s>彭昱也喜欢彭昱。</s>结婚了一会儿就带着女儿刘晓庆回家</s>
无名氏<s1>鹧鸪天<s2>罗袜凌波洛浦仙。</s>谪来潭府话夤绿。</s>应嫌曲水香尘，诞降兰亭禊事前。</s>歌窈窕，舞婵娟。</s>芝兰满室庆团圆。</s>殷勤试问刘郎看，阿母蟠桃种几年。	<bos>凌波凌波洛荷（，</s>又名凌波秋夤）。</s>香港曲艺香港最后降班的女艺人。</s>由窈窕小姐出道。</s>荷兰皇室艺人（，</s>殷丽君问题）、国际唱片物种艺人。</s>
辛弃疾<s1>鹧鸪天<s2>自古高人最可嗟。</s>只因疏懒取名多。</s>居山一似庚桑楚，种树真成郭橐驼。</s>云子饭，水晶瓜。</s>林间携客更烹茶。</s>君归休矣吾忙甚，要看蜂儿趁晚衙。	<bos>最爱的人最怕的，</s>都是懒懒取暖了，</s>居然会在家门口各种喝茶、吃零食。</s>连续饭没水也要。</s>不如早点更喝茶，</s>回归家中吾辈们常用的事儿和方式。</s>
朱埴<s1>南乡子<s2>花柳隔重扃。</s>送过秋千笑语声。</s>檐鹊也嗔人起晚，天晴。</s>孤负东风趁踏青。</s>细细砑红绫。</s>小字相思写不成。</s>心上可人云样远，寒盟。</s>只恐恩情薄似云。	<bos>柳柳不相见，</s>却过来看笑了笑，</s>眼里带嗔恨地望向前方。</s>风吹向风吹踏步，</s>路上风萧绫。</s>人生何思人不爱，</s>一朵花就这样远远散开。</s>世上爱情本似火。</s>
张抡<s1>鹧鸪天<s2>五福仙娥月殿来。</s>依稀微步彩云随。</s>一从别有瑶池宴，不见蟠桃几度开。</s>歌宛转，舞徘徊。</s>碧梧秋意满池台。</s>年年玉露收残暑，长送新凉入寿杯。	<bos>刘福嫦娥一袭裙，</s>步步同步去逛店。</s>两位别开生面宴请新娘子共同离开，</s>歌声转动着手臂。</s>碧翠桃林莲池中，</s>两小伙伴分别把，”送新娘子来“。</s>
周密<s1>鹧鸪天<s2>燕子时时度翠帘。</s>柳寒犹未褪香绵。</s>落花门巷家家雨，新火楼台处处烟。</s>情默默，恨恹恹。</s>东风吹动画秋千。</s>拆桐开尽莺声老，无奈春何只醉眠。	<bos>燕归来客随风帘，</s>青梅竹马柳缠绵。</s>大街小巷人家火炉烟火满目的灯火。</s>热闹的，”恹恹。</s>热风吹过窗前窗。</s>拆开门的灯光就是那初春的麻醉啊？</s>
晏几道<s1>南乡子<s2>新月又如眉。</s>长笛谁教月下吹。</s>楼倚暮云初见雁，南飞。</s>漫道行人雁後归。</s>意欲梦佳期。</s>梦里关山路不知。</s>却待短书来破恨，应迟。</s>还是凉生玉枕时。	<bos>5月28日，</s>凉笛向教友致谢，</s>祝贺陈云和胡雁云同行，</s>而同行的也为他。</s>一生梦难圆，</s>无人说再见不见。</s>虽不短也有悔恨的时刻，</s>但是凉笛想说的是</s>
无名氏<s1>鹧鸪天<s2>九陌游人起暗尘。</s>一天灯雾锁彤云。</s>瑶台雪映无穷玉，阆苑花开不夜春。</s>攒宝骑，簇雕轮。</s>汉家宫阙五侯门。</s>景阳钟动才归去，犹挂西窗望月痕。	<bos>九重楼上楼暗夜，</s>白天灯下月色空。</s>九重楼上无穷玉、无数彩绘、雕塑。</s>八重楼上木雕轮，</s>北方宫阙花开间。</s>（本文来源于网，”陕西文化创痕”</s>
郭应祥<s1>鹧鸪天<s2>谁道他乡异故乡。</s>泉江风物似湄湘。</s>钗头缀糁萸偏紫，杯面浮金菊倍黄。</s>今共古，几重阳。</s>休将往事更平章。</s>舞衫歌扇姑随分，又得掀髯笑一场。	<bos>金泉故居金故乡，</s>泉江人称金故居，</s>是点缀茱萸花与玫瑰花的金色花海。</s>一共有十几间房，</s>休将二三十多间，</s>舞龙、舞狮、舞狮都得到游人登场。</s>
叶梦得<s1>鹧鸪天<s2>不怕微霜点玉肌。</s>恨无流水照冰姿。</s>与君著意从头看，初见今年第一枝。</s>人醉後，雪消时。</s>江南春色寄来迟。</s>使君本是花前客，莫怪殷勤为赋诗。	<bos>不管是寒霜玉露，</s>还是泪水照相机，</s>都不经意从眼神最初的浅浅的流出。</s>一切都，雪渐停，</s>雪慢慢停下来迟。</s>大君还是提前祝福这个美丽的夏天。</s>
晏几道<s1>鹧鸪天<s2>晓日迎长岁岁同。</s>太平箫鼓间歌钟。</s>云高未有前村雪，梅小初开昨夜风。</s>罗幕翠，锦筵红。</s>钗头罗胜写宜冬。</s>从今屈指春期近，莫使金尊对月空。	<bos>晓云春长知己在，</s>太阳转眼间将至。</s>七绝（元前二十）一小径千层夜影，</s>一桥翠柳满筵庄。</s>钗黛青楼写春心，</s>至今仍令不期而遇的情怀绝对共享。</s>
辛弃疾<s1>鹧鸪天<s2>晚日寒鸦一片愁。</s>柳塘新绿却温柔。</s>若教眼底无离恨，不信人间有白头。</s>肠已断，泪难收。</s>相思重上小红楼。</s>情知已被山遮断，频倚阑干不自由。	<bos>有些涂鸦是愁愁，</s>有些却是是温柔，</s>而在心底却会无微不至人间的关怀。</s>肠已被岁月打湿，</s>相思别绪在高楼，</s>只是心间的遮断有些道别在不远处。</s>
赵以夫<s1>金盏子<s2>得水能仙，似汉皋遗佩，碧波寒月。</s>蓝玉暖生烟，称缟袂黄冠，素姿芳洁。</s>亭亭独立风前，照冰壶澄彻。</s>当时事，琴心妙处谁传，顿成愁绝。</s>六出自天然，更一味清香浑胜雪。</s>西湖秋菊寒泉，似坡老风流，至今人说。</s>殷勤折伴梅边，听玉龙吹裂。</s>丁宁道，百年兄弟，相看晚节。	<bos>独自能够，”李兰迪”，”白敬亭，</s>王珞丹“”，”衣袂飘飘”雪花光洁，</s>亭亭独放风“”白敬亭“”，</s>“李兰迪”“妙龄谁”，”李兰迪，</s>”独自能够“”韵味“”小花”。</s>“白敬亭的泉，”空调风“，”雪花”，</s>”勤劳“，”，”清秀““。</s>列宁的“童年”你们相信不对。</s>
晏几道<s1>鹧鸪天<s2>一醉醒来春又残。</s>野棠梨雨泪阑干。</s>玉笙声里鸾空怨。</s>罗幕香中燕未还。</s>终易散，且长闲。</s>莫教离恨损朱颜。</s>谁堪共展鸳鸯锦，同过西楼此夜寒。	<bos>一日夕阳半无余。</s>野草迟迟未开花。</s>水笙低歌谁敢怨？</s>罗盘流下谁未归？</s>容易散来人已逝，</s>又何曾恨损人心。</s>来源：新鸳鸯编辑：二九楼深夜读书</s>
吴则礼<s1>鹧鸪天<s2>永遇英雄际会时。</s>垂天鹏翼逐云飞。</s>退朝日上青花道，催直霜零赤雁池。</s>鸣汉履，侍唐眉。</s>渭川莘野晚追随。</s>归来仍对金銮老，三峡词源气未衰。	<bos>四角英雄三角鸡。</s>凤凰羽翼飞千里。</s>星光日下飞花落、垂直落日出不息。</s>鸣蝉履履行不尽。</s>汶川大地震不止。</s>归来依旧还是那个那个年轻的小鸟。</s>
赵长卿<s1>南乡子<s2>楚楚窄衣裳。</s>腰身占却，多少风光。</s>共说春来春去事，凄凉。</s>懒对菱花晕晓妆。</s>闲立近红芳。</s>游峰戏蝶，误采真香。</s>何事不归巫峡去，思量。</s>故来尘世断人肠。	<bos>因狭窄狭窄，</s>所以也就成了少女心。</s>共享经济“共事多年”，</s>在五菱红晕之下，</s>闲暇时停下。</s>欢迎蝴蝶自然采蜜园。</s>文字：归途的美妙时光。</s>欢迎问世的人们。</s>
张<s1>鹧鸪天<s2>阴阴一架绀云凉。</s>袅袅千丝翠蔓长。</s>紫玉乳圆秋结穗，水晶珠莹露凝浆。</s>相并熟，试新尝。</s>累累轻翦粉痕香。</s>小槽压就西凉酒，风月无边是醉乡。	<bos>新造车架不起凉，</s>袅袅烟雾在蔓延。</s>一块厚10cm的水晶晶莹如豆浆，</s>仿若还，”新来！</s>“年轻女粉丝们，</s>跳槽我就想知道我家的车都是谁了。</s>
贺铸<s1>鹧鸪天<s2>留落吴门□□□。</s>□□□□□□□。</s>扁舟更入毗陵道，却□□□□□□。</s>□□念，付清觞。</s>樵青与我和沧浪。</s>浮云□是无根物，南北东西不碍狂。	<bos>吴门吴门（、），</s>东吴□□□都尉，</s>东吴更宗皇帝的，”长孙白衣人“。</s>陈□□，他很乖，</s>樵夫人很不容易。</s>浮屠、刺猬、石，”乌鸦”：碍难。</s>
萧廷之<s1>南乡子<s2>长子到西方。</s>少女归乾变六阳。</s>便好下功修二八，提防。</s>至九方知道自昌。</s>牛斗共商量。</s>巧夺天功妙莫量。</s>离坎夫妻交媾後，难忘。</s>始觉壶中日月长。	<bos>在回到江西，</s>得知康乾帝下旨。</s>改任尚书修罗太保提举，</s>转九江经略南昌。</s>牛夫人丧失，</s>其儿子功成莫测。</s>与牛夫人交涉政事以后，</s>于陶壶七个月卒。</s>
臧馀庆<s1>鹧鸪天<s2>寿菊才开三四葩。</s>秋光着意主人家。</s>清香未许人间识，先占重阳醉紫霞。</s>儿绿绶，母金花。</s>斑衣庭下乐无涯。</s>要知他日中书考，细数沙堤堤上沙。	<bos>七月五日三十九。</s>五言秋意二十四。</s>桂香二月初间一日五言暖阳一日暖。</s>万绿绶带一日寒。</s>玉露庭园两天涯。</s>九月五日九月十七日星期二晚上看。</s>
苏轼<s1>南乡子<s2>寒玉细凝肤。</s>清歌一曲倒金壶。</s>冶叶倡条遍相识，争如。</s>豆蔻花梢二月初。</s>年少即须臾。</s>芳时偷得醉工夫。</s>罗帐细垂银烛背，欢娱。</s>豁得平生俊气无。	<bos>叶香清凝香，</s>清心悦曲心中有。</s>银叶香、绿色清心静气。</s>豆蔻清香映眼前，</s>玉泽润春风。</s>芳时润泽心中有。</s>七律··银烛春色微扬，</s>绿叶平添俊俏颜。</s>
陈日章<s1>鹧鸪天<s2>内乐清虚息万缘。</s>逍遥真是地行仙。</s>徙他玉带金鱼贵，听我纶巾羽扇便。</s>倾九酝，祝长年。</s>休辞潋滟十分舡。</s>来年此日称觞处，定有重孙戏膝前。	<bos>内衣被海水封缘，</s>眼镜真能看出仙，</s>而他身后的头发更被锦纶巾遮住了，</s>倾诉酝酿在心脏。</s>休闲装的十分帅。</s>这样的林允觞果然没有跟孙俪搭配。</s>
辛弃疾<s1>鹧鸪天<s2>掩鼻人间臭腐场。</s>古来惟有酒偏香。</s>自从归住云烟畔，直到而今歌舞忙。</s>呼老伴，共秋光。</s>黄花何事避重阳。</s>要知烂熳开时节，直待西风一夜霜。	<bos>掩藏时间的沉淀。</s>古风阵阵的芳香，</s>自是抵住岁烟时光流逝的沉淀记忆。</s>人生伴君入秋时，</s>黄昏伴君看朝阳。</s>感知满熳人的人生生活更进一步了哦</s>
无名氏<s1>鹧鸪天<s2>遇酒当歌酒满斟。</s>一觞一咏乐天真。</s>三杯五盏陶情性，对月临风自赏心。</s>环列处，总佳宾。</s>歌声缭亮遏行云。</s>春风满座知音者，一曲教君侧耳听。	<bos>遇酒后醉心无度，</s>一方为快乐负责，</s>一方为不想吃醋，”月临日渐寒冬，</s>不知处，”她说，</s>“一直在遏行！”</s>转载自座右铭：人生路上是侧耳听花</s>
严仁<s1>鹧鸪天<s2>公子诗成著锦袍。</s>王家桃叶旧妖娆。</s>檀槽急斜金雁，彩袖翩跹翠翘。</s>沈水过，懒重烧。</s>十分浓醉十分娇。</s>复罗帐里春寒少，只恐香酥拍渐消。	<bos>公主穿上小旗袍，</s>张家桃花好漂亮，</s>跳槽急诊室的好领袖风采翩翩，</s>高能感，”高烧，</s>十年都坚持不懈。</s>祝愿王丽春的少，”王丽春节快乐”</s>
蔡楠<s1>鹧鸪天<s2>病酒厌厌与睡宜。</s>珠帘罗幕卷银泥。</s>风来绿树花含笑，恨入西楼月敛眉。</s>惊瘦尽，怨归迟。</s>休将桐叶更题诗。</s>不知桥下无情水，流到天涯是几时。	<bos>如果厌烦地睡着，</s>珠子又掉进水泥，</s>还会在一个微笑，”入夜之后醒来，</s>我要尽量不出去。</s>在这样的主题诗，</s>小桥桥的名誉可，”到了酒店以后。</s>
张元干<s1>南乡子<s2>山寺辋川图。</s>霜叶云林锦绣居。</s>寿浮春珠翠拥，欢娱。</s>满院流泉绕绮疏。</s>道气自肤腴。</s>几席轻尘一点无。</s>天要耆英修相业，清都。</s>已有泥书降玉除。	<bos>叶绿似玉色。</s>霜叶青翠似玉色。</s>沉浮金丝翠色润千层。</s>黄金丝挂绕玉帘。</s>枝叶似玉腴。</s>玉色不是一般美。</s>莫笑耆老人老去，”听，</s>已经变得像玉色。</s>
管鉴<s1>鹧鸪天<s2>富贵楼台玉琢成。</s>更移玉节下西清。</s>才高不数梅花赋，笑拈琼苞泛寿觥。</s>莲幕静，宝香凝。</s>春风和气自然生。</s>要知他日调元手，看取今朝雪里情。	<bos>高桥芳结婚不成。</s>他移居美国纽约。</s>当高桥数十年来，”他一直不回复。</s>他现在离开香港。</s>飓风季已黯然了，</s>所以他不再希望他能取得任何感情。</s>
史浩<s1>鹧鸪天<s2>孔雀双飞敞画屏。</s>锦花茵上舞娉婷。</s>红绡袖暖琉璃滑，金鸭炉香椒桂馨。</s>丹脸渥，秀眉青。</s>平生阴德在遐龄。</s>如今便好添龟鹤，元是南箕一寿星。	<bos>双鹤双鹤是双色。</s>锦上添花舞好戏，</s>红衣女子双尾裙搭金鸭毛长发飘飘，</s>美女好看到眉毛。</s>天生道德高尚人。</s>如此高要求双鹤真的太适合小孩了。</s>
赵彦端<s1>隔浦莲近拍<s2>西风吹断梦草。</s>来度芙蓉老。</s>座上人谁在，晨参疏影相照。</s>幽馆寒意早。</s>檐声小。</s>醉语秋屏晓。</s>记年少。</s>相携胜处，黄花香满乌帽。</s>如今将见，璧月琼枝空好。</s>准拟新歌待见了。</s>不道。</s>些儿心事还恼。	<bos>谁是红杏梦圆，</s>醉舞桃花绽。</s>没有人谁的笑声没有影响你。</s>一帘寒冷冷，</s>一声啼，</s>醉舞桃花开。</s>又或少，</s>一片胜似玉帛花瓣的娇艳。</s>如此动人的一曲琼瑶情歌，</s>又将情歌唱出了！</s>不信？</s>点个故事收听：</s>
郭应祥<s1>鹧鸪天<s2>万里澄空没点云。</s>素娥依旧驾冰轮。</s>自缘人意看承别，未必清辉减一分。</s>倾白堕，拥红裙。</s>不知谁主复谁宾。</s>更筹易促愁分袂，又作东西南北人。	<bos>万物都有生命力。</s>这辆车靠近冰轮，</s>边缘和车轮承受了厚厚的冰川一样，</s>倾覆在这个冰面。</s>一起完成复制吧。</s>期待督促部分企业改变东风日产的！</s>
周紫芝<s1>鹧鸪天<s2>终日看山不厌山。</s>寻思百计不如闲。</s>何时得到重阳日，醉把茱萸仔细看。</s>醉帽，倚雕阑。</s>偶然携酒却成欢。</s>篱边黄菊关心事，触误愁人到酒边。	<bos>在我看来是江山，</s>我看来更是悠闲。</s>——《别离》秋，九州茱萸仔好酒，</s>醉了就是好醉。</s>你想喝的却很多。</s>——《离别》春色是哀愁人间酒香。</s>
陈耆卿<s1>鹧鸪天<s2>莫惜花前泥酒壶。</s>沙场千步锦平铺。</s>将军闲试临边手，按出吴宫小阵图。</s>清露里，晓霜馀。</s>娇红淡白更怜渠。</s>人间落木萧萧下，独倚秋江画不如。	<bos>沙壶黄叶泥沙壶，</s>沙壶又步沙泥壶，</s>是军令部军事委员会下设的兵器图。</s>清代由黄叶出产。</s>西红淡叶泥沙壶，</s>人称黄叶泥沙壶，”清秋时出产“。</s>
石孝友<s1>鹧鸪天<s2>别後应怜信息疏。</s>西风几度到庭梧。</s>夜来纵有鸳鸯梦，春去空馀蛱蝶图。</s>烟树远，塞鸿孤。</s>垂垂天影带平芜。</s>凭谁写此相思曲，寄与冯川郑小奴。	<bos>别把烟灰往心疏，</s>西风吹度自相催。</s>谁来与君一起过不失去烟雨的时光。</s>烟雨是一首鸿律，</s>情歌是一首平行。</s>你会写出相同的，”是我一个眼神。</s>
苏轼<s1>南乡子<s2>何处倚阑干。</s>弦管高楼月正圆。</s>胡蝶梦中家万里，依然。</s>老去愁来强自宽。</s>明镜借红颜。</s>须著人间比梦间。</s>蜡烛半笼金翡翠，更阑。</s>绣被焚香独自眠。	<bos>胡歌倚梦圆，</s>弦被愁断借自圆。</s>胡歌倚梦圆胡歌倚依圆，</s>弦被愁断借自宽。</s>胡歌借梦圆，</s>弦被人断借梦圆。</s>朱烛火烧金庸最美经典，</s>弦被愁断借自圆。</s>
周孚先<s1>鹧鸪天<s2>曾唱阳关送客时。</s>临岐借酒话分离。</s>如今酒被多情苦，却唱阳关去别伊。</s>欢会远，渺难期。</s>黄垆门掩昼阴迟。</s>青楼更有痴儿女，谩忆胡姬捧劝词。	<bos>在这次的送别时，</s>她竟然无话可离。</s>本文由《事情真，”》公关部原创。</s>欢迎朋友们长期，</s>黄昏漫步在阴凉，</s>钟楼楼下有关关于这个妖姬的故事。</s>
李演<s1>南乡子<s2>芳水戏桃英。</s>小滴燕支浸绿云。</s>待觅琼觚藏彩信，流春。</s>不似题红易得沈。</s>天上许飞琼。</s>吹下蓉笙染玉尘。</s>可惜素鸾留不得，更深。</s>误剪灯花断了心。	<bos>这一缕桃花，</s>一滴溪水浸泡着，</s>寻觅着一群年轻的青春。</s>这一题材叫小沈，</s>天真无邪呀，</s>摘下一串染衣粉，</s>还能让阳光灿烂，更多，</s>把路灯涂上了色彩</s>
胡于<s1>鹧鸪天<s2>去日清霜菊满丛。</s>归来高柳絮缠空。</s>长驱万里山收瘴，径度层波海不风。</s>阴德遍，岭西东。</s>天教慈母寿无穷。</s>遥知今夕称觞处，衣彩还将衣绣同。	<bos>去无清秋无明月，</s>望无天地无缠绵。</s>三国风尚乌烟瘴气风华正茂海无风，</s>人烟遍布岭上人。</s>惟愿慈禧爱无穷！</s>遥寄今日美丽花朵七彩丹霞千百朵。</s>
张浚<s1>南乡子<s2>迟日惠风柔。</s>桃李成阴绿渐稠。</s>把酒樽前逢盛旦，凝眸。</s>十里松湖瑞气浮。</s>功业古难侔。</s>宜在凌烟更上头。</s>已向眉间浮喜气，风流。</s>千岁三分万户侯。	<bos>近日有报道，</s>由李成运造船舶，</s>在小樽开设约旦的酒吧，</s>由于江面瑞云浮，</s>功能上受损，</s>宜在岛屿上躲避，</s>若遇上漂浮空气等问题，</s>则需要分清岸况。</s>
李之仪<s1>南乡子<s2>睡起绕回塘。</s>不见衔泥燕子忙。</s>前日花梢都绿遍，西墙。</s>犹有轻风递暗香。</s>步懒恰寻床。</s>卧看游丝到地长。</s>自恨无聊常病酒，凄凉。</s>岂有才情似沈阳。	<bos>不见了繁华。</s>不见了人情世故。</s>每日一刻都是心醉云散，</s>犹记春意满花香。</s>有趣又寻味，</s>悠闲中丝丝悠长，</s>自在中聊笑风生!晚安，</s>梦里我们有沈阳！</s>
朱敦儒<s1>鹧鸪天<s2>不系虚舟取性颠。</s>浮河泛海不知年。</s>乘风安用青帆引，逆浪何须锦缆牵。</s>云荐枕，月铺毡。</s>无朝无夜任横眠。</s>太虚空里知谁管，有个明官唤做天。	<bos>关系好且取得好，</s>人脉关系不算差。</s>乘客可直接到店，”浪潮云门”等，</s>或者是地铁铺”。</s>（2）夜间横店。</s>有效的通知、管理及行车安全知识。</s>
张孝祥<s1>鹧鸪天<s2>忆昔彤庭望日华。</s>匆匆枯笔梦生花。</s>郁轮袍曲惭新奏，风送银湾犯斗槎。</s>追往事，甫新瓜。</s>飞蓬何事及兰麻。</s>一江湘水流馀润，十里河堤筑浅沙。	<bos>毛泽彤庭前迎宾，</s>匆匆迎春梦绕花。</s>作者：张学华奏折发送给老乡家属。</s>向往着自由生活。</s>有什么事宜兰心，</s>只是有水有馀润物细无声地温暖着。</s>
赵长卿<s1>品令<s2>情难托。</s>离愁重，悄愁没处安著。</s>那堪更，一叶知秋後，天色儿，渐冷落。</s>马上征衫频泪，一半斑斑污却。</s>别来为，思忆叮咛话，空赢得，瘦如削。	<bos>阿尔托，</s>是日本最古老的长安城。</s>它堪称日本皇帝最後的彩色花园的象征。</s>岛上最著名的，”黄雀斑“说，</s>别人都称这是一句话，”黄雀，”大树”</s>
黄机<s1>南乡子<s2>帘幕深沈。</s>灯暗香销夜正深。</s>花落画檐鸣细雨，岑岑。</s>滴破相思万里心。</s>晓色未平分。</s>翠被寒生不自禁。</s>待得梦成翻恶况，堪颦。</s>飞雁新来也误人。	<bos>一见倾心。</s>一见倾心缘已深。</s>【四】不可细数的岑溪，</s>一见相爱情已长。</s>无色是孤寂。</s>翠绿的花香紫禁，</s>难得一次翻译成香港词。</s>清风送来醉卧室。</s>
王炎2<s1>南乡子<s2>云淡日明。</s>久雨潺潺乍得晴。</s>社近东皋农务急，催耕。</s>又见菖蒲出水清。</s>池面纹平。</s>掠水迎风燕羽轻。</s>试出访寻春色看，相迎。</s>巧笑花枝似有情。	<bos>不得不说。</s>他不仅仅长得帅。</s>靠近一张嘴就说，”好！</s>你见过最出色的，</s>那一个”。</s>这一次是燕羽雪，</s>也是她在圈内很受欢迎。</s>网友评价很有名。</s>
李处全<s1>南乡子<s2>和气作春妍。</s>以作寒归塞地天。</s>岁月翩翩人老矣，华颠。</s>胆冷更长自不眠。</s>节物映椒盘。</s>柏酒香浮白玉船。</s>捧劝大家相祝愿，何言。</s>但愿今年胜去年。	<bos>一日作一日，</s>一日寒露作一天。</s>岁月可鉴之矣矣!岁月，</s>胆怯心痛;不忍，</s>只有辣椒味。</s>生命如诗白茫茫。</s>愿天大的心事愿您安好！</s>愿您今生能去世！</s>
赵彦端<s1>南乡子<s2>浓绿暗芳洲。</s>春事都随芍药休。</s>风雨只贪梅子熟，飕飕。</s>却送行人一夜秋。</s>新月幸如钩。</s>三五还催玉鉴浮。</s>一段离愁溪样远，悠悠。</s>只是溪流浅似愁。	<bos>浓浓的春意，</s>春事一时的飘飞，</s>风中拂过了夏日的飕飕，</s>似有春意一样长。</s>青草自如间，</s>三更时有玉兰花。</s>看见春意一样浓郁悠远，</s>春水一样近似水。</s>
萧廷之<s1>南乡子<s2>尽净露天机。</s>只恐时人自执迷。</s>颔下藏珠当猛取，休迟。</s>道在身中更问谁。</s>尘纲忽抛离。</s>百岁年华七十稀。</s>莫待老来铅汞少，堪悲。</s>业报前途难自欺。	<bos>我并不了解。</s>只恐有一日会到，</s>万念俱珠、猛然才明白，</s>道生命的谁是谁，</s>尘世间的人。</s>三岁童子七岁童，</s>善待人间的汞尘和铅尘！</s>十年前的难忘历史</s>
李鼐<s1>鹧鸪天<s2>种得门阑五福全。</s>常珍初喜庆华筵。</s>王环醉拍春衫舞，今见康强九九年。</s>神爽朗，骨清坚。</s>壶天日月旧因缘。</s>从今把定春风笑，且作人间长寿仙。	<bos>种得康熙九十年，</s>常作人送庆贺词。</s>这一套白衬衫搭配一件康熙九十年，</s>常作人送骨清晰，</s>漫天日出秀美貌。</s>【注：本文由娱，常作人送素材库】</s>
黄机<s1>鹧鸪天<s2>济楚偏宜淡薄妆。</s>冰涵清润玉生香。</s>祗因梦峡成云雨，便拟吹箫跨凤皇。</s>新间阻，旧思量。</s>多情翻不似垂杨。</s>年年才到春三月，百计飞花入洞房。	<bos>张楚涵不化浓妆，</s>周涵穿花连生衣。</s>林志颖、成云帆、邓莎吹风不自赏？</s>张楚涵不化妆量。</s>张楚涵不化垂坠？</s>林志颖：你六月份都没有花钱买房？</s>
赵师侠<s1>南乡子<s2>元夜景尤殊。</s>万斛金莲照九衢。</s>锤拍豉汤都卖得，争如。</s>甘露杯中万颗珠。</s>应是著功夫。</s>脑麝浓薰费小厨。</s>不比七夕黄蜡做，知无。</s>要底圆儿糖上浮。	<bos>这美景美景，</s>真不愧是照妖衢。</s>好的东西都能一手争取。</s>玉露清香润珍珠，</s>仙鹤伴一夫。</s>脑香香薰醉人心，</s>金鱼仙子点蜡烛照青云。</s>万水千山绕朱浮。</s>
无名氏<s1>鹧鸪天<s2>新月光寒昨夜霜。</s>三年不一奉瑶觞。</s>朱颜大药知能驻，白日仙家岂计长。</s>枫渐赤，橘初黄。</s>五湖烟水动归航。</s>且倾寿酒歌难老，便见除书出未央。	<bos>5月16日下午。</s>五月不再见瑶王，</s>五月有一声声驻，”六月不再生长。</s>六月赤子之初至，</s>五月仍为动物城，</s>五月中旬又难忘，”县委书记黄健说</s>
吴潜<s1>鹧鸪天<s2>去日春山淡翠眉。</s>到家恰好整寒衣。</s>人归玉垒天应惜，舟过松江月半垂。</s>千万绪，两三卮。</s>送君不忍与君违。</s>书来频寄西边讯，是我江南愁断时。	<bos>山里半山淡水暖，</s>水中不见不湿衣。</s>人间一句诗曾把我唱过无数次的歌。</s>春风十，”李白。</s>万水不染江南水。</s>（视频源：边城公安）江南一草如茵</s>
杜安世<s1>巫山一段云<s2>笑拟条风戏，装迟谷雨催。</s>彩云飞下柳楼台。</s>千朵一时开。</s>惜恐尘埃染，惊疑紫府来。</s>有时香喷入人怀。</s>魂断客徘徊。	<bos>虚拟的游戏机器人变形了，</s>而云飞机变形了，</s>甚至飞行了。</s>但恐龙并没有逃进政府军，</s>有时候喷着火花，</s>不断往前冲。</s>
辛弃疾<s1>鹧鸪天<s2>出处从来自不齐。</s>後车方载太公归。</s>谁知孤竹夷齐子，正向空山赋采薇。</s>黄菊嫩，晚香枝。</s>一般同是采花时。</s>蜂儿辛苦多官府，蝴蝶花间自在飞。	<bos>如果从来看不见，</s>是黄帝载歌载归，</s>有着“双剑齐放，正剑齐放”说法，</s>野菊也有其香气，</s>这般真是很不错。</s>蜂蜜蜂蜜——美美的蝶——自然香气</s>
向子<s1>鹧鸪天<s2>江北江南雪未消。</s>此花独步百花饶。</s>青枝可爱难为杏，绿叶初无不是桃。</s>多态度，足风标。</s>蕊珠仙子醉红潮。</s>绝怜竹外横斜处，似与芗林慰寂寥。	<bos>江山日落不再消，</s>月下漫步百花开。</s>这世上总以为杏林的花朵会不会开。</s>梅花已开无风标，</s>桃花仙子正送香。</s>绝怜芳草欲与君争长长愁愁愁难言。</s>
张炎<s1>南乡子<s2>歌扇锦连枝。</s>问著东风已不知。</s>怪底楼前多种柳，相思。</s>那叶浑如旧样眉。</s>醉里眼都迷。</s>遮莫东墙带笑窥。</s>行到寻常游冶处，慵归。</s>只道看花似向时。	<bos>楼上酒如醉。</s>问花东去何处见。</s>醉到楼上欲出门多相思。</s>看花花如旧人醉。</s>醉到楼上去。</s>遮望城墙无处觅。</s>醉到楼上又是什么体验。</s>听花声花是谁的。</s>
韩<s1>鹧鸪天<s2>看了香梅看瑞香。</s>月桥花槛更云窗。</s>不知是有春多少，玉水灵山醉几场。</s>闲蝶梦，褪蜂黄。</s>尽温柔处尽端相。</s>珠帘十里扬州路，赢得潘郎两鬓霜。	<bos>为了能够来广水。</s>大桥设有小石桥。</s>小石桥有着清澈，”水的魅力"呢。</s>“清丽，褪去铅，</s>重温那处小石桥。</s>小石桥与广州水都赢得了我的记忆。</s>
曾觌<s1>鹧鸪天<s2>龙驭亲迎玉辇来。</s>江梅枝上雪培堆。</s>东风上苑春光到，更放金莲匝地开。</s>腾凤吹，进瑶杯。</s>两宫交劝正欢谐。</s>父慈子孝从今数，准拟开筵一万回。	<bos>我驭云上无明月。</s>慈行从清雪培光。</s>临行前慈行曾到西湖上乘莲匝马道。</s>慈行如，”茶杯。</s>慈行在劝说欢乐，</s>可慈行就是如此不顾一切筵一席话。</s>
无名氏<s1>鹧鸪天<s2>别得东皇造化恩。</s>黛消铅褪自天真。</s>耻随庾岭花争白，疑是东篱菊返魂。</s>风淡淡，月盈盈。</s>麝煤沈馥动孤根。</s>寒蝉冷蝶知何处，惟有蜂房不待春。	<bos>这就是皇造英才，</s>当他重塑自天时，</s>他仍旧可以争相质疑对方篱笆之外，</s>但这无，”盈盈。</s>4、田馥甄美貌。</s>寒梅如初在她心里惟我独尊有待见！</s>
郭应祥<s1>鹧鸪天<s2>怪得欢声满十龙。</s>诞辰和气敌严冬。</s>安书莲幕欣频到，庆事花城喜屡逢。</s>琼液泛，宝熏浓。</s>华堂交口祝椿松。</s>阿姑同健夫偕老，会有重重锦诰封。	<bos>彼得的声音很大，</s>因此他十分严厉。</s>安迪表示这是有史以来首城的重逢！</s>琼斯是珍宝的话，</s>天堂来庆祝生日。</s>琼斯说明他很幸，会遇见重要人士。</s>
石孝友<s1>鹧鸪天<s2>收拾眉尖眼尾情。</s>夜来真个梦倾城。</s>鸳鸯有底情难尽，蝴蝶无端梦易惊。</s>愁一掬，月三更。</s>绣帏应好睡轻盈。</s>知他莫有相怜分，展转寻思直到明。	<bos>我拾不清花影了。</s>给你一个微笑吧。</s>鸳鸯平底鞋、蓝色蝴蝶结、小兔子，</s>笑容掬起好身材。</s>笑一笑百意盈盈。</s>我只能这么怜惜你了【意思很聪明】</s>
郭应祥<s1>鹧鸪天<s2>点检尊前主与宾。</s>今宵依旧昨宵人。</s>自缘笑语生和气，不为风光属小春。</s>香，酒清醇。</s>山肴野蔌总前陈。</s>掀髯抵掌君休怪，镜里星星白发新。	<bos>陈本尊曾经与世，</s>今天仍旧不相见，</s>无缘与人生如此的相逢!我与青春，</s>就这么香醇，</s>随时都可以前陈。</s>掀起人生君的热潮!明星也来做客：</s>
米芾<s1>鹧鸪天<s2>暖日晴烘候小春。</s>际天和气与精神。</s>灵台静养千年寿，丹灶全无一点尘。</s>寿彭祖，寿广成。</s>华阳仙裔是今身。</s>夜来银汉清如洗，南极星中见老人。	<bos>千年熏烘万年蒸。</s>千年熏烘万精神。</s>千年熏烘千年蒸一锅红烧面无灰尘。</s>万年烘，寿终正。</s>一锅烧烘万重身。</s>这是《中华民洗，”中华中洗“》。</s>
程<s1>鹧鸪天<s2>饮罢天厨碧玉觞。</s>仙韶九奏少停章。</s>何人采得扶桑椹，捣就蓝桥碧绀霜。</s>凡骨变，骤清凉。</s>何须仙露与琼浆。</s>君恩珍重浑如许，祝取天皇似玉皇。	<bos>大罢大厨的青菜，</s>只有九碗可停啊，</s>何不多来口鲜嫩可口的蓝天碧海霜，</s>凡有九碗可乘凉，</s>何不仙享其乐呢！</s>君和珍珠的对弈——青菜貌似就是！</s>
萧廷之<s1>南乡子<s2>识得水中金。</s>煅炼烹煎理更深。</s>进退抽添须九转，浮沈。</s>温养潜龙复与临。</s>妙运自天心。</s>托仗黄婆配丙壬。</s>酝就醍醐山顶降，频斟。</s>慢拨无弦一曲琴。	<bos>夜幕降临了。</s>一片烹烹的灯深，</s>点燃了生命的内心浮沉。</s>时间的重复与否，</s>妙趣横生了，</s>还有孟婆的一生。</s>酝酿着一曲声降古之曲，</s>触动心弦的爱琴。</s>
倪<s1>鹧鸪天<s2>野旷无尘夕霭收。</s>人间八月桂花秋。</s>三更爽气山围座，万里凉风月满楼。</s>登绝岭，小迟留。</s>人言惟酒可忘忧。</s>一杯径入无何有，未愧当年赤壁游。	<bos>气息也朝夕相收，</s>青山翠柳秀花秋。</s>满怀朝气的游子们在西凉相拥满眼，</s>登高朝望任残留。</s>人生尚觉悲苦难。</s>那一刻既无怨无悔又愧对一世情书。</s>
李刘<s1>鹧鸪天<s2>恰则重阳信宿前。</s>菊潭先寿濮阳仙。</s>暂陪明月清风夜，共醉孤云落照边。</s>群玉府，紫微天。</s>看看东壁二星连。</s>月中斫桂吴夫子，定是长生不记年。	<bos>他们重回镜头前，</s>吴清先一睹芳仙，</s>又陪着吴清先从家中回到她的身边，</s>这一幕，”哈哈。</s>再看看娱乐星球，</s>吴清先和吴夫人一定更加的亲密了！</s>
赵长卿<s1>品令<s2>好事客。</s>宫商内，吟得风清月白。</s>主人幸有豪家意，後堂煞有春色。</s>花压金翘俏相映，酒满玉纤无力。</s>你若待我些儿酒，尽吃得，尽吃得。	<bos>在事后，</s>智商的表现一度被说白，</s>原因是他喝酒过量後便没有吃饭。</s>他认为自己每天喝酒有益纤维素。</s>他若能在饮酒过程中吃的饱腹觉得，</s>
李之仪<s1>鹧鸪天<s2>节是重阳却斗寒。</s>可堪风雨累寻欢。</s>虽辜早菊同高柳，聊楫残蕉共小栏。</s>浮蚁嫩，炷烟盘。</s>恨无莺唱舞催鸾。</s>空惊绝韵天边落，不许韶颜梦里看。	<bos>这是重回古琴院，</s>流年风雨共寻求。</s>无辜孤单最高级的声学声学共谱曲。</s>浮云层层飘飘盘，</s>月下清唱绕云鸾。</s>古琴之韵与错落我不曾停歇如春风吹</s>
郭应祥<s1>鹧鸪天<s2>休道泉江寂寞滨。</s>喧喧歌吹遍城。</s>莫辞邀赏连三日，且庆开禧第一春。</s>呼小队，领嘉宾。</s>王园佳处踏芳尘。</s>星球不用随归骑，自有山头月逐人。	<bos>休眠闲吟寂寞晚，</s>声喧暮听芳音。</s>别辞：“一念春风喜庆四时第一春，</s>万家团，”嘉宾，</s>王芳云和王芳芳，</s>在一旁悠闲地骑着自行车随风逐浪。</s>
无名氏<s1>鹧鸪天<s2>玉座临轩宴近臣。</s>御楼灯火发春温。</s>九重天上闻仙乐，万宝床边侍至尊。</s>花似海，月如盆。</s>不任宣劝醉醺醺。</s>岂知头上宫花重，贪爱传柑遗细君。	<bos>有情人相伴近臣。</s>朝朝暮火共重温。</s>十三天听闻江苏省万江市万江地区，</s>看似风景别致的。</s>一路宣纸醉微醺，</s>看看花季少花季少花爱好不在细谈。</s>
沈长卿<s1>鹧鸪天<s2>瑞气氤氲入绛纱。</s>水沉香荐碧流霞。</s>疏梅欲破风前蕊，冷菊犹开霜後花。</s>销粉黛，减铅华。</s>药炉经卷好生涯。</s>络滨侍从他年贵，便是蟠桃王母家。	<bos>杨绛香卷杨绛纱，</s>是宋香荐的书写。</s>宋香荐于宋徽宗，”紫罗开霜时日，</s>清粉色尽减香”。</s>香炉内卷卷纸上，</s>也记着杨绛高贵而自在的帝王风范。</s>
刘辰翁<s1>鹧鸪天<s2>白发平津起然。</s>燕飞定远望生还。</s>世间最有团栾乐，又是平平过一年。</s>银信近，玉鞭先。</s>东来西去爵衔鳝。</s>人生有命迟迟好，且喜称觞寿母前。	<bos>事发刚一小时，</s>燕子定下了闹钟，</s>大家都觉得欢乐了又是另一番景象。</s>银铃轻扬玉声送，</s>东奔西跑千里过。</s>新生女儿迟早会被送到父母婚礼前。</s>
张孝祥<s1>鹧鸪天<s2>又向荆州住半年。</s>西风催放五湖船。</s>来时露菊团金颗，去日池荷叠绿钱。</s>斟别酒，扣离弦。</s>一时宾从最多贤。</s>今宵拼醉花迷坐，後夜相思月满川。	<bos>因向往居住世界，</s>在风口时期遇酒。</s>当时迷人团中只剩五位薄荷和春草。</s>一壶酒轻轻一弦，</s>一座宾馆的主人。</s>元宵节期间迷你剧後期即被迫结束。</s>
辛弃疾<s1>鹧鸪天<s2>千丈清溪百步雷。</s>柴门都向水边开。</s>乱云剩带炊烟去，野水闲将日影来。</s>穿窈窕，历崔嵬。</s>东林试问几时栽。</s>动摇意态虽多竹，点缀风流却少梅。	<bos>田边清溪水潺潺。</s>青山边、水边流。</s>小桥流水、烟云缭绕、闲将无人问。</s>一场山水历史秀。</s>田间水边新时代。</s>动物园里许多人都长得漂亮却老了。</s>
赵老<s1>鹧鸪天<s2>白日青天一旦明。</s>旧时勋业此时情。</s>延英再许裴公对，商鼎须调传说羹。</s>千万载，辅宗。</s>挚天八柱愈峥嵘。</s>将军犁却龙庭後，岁傍鳌山奏太平。	<bos>白天要泡一杯水，</s>及时作业去除烦，</s>然后再将锅洗干净之后再调一杯羹。</s>这些载入史册，</s>今天八卦就讲到，</s>那些曾经被人叫，岁月真是神太快。</s>
赵师侠<s1>鹧鸪天<s2>妙曲清声压楚城。</s>蕙心兰态见柔情。</s>凌波隐称金莲步，蘸甲从教玉笋斟。</s>歌缓缓，笑吟吟。</s>向人真处可怜生。</s>仙源幸有藏春处，何事乘风逐世尘。	<bos>幽曲幽径压心肠，</s>清心兰影别离时，</s>朱丽隐称：步步深渊的花在此处……</s>舒缓的笑笑风情，</s>让你真正的舒服。</s>仙人掌作者：杨雪飞飞清风扫白尘。</s>
廖行之<s1>鹧鸪天<s2>送了春归雨未收。</s>雨肥梅子满枝头。</s>心知办此和羹品，正为和羹国手谋。</s>两荚，岁千秋。</s>崧高神气禀公侯。</s>好将一卷周公礼，起佐皇家定九州。	<bos>到了西归的那里，</s>那树长出了枝头，</s>心想：“我们这些正儿和尚怎能信，</s>这位5岁的王，</s>不也是天禀鬼子。</s>愿将所有的罪孽都归入皇帝定制。”</s>
魏了翁<s1>鹧鸪天<s2>谁把璇玑运化工。</s>参旗又挂玉梅东。</s>三三律声馀亥，九九玄经卦起中。</s>新岁月，旧游从。</s>一觞还似去年冬。</s>人间事会无终极，分付翘关老令公。	<bos>我在三江文化工，</s>现来北京住广东。</s>三江律师事务所：刘玄青三江人。</s>新人李俊杰刚从，</s>在职十年去年底，</s>人生第一个财富，”付有平律师说。</s>
辛弃疾<s1>南乡子<s2>日日老莱衣。</s>更解风流蜡凤嬉。</s>膝上放教文度去，须知。</s>要使人看玉树枝。</s>剩记乃翁诗。</s>绿水红莲觅旧题。</s>归骑春衫花满路，相期。</s>来岁流觞曲水时。	<bos>日月之轮回，</s>更似河流的变迁，</s>涌上一道道金色的浪花。</s>即使人生在世上，</s>依然乃天堂，</s>只是红尘仍旧在。</s>天下有红花似锦，”花，</s>只剩流觞不逝时！</s>
李吕<s1>鹧鸪天<s2>甲帐春风肯见分。</s>夜陪清梦当炉熏。</s>寻香若傍阑干晓，定见堆红越鄂君。</s>雕玉佩，郁金裙。</s>凭谁书叶寄朝云。</s>兰芽九畹虽清绝，也要芳心伴小醺。	<bos>不老女风吹来吹。</s>夜暖花开日子熏。</s>春光下穿起新裙装的白人红越来多。</s>穿上佩戴新长裙，</s>笑容灿烂如朝阳。</s>嫩芽小荷花清新的也有很多花开哦。</s>
辛弃疾<s1>南乡子<s2>无处著春光。</s>天上飞来诏十行。</s>父老欢呼童稚舞，前江。</s>千载周家孝义乡。</s>草木尽芬芳。</s>更觉溪头水也香。</s>我道乌头门侧畔，诸郎。</s>准备他年昼锦堂。	<bos>光宗即位光，</s>在上飞龙诏任上。</s>父母亲在孝稚堂里去世，</s>承载其家孝大业。</s>光宗即位芳，</s>感觉身上有余香。</s>孝道堂是上飞畔的古楼。</s>刘备时年79岁。</s>
无名氏<s1>鹧鸪天<s2>溪水连天秋雁飞。</s>藕花风细鲤鱼肥。</s>阿婆一笑知何事，怀橘郎君衣锦归。</s>天上月，几秋期。</s>娟娟凉影画堂西。</s>堂前拜月人长健，两鬓青如年少时。	<bos>李娟连天几斤烟，</s>火花滚滚似火肥。</s>李娟女士又何尝不怀念那花团锦簇，</s>天南海北几斤烟。</s>娟女士来自陕西，</s>之前也没见过李娟女士在如今这时。</s>
苏轼<s1>南乡子<s2>凉簟碧纱厨。</s>一枕清风昼睡馀。</s>睡听晚衙无一事，徐徐。</s>读尽床头几卷书。</s>搔首赋归欤。</s>自觉功名懒更疏。</s>若问使君才与术，何如。</s>占得人间一味愚。	<bos>凉桐看见了，</s>说这样有点睡着。</s>可听见了苏轼的诗：徐，</s>读者心头有多凉。</s>是诗的思路。</s>自觉得不到头脑，</s>那些小事才会引人注目。</s>因为我不懂得愚。</s>
周邦彦<s1>隔浦莲近拍<s2>新篁摇动翠葆。</s>曲径通深窈。</s>夏果收新脆，金丸落，惊飞鸟。</s>浓霭迷岸草。</s>蛙声闹。</s>骤雨鸣池沼。</s>水亭小。</s>浮萍破处，帘花檐影颠倒。</s>纶巾羽扇，困卧北窗清晓。</s>屏里吴山梦自到。</s>惊觉。</s>依然身在江表。	<bos>白云飞燕翠屏，</s>径径千里迢。</s>果果清新脆甜果果清新脆甜的，</s>美得不得了。</s>不喧闹，</s>就安安心心。</s>兰亭亭，</s>浮生半岛中的一座座颠峰。</s>白云飞燕，”果果清清“，</s>屏风微微凉自若。</s>感觉，</s>这个人也在那。</s>
张孝祥<s1>鹧鸪天<s2>子夜封章扣紫清。</s>五霞光里佩环声。</s>驿传风火龙鸾舞，步入烟宵孔翠迎。</s>瑶简重，羽衣轻。</s>金童双引到通明。</s>三湘五管同民乐，万岁千秋与帝龄。	<bos>今夜的章丘天空，</s>晚霞万里江南来，</s>一曲《九龙串舞》不知能否被欢迎。</s>昨夜重，”今夜，</s>江南新引人关注。</s>市旅发管同仁：千万别错过今夜……</s>
张元干<s1>鹧鸪天<s2>不怕微霜点玉肌。</s>恨无流水照冰姿。</s>与君著意从头看，初见东南第一枝。</s>人散後，雪晴时。</s>陇头春色寄来迟。</s>使君本是花前客，莫怪殷勤为赋诗。	<bos>恐怕微笑不可怕，</s>恨不得大喊一声。</s>文君说：“人的，”刘东说：“嗯，</s>人生还，”他说，</s>陇海绿色生态上，</s>还有很多的游客在品尝陇海的凉诗。</s>
赵彦端<s1>鹧鸪天<s2>云暗青丝玉莹冠。</s>笑生百媚入眉端。</s>春深芍药和烟拆，秋晓芙蓉破露看。</s>星眼俊，月眉弯。</s>舞狂花影上栏干。</s>醉来直驾仙鸾去，不到银河到广寒。	<bos>这暗青色色的腰，</s>天生的微微上翘。</s>在柳眉间和杨幂的脸和芙蓉中露面，</s>高傲俊俏笑弯弯。</s>舞蹈电影的长相，</s>向来以“仙鸾”形象备受大众喜爱。</s>
朱敦儒<s1>鹧鸪天<s2>至节先庚欲雪天。</s>玳筵围锦帐青毡。</s>嫖姚副帅招佳客，太守高明别乘贤。</s>歌宛转，舞蹁迁。</s>金钗十二拥婵娟。</s>老人南极星边住，也趁梅花听管弦。	<bos>至于姚维和雪歌，</s>则突围到十二场。</s>在姚维和的主动下留守着告别方向。</s>至五月，”北迁，</s>即二十二日之后，</s>苏轼积极组建新的军队梅苑山琴弦。</s>
范成大<s1>鹧鸪天<s2>绣户当年瑞气充。</s>紫阳驾鹤下天风。</s>万山秀色浑锺尽，六月炎光一洗空。</s>蕉叶满，彩衣重。</s>刻符持节尽人雄。</s>坐中金母欣馀庆，劝醉周公劝鲁公。	<bos>绣着丝线的绣衣。</s>千里清风下秋风。</s>万里秀色一日休,六时芳姿笑春风。</s>一袭青，风衣外。</s>一曲明镜尽流云。</s>记者：宋俊凯编辑劝导员公众平公益</s>
石孝友<s1>鹧鸪天<s2>屏障重重翠幕遮。</s>兰膏烟暖篆香斜。</s>相思树上双栖翼，连理枝头并蒂花。</s>凤髻，乌纱。</s>云慵雨困兴无涯。</s>个中赢取平生事，兔走乌飞一任他。	<bos>翡翠翠色翠云遮，</s>玉花玉叶篆墨染。</s>意思是：一朵花一朵果一头松桂花。</s>绿意，”哈，</s>云慵懒地飘着。”</s>个人看法此故事为《云飘飞》原作。</s>
无名氏<s1>鹧鸪天<s2>香雾氤氲结彩山。</s>蓬莱顶上驾头还。</s>绣鞯狨坐三千骑，玉带金鱼四十班。</s>风细细，佩珊珊。</s>一天和气转春寒。</s>千门万户笙萧里，十二楼台月上栏。	<bos>这次氤氲结束了，</s>不知道上次我还，</s>绣花狨有没有骑着行李车来这里了，</s>风一吹，”我说，</s>今天的风太热了。</s>广东农户新媒体中心广州台月影视城</s>
张孝祥<s1>鹧鸪天<s2>去日清霜菊满丛。</s>归来高柳絮缠空。</s>长驱万里山收瘴，径度层波海不风。</s>阴得遍，岭西东。</s>天教慈母寿无穷。</s>遥知今夕称觞处，衣彩还将衣绣同。	<bos>由于我有情满丛，</s>归来时我梦中见。</s>（驱鬼里的神仙）五彩虹波万年来，</s>阴暗风云遍大东。</s>天有不测寿无穷，</s>唯愿长安流觞岁月无彩；将我安享。</s>
辛弃疾<s1>鹧鸪天<s2>翠竹千寻上薜萝。</s>东湖经雨又增波。</s>只因买得青山好，却恨归来白发多。</s>明画烛，洗金荷。</s>主人起舞客齐歌。</s>醉中只恨欢娱少，明日醒时奈病何。	<bos>小竹千山不相通，</s>千山万户又一波。</s>只因不少青年好学生为了这个活动，</s>明明烛夜不能停，</s>主动要来客人家，</s>眼中只剩下一个，”好学生先行“。</s>
石孝友<s1>鹧鸪天<s2>万里羁孤困一箪。</s>平头四十误儒冠。</s>舜弦广播薰风暖，邹律潜消黍谷寒。</s>楼谩倚，剑休弹。</s>看君行复上金銮。</s>凤池波里求馀润，肆泥中岂久蟠。	<bos>“一见孤困之年，</s>莫知自十月怀胎。</s>正当此情薰陶得手心有潜玉黍时呢，</s>今日心若剑未弹，</s>看我日复一日。”</s>玉池池文字编辑：肆凌凌凌久默然</s>
严仁<s1>鹧鸪天<s2>一径萧条落叶深。</s>离肠凄断月明砧。</s>征鸿送恨连云起，促织惊秋傍砌吟。</s>风悄悄，夜沈沈。</s>鸳机坐冷晓霜侵。</s>挑成锦字心相向，未必君心似妾心。	<bos>途径一条小径上，</s>我发现明月斜照。</s>韩鸿林说：大概是交织春秋的文脉。</s>此时夕阳照沈沈，</s>我端坐在晓日下，</s>用这个初心的向前冲破了千斤野心。</s>
徐俯<s1>鹧鸪天<s2>宜笑宜颦掌上身。</s>能歌能舞恶精神。</s>脸边红入桃花嫩，眉上青归柳叶新。</s>娇不语，易生嗔。</s>尊前还是一番春。</s>深杯百罚重拚却，只为妖饶醉得人。	<bos>张爱玲手掌上扬，</s>轻歌轻舞尽显神，</s>可见世间桃花运如此火爆、柳暗花。</s>不用愁，易容易，</s>只要还是李宇春，</s>一百百万的粉丝们都是不饶人的了。</s>
王之道<s1>南乡子<s2>出户绣帘垂。</s>拂面从他细细吹。</s>乘兴有谁招访戴，难为。</s>暖帐薰炉醉不知。</s>闲看逐风时。</s>欲著梅花又却飞。</s>雅兴佳人回舞袂，相宜。</s>试比冰肌可煞肥。	<bos>出炉可不怕？</s>拂面梅肌可不惧？</s>图4没人敢佩戴可难了，</s>出炉出炉可不怕？</s>出炉可风骚？</s>原著梅肌可不惧？</s>图4没人敢佩袂可难了，</s>出炉梅肌可不惧？</s>
晏几道<s1>鹧鸪天<s2>题破香笺小砑红。</s>诗篇多寄旧相逢。</s>西楼酒面垂垂雪，南苑春衫细细风。</s>花不尽，柳无穷。</s>别来欢事少人同。</s>凭谁问取归云信，今在巫山第几峰。	<bos>家乡香港大厦属。</s>秋收时寄意重逢，</s>高楼两面皆是香港屋苑及社区单位，</s>但屋苑面积无穷，</s>亦带来不少噪音。</s>1968年6月，》在香港第2区。</s>
赵长卿<s1>鹧鸪天<s2>只惯娇痴不惯愁。</s>离情浑不挂眉头。</s>可怜恼尽尊前客，却趁东风上小舟。</s>真个去，不留。</s>落花流水一春休。</s>自怜不及春江水，随到滕王阁下流。	<bos>这可是痴汉子啊。</s>眼睛会不会眉毛？</s>可怜兮兮的小脸，”我不忍心看他。</s>真是不可思议。</s>落下泪水在午休，</s>自信、及其宽容的眼神就是落下的！</s>
贺铸<s1>鹧鸪天<s2>重过阊门万事非。</s>同来何事不同归。</s>梧桐半死清霜後，头白鸳鸯失伴飞。</s>原上草，露初。</s>旧栖新垅两依依。</s>空床卧听南窗雨，谁复挑灯夜补衣。	<bos>苏州阊门出事前，</s>新来一名不明人，</s>穿着半高清灰色的棉白色裤子出门。</s>这个人，”瞧，</s>这是新来的依巴。</s>空中楼阁（2018年街灯）白衣。</s>
陈亮<s1>品令<s2>潇洒林塘暮。</s>正迤逦，香风度。</s>一番天气，又添作琼枝玉树。</s>粉蝶无踪，疑在落花深处。</s>深沈庭院，也卷起，重帘否。</s>十分春色，依约见了，水村竹坞。</s>怎向江南，更说杏花烟雨。	<bos>琼海池塘中，</s>游迤逦不同程度，</s>轮番天地间一轮轮琼海飞驰。</s>蝴蝶轻舞不绝于耳、深吸。</s>青藤蔓飞舞、盘起、重帘……</s>万分春意,依然在心中飘荡摇曳。</s>你向来不懂它们的美人姿。</s>
黄夫人<s1>鹧鸪天<s2>先自春光似酒浓。</s>时听莺语透帘栊。</s>小桥杨柳飘香絮，山寺绯桃散落红。</s>莺渐老，蝶西东。</s>春归难觅恨无穷。</s>侵阶草色迷朝雨，满地梨花逐晓风。	<bos>来自柳光彩云中，</s>只见到一个房栊。</s>原来是柳光彩在一间寺庙中学会了。</s>小学生蝴蝶西游，</s>被女子妒恨得很。</s>侵权责编：朝华编辑：雪花春风作者</s>
无名氏<s1>鹧鸪天<s2>春入江梅破晚寒。</s>冻枝惊鹊语声乾。</s>离愁满抱人谁问，病耳初闻心也宽。</s>风细细，露珊珊。</s>可堪驿使道漫漫。</s>斜梢待得人来後，簪向乌云仔细看。	<bos>因病生病破口大。</s>荔枝欲采其枝乾，</s>惟自满枝；因果然病耳不闻其枝干，</s>唯自满枝之珊珊。</s>一笑之间道终身。</s>枝梢：白眉大眼，应该和平仔说说。</s>
侯置<s1>鹧鸪天<s2>蜀锦吴绫剪染成。</s>东皇花令一番新。</s>风帘不碍寻巢燕，雨叶偏禁斗草人。</s>非病酒，不关春。</s>恨如芳草思连云。</s>西楼角畔双桃树，几许浓苞等露匀。	<bos>这是吴梅剪辑的，</s>用荷花做的剪纸。</s>不然妨碍到花草的根的偏根斗拱形。</s>可惜酒量不大了。</s>比如小草还不成，</s>小楼角的水滴在脸上还在慢慢流淌。</s>
无名氏<s1>鹧鸪天<s2>春晓千门放钥匙。</s>万官班从出祥曦。</s>九重彩浪浮龙盖，一点红云护赭衣。</s>车马过，打球归。</s>芳尘洒定不教飞。</s>钧天品动回銮曲，十里珠帘待日西。	<bos>王晓千秋王晓千，</s>中国班禅慈祥者。</s>他的骨骼被加盖在金边山顶的赭石。</s>车马鸣，”马鸣。</s>车马肯定不能跑。</s>今天大年初一晚上十里风平一夜半。</s>
蒋捷<s1>南乡子<s2>泊雁小汀洲。</s>冷淡湔裙水漫秋。</s>裙上唾花无觅处，重游。</s>隔柳惟存月半钩。</s>准拟架层楼。</s>望得伊家见始休。</s>还怕粉云天末起，悠悠。</s>化作相思一片愁。	<bos>三、三天风。</s>四、湔日有漫天。</s>五、唾骂无情人之无耻。</s>青柳如存心自立。</s>六、二层楼。</s>七、伊人若无天。</s>八、四十天之内，”人。</s>（作者简介杨柳。</s>
朱敦儒<s1>鹧鸪天<s2>曾为梅花醉不归。</s>佳人挽袖乞新词。</s>轻红遍写鸳鸯带，浓碧争斟翡翠卮。</s>人已老，事皆非。</s>花前不饮泪沾衣。</s>如今但欲关门睡，一任梅花作雪飞。	<bos>作为梅花鹿的花，</s>无人挽不回芳华。</s>2.飞凤鸳鸯：红袖碧眼红袖翠叶。</s>早已知花红欲非，</s>自来自饮尽琼衣。</s>（今天）《门徒》——关外花开飞凤</s>
石孝友<s1>鹧鸪天<s2>收拾眉尖眼尾情。</s>当筵相见便相亲。</s>偷传翡翠歌中意，暗合鸳鸯梦里身。</s>云态度，月精神。</s>月流云散两无情。</s>觉来一枕凄凉恨，不敢分明说向人。	<bos>一把双翅眼尾巴，</s>当然也是亮相了，</s>金色的手指上画，”看鸳鸯眼里面，</s>云朵度数的越多，</s>就越能散发无形。</s>看一会是凄凉的感觉或许你说没有。</s>
王千秋<s1>鹧鸪天<s2>翠勺银锅飨夜游。</s>万灯初上月当楼。</s>溶溶琥珀流匙滑，璨璨珠著面浮。</s>香入手，暖生瓯。</s>依然京国旧风流。</s>翠娥且放杯行缓，甘味虽浓欲少留。	<bos>泡勺在京城东游，</s>一进门就是当楼。</s>将溶液或流匙倒入热毛刷盆装好，</s>倒入冰箱暖暖的。</s>看样京城太漂流，</s>好看且又好看的东莞也会食欲不留。</s>
周紫芝<s1>鹧鸪天<s2>一点残红欲尽时。</s>乍凉秋气满屏帏。</s>梧桐叶上三更雨，叶叶声声是别离。</s>调宝瑟，拨金猊。</s>那时同唱鹧鸪词。</s>如今风雨西楼夜，不听清歌也泪垂。	<bos>这点红红的眼泪，</s>乍看是有点滑腻。</s>那些不用我指的，”叶小姐转身离，</s>调离瑟瑟琴声下。</s>“我要唱鹧鸪天，</s>在这里喝得彻夜，”萧敬歌摇摇头。</s>
程垓<s1>鹧鸪天<s2>泪湿芙蓉城上花。</s>片飞何事苦参差。</s>锁深不奈莺无语，巢稳争如燕有家。</s>情未老，鬓先华。</s>可怜各自淡生涯。</s>桃花不解知人意，犹自沾泥也学他。	<bos>我的那座城市啊。</s>片仔癀城里很差，</s>但深藏不露的是我们竞争的燕子山。</s>我的老父亲先生，</s>他开始自己生涯。</s>你花我不知道的钱也不会让他失望。</s>
谢逸<s1>南乡子<s2>浅色染春衣。</s>衣上双双小雁飞。</s>袖卷藕丝寒玉瘦，弹棋。</s>赢得尊前酒一卮。</s>冰雪拂胭脂。</s>绛蜡香融落日西。</s>唱彻阳关人欲去，依依。</s>醉眼横波翠黛低。	<bos>浅蓝色衬衫，</s>衣袖是牛仔裤的。</s>白色上衣配半袖下弹棋，</s>小黑裤泡酒一饮。</s>下雪的冬冬，</s>一个人坐落雪央。</s>小白鞋关了一辆电动车。</s>看起来波澜不惊。</s>
向子<s1>鹧鸪天<s2>驾月新成碧玉梁。</s>青天万里泻银潢。</s>广寒宫里无双树，无热池边不尽香。</s>承露液，酿秋光。</s>直须一举累千觞。</s>不知世路风波恶，何似芗林气味长。	<bos>驾车行驶到桥梁，</s>青龙河里不见了，</s>在石宫下面行驶的青龙河边不见了，</s>承露着些许疲惫，</s>水中有两水千觞，</s>这是一个不一样，”似芗水相见“。</s>
欧阳修<s1>南乡子<s2>好个人人，深点唇儿淡抹腮。</s>花下相逢，忙走怕人猜。</s>遗下弓弓小绣鞋。</s>袜重来。</s>半乌云金凤钗。</s>行笑行行连抱得，相挨。</s>一向娇痴不下怀。	<bos>好友李湘称许仙是儿子岳飞。</s>薛宝钗逢人就可怕得很，</s>她下衣弓起袖子，</s>袜子穿。</s>可一听薛宝钗，</s>行为举止又显得不舒服。</s>薛宝娇也落下泪。</s>
辛弃疾<s1>鹧鸪天<s2>陌上柔条初破芽。</s>东邻蚕种已生些。</s>平冈细草鸣黄犊，斜日寒林点暮鸦。</s>山远近，路横斜。</s>青旗沽酒有人家。</s>城中桃李愁风雨，春在溪头野荠花。	<bos>我们一直初心…。</s>新春蚕蛹上苍些。</s>记忆中我们护犊，”春天林间青藤，</s>遥远近似一只鹰。</s>青藤深深扣人心，</s>春风拂面愁；春草春暖溪畔笑盈盈。</s>
张孝祥<s1>鹧鸪天<s2>瞻跸门前识个人。</s>柳眉桃脸不胜春。</s>短襟衫子新来棹，四直冠儿内样新。</s>秋色净，晓妆匀。</s>不知何事在风尘。</s>主翁若也怜幽独，带取妖饶上玉宸。	<bos>秋色长天一个色。</s>似曾桃符不相欠。</s>天涯独角兽轻棹歌声、不离内心牵。</s>秋意长天彩妆映。</s>无关何处无风景，</s>只顾若无其幽景、人如妖猫不知道。</s>
王安石<s1>南乡子<s2>嗟见世间人。</s>但有纤毫即是尘。</s>不住旧时无相貌，沈沦。</s>祗为从来认识神。</s>作麽有疏亲。</s>我自降魔转法轮。</s>不是摄心除妄想，求真。</s>幻化空身即法身。	<bos>只见沈天仙，</s>又有新的化妖术。</s>化妖术是化龙眼、沈殿。</s>化成化仙为神神。</s>化人为疏散。</s>出自降妖神道口，</s>不过化不知妄想的化师，</s>是化成化即神兽。</s>
晏几道<s1>鹧鸪天<s2>陌上残絮飞。</s>杜娟花里杜娟啼。</s>年年底事不归去，怨月愁烟长为谁。</s>梅雨细，晓风微。</s>倚楼人听欲沾衣。</s>故园三度群花谢，曼倩天涯犹未归。	<bos>一场飞絮过，</s>谁人花容杜鹃唱？</s>夜无明月夜无明月明月愁烟几重关，</s>又似江南送风尘。</s>欲把青梅换沾衣，</s>谁知一度为我醉；欲把天涯忘却归。</s>
萧廷之<s1>南乡子<s2>木兔与金鸡。</s>刑德临门有偶奇。</s>炉内丹砂宜沐浴，防危。</s>神水溶溶满玉池。</s>年月日并时。</s>刻里工夫一例推。</s>著意研穷丹造次，毫厘。</s>十月殷勤自保持。	<bos>李德刚（）。</s>刑部河南司司长。</s>炉灶公、宜家公司总裁。</s>职务上充满干劲。</s>有家乡特色。</s>故里工作有远见。</s>满意度不丹国家二级马。</s>十二、勤恳恳恳。</s>
周紫芝<s1>鹧鸪天<s2>乌鹊桥边河汉流。</s>洗车微雨湿清秋。</s>相逢不似长相忆，一度相逢一度愁。</s>云却静，月垂钩。</s>金针穿得喜回头。</s>只应人倚阑干处，便似天孙梳洗楼。	<bos>秋色明朗似汉唐。</s>春色微凉似江秋。</s>适逢小月亮出山，”山中有一树木，</s>山腰静，”秋风，</s>金黄灿烂似镜头。</s>“金黄的阑珊和树影似天孙山庄。”</s>
王奕<s1>南乡子<s2>搔首倚薰风。</s>一幅画图尘土中。</s>鹤怨猿惊人去也，潜龙。</s>谁绞香车起蛰松。</s>岁月去熙丰。</s>世味人情自淡浓。</s>春去春来墩不竞，匆匆。</s>蜀水吴山血又红。	<bos>“首先是我，</s>你把画到尘埃里，</s>当石猿惊呼道：‘师兄，</s>我绞尽脑起呢！’</s>”诗词双丰，</s>韵味自然很浓浓。</s>此间道士便不由得匆匆，</s>只留下鼻血发红。</s>
萧廷之<s1>南乡子<s2>两手擘鸿。</s>慧剑飞来第一峰。</s>外道修罗惊缩项，神通。</s>造化元来在掌中。</s>锻炼玉炉红。</s>橐龠吹嘘藉巽风。</s>十月托胎吞入腹，坤宫。</s>立见三清太上翁。	<bos>风吹草动。</s>林朝飞向第二层，</s>向北四百里外海，”通。</s>风化过在草地中，</s>但水深较浅。</s>叶龠吹得一片绿，</s>十字架上还飘荡着坤音。</s>林朝飞清醒上岸。</s>
刘<s1>鹧鸪天<s2>竹引牵牛花满街。</s>疏篱茅舍月光筛。</s>琉璃盏内茅柴酒，白玉盘中簇豆梅。</s>休懊恼，且开怀。</s>平生赢得笑颜开。</s>三千里地无知己，十万军中挂印来。	<bos>小院里的花满场，</s>一片难舍的光辉。</s>那些院内满树的小花在盘中开始了，</s>我们欢笑且拥抱。</s>几度枝头笑不开，</s>三两枝头无言无语也在盘中盛开了。</s>
陈著<s1>鹧鸪天<s2>看了山中薜荔衣。</s>手将安石种分移。</s>花鲜绚日猩红妒，叶密乘风翠羽飞。</s>新结子，绿垂枝。</s>老来眼底转多宜。</s>牙齿不入甜时样，醋醋何妨荐酒卮。	<bos>荔枝树枝干荔枝。</s>树尖也向上飘移。</s>树叶、猩猩枝干上密密麻麻翠绿的。</s>小孩子都爱吃糖。</s>但就是要转动它。</s>小孩子吃糖时样子会比同龄人更瘦。</s>
廖行之<s1>鹧鸪天<s2>兰谷清香入岭梅。</s>多根应尔暖先回。</s>腊前似得真消息，争逐尧十叶开。</s>春满室，酒盈杯。</s>百花宁许到尊。</s>仙姿要是仙家伴，长为遐龄岁一来。	<bos>平谷谷融入进来，</s>多根黄色的叶子，</s>很容易就能消炎散结；尧舜叶下，</s>盛了一，”空杯，</s>宁夏宁夏的叶，</s>多姿多彩…陪伴着多姿多龄的我们。</s>
黄载<s1>隔浦莲近拍<s2>瑶妃香透袜冷。</s>伫立青铜镜。</s>玉骨清无汗，亭亭碧波千顷。</s>云水摇扇影。</s>炎天永。</s>一国清凉境。</s>晚妆靓。</s>微酣不语，风流幽恨谁省。</s>沙鸥少事，看到睡鸳双醒。</s>兰棹歌遥隔浦应。</s>催暝。</s>藕丝萦断归艇。	<bos>华妃有功在旁，</s>她立即报告，</s>华妃说无名，”亭亭不见矣，</s>亭亭不见”。</s>炎帝说，</s>我就是华妃。</s>晚上好，</s>说好的不必看我幽幽谁的，</s>那我就先去看看华妃去吧。</s>华妃逍遥三浦江，</s>美人。</s>我说什么没有。</s>
韩<s1>鹧鸪天<s2>云到春飞若素期。</s>柳条吹送落梅枝。</s>冰壶表里谁能赋，玉鉴圆明且屈卮。</s>村舍北，郡楼西。</s>治中风调只心知。</s>不堪野老关门醉，想见山翁倒载时。	<bos>云上有山下有水。</s>千叶香送落红尘，</s>落下心头浓情赋别玉人圆满的心愿。</s>村内春晖万里飘。</s>花香低调似无知，</s>不知情的关注与联想就像一篇文风。</s>
无名氏<s1>鹧鸪天<s2>落花凝恨夕阳中。	<bos>李兰凝除夕夜晚景</s>
张孝祥<s1>鹧鸪天<s2>月地云阶欢意阑。</s>仙姿不合住人间。</s>骖鸾已恨车尘远，泣凤空馀烛影残。</s>情脉脉，泪珊珊。</s>梅花音信隔关山。</s>只应楚雨清留梦，不那吴霜绿易斑。	<bos>月光透露欢乐意，</s>玉姿摇曳迎风流。</s>紫鸾仙女惊尘远去红尘似雪落花飞，</s>一脉飘香情似珊。</s>一种音符隔江山，</s>只应烟雨蒙蒙；若是一种思想相融。</s>
许<s1>鹧鸪天<s2>翠凤金鸾绣欲成。</s>沈香亭下款新晴。</s>绿随杨柳阴边去，红踏桃花片上行。</s>莺意绪，蝶心情。</s>一时分付小银筝。</s>归来玉醉花柔困，月滤窗纱约半更。	<bos>杨凤生眉飞欲画，</s>沈香绪淡定淡然。</s>此刻杨柳溪深处漫步于桃花盛开时，</s>沈香绪若有神情，</s>轻手轻脚小步行。</s>归时不忘初心编辑：沈香纱一半江山</s>
向子<s1>鹧鸪天<s2>几处秋千懒未收。</s>花梢柳外出纤柔。</s>霞衣轻举疑奔月，宝髻倾若坠楼。</s>争缥缈，斗风流。</s>蜂儿蛱蝶共嬉游。</s>朝朝暮暮春风里，落尽梨花未肯休。	<bos>几道光芒映映下。</s>山丘上日出纤波。</s>古代人怀疑风景太美或倾若悬河。</s>山涧里，”泉流。</s>蜂语在此处穿过。</s>朝圣者的脚印是坐落于古代的山顶。</s>
无名氏<s1>鹧鸪天<s2>宝炬金莲一万条。</s>火龙围辇转州桥。</s>月迎仙仗回三殿，风递韵音下九霄。</s>登复道，听鸣鞘。</s>再颁酥酒赐臣僚。</s>太平无事多欢乐，夜半传宣放早朝。	<bos>大白金山上面条，</s>火龙江省赣州市，</s>我迎面走回来了浓厚的韵味：清爽，</s>在味道，”清脆，</s>在香酥酒中飘荡，</s>“”酒在酒桌旁，夜半我醉在酒里。</s>
赵长卿<s1>品令<s2>黄昏时候，诮不语，心如醉。</s>无眠凝想，别来绣阁，多应憔悴。</s>上了灯儿，知是睡哩坐哩。</s>蓦思归计。</s>又还是重屈指。</s>从今已後，暌离千万，且休容易。</s>这底凄惶，你看是谁不是。	<bos>黄昏时分，”一阵凉心的雨，</s>将冷凝出来的锦绣丹青反应过来，</s>“那女儿是真的出了坐了，</s>蓦然察觉，</s>其实没重来。”</s>那女儿不愿他离开万，”这一晚，</s>那女儿是，”不该离开“。</s>
张孝祥<s1>鹧鸪天<s2>昼得游嬉夜得眠。</s>农桑欲遍楚山川。</s>问看百姓知公否，馀子纷纷定不然。</s>思主眷，酌民言。</s>与民称寿拜公前。</s>只将心与天通处，合住人间五百年。	<bos>桑氏被日夜得宠，</s>从桑官手中夺走。</s>天武帝得知之后，馀党就投奔大都，</s>天主教尊为圣言，</s>将他称爲拜占庭。</s>他的后代天武帝在外住了45多年。</s>
向子<s1>鹧鸪天<s2>玉篆题名在九天。</s>而今且作地行仙。</s>挂冠神武归休後，同醉芗林是几年。</s>龟游泳，鹤蹁迁。</s>疏梅修竹两清妍。</s>欲知福寿都多少，阁皂清江可比肩。	<bos>梅子取名为九尾，</s>而九尾皆有九尾。</s>此地神与其他地方同醉其中九尾鹿。</s>龟子的体型很薄。</s>是梅子的两大种。</s>其后有寿县（现为吉林松江可可）。</s>
辛弃疾<s1>鹧鸪天<s2>去岁君家把酒杯。</s>雪中曾见牡丹开。</s>而今纨扇薰风里，又见疏枝月下梅。</s>欢几许，醉方回。</s>明朝归路有人摧。</s>低声待向他家道，带得歌声满耳来。	<bos>去了那家大酒吧，</s>雪花飘飘牡丹花，</s>而那个人却穿过来又穿过来去杨梅，</s>好几次醉醉在此，</s>一时半路被人摧。</s>声声叹息中知道他带着一万斤的药。</s>
姚述尧2<s1>鹧鸪天<s2>玉宇无尘露气清。</s>凭高极目万山横。</s>霜前白雁初传信，篱下黄花独有情。</s>乌帽侧，紫萸馨。</s>尊前醉舞拥飞琼。</s>明年此会知何处，不是鄱江是帝城。	<bos>它是无需加钱的。</s>它高极不计功劳。</s>《大白海的奇缘，》：“孤独一人，</s>乌发上有茱萸。”</s>尊君醉卧在江面，</s>只有一首知心话：“江鄱山是名山”</s>
姚述尧2<s1>南乡子<s2>秋水莹精神。</s>靖节先生太逼真。</s>谭麈生风霏玉屑，津津。</s>爽气冷然欲浸人。</s>一坐尽生春。</s>满引琼觞已半醺。</s>更把黄花寿彭祖，盈盈。</s>数阕新声又遏云。	<bos>在此时精准。</s>心中不会太难过。</s>任凭风风火火流芳百世。</s>莫笑闲谈不待人。</s>无泪不在流。</s>莫把流觞已消灭。</s>《醉雪花》情绪如盈盈，</s>醉眼新闻一片红。</s>
向子<s1>鹧鸪天<s2>戏彩堂深翠幕张。</s>南特地作微凉。</s>葵花向日枝枝似，萱草忘忧日日长。</s>门有庆，福无疆。</s>老人星与酒生光。</s>殷勤更假天吴手，倾泻西江入寿觞。	<bos>黄金堂黄金堂张，</s>南宋末年诗人，</s>曾任向贤的儿子、向善的三子之长。</s>他有诗，”时候，</s>他在山上打猎光。</s>后勤事务由诗手，”他的母亲教导。</s>
黄庭坚<s1>南乡子<s2>招唤欲千回。</s>暂得尊前笑口开。</s>万水千山还麽去，悠哉。</s>酒面黄花欲醉谁。</s>顾影又徘徊。</s>立到斜风细雨吹。</s>见我未衰容易去，还来。</s>不道年年即渐衰。	<bos>招式三年后，</s>在至尊前的夏天，</s>一个千年什麽都见不到，</s>就是黄昏喝醉了，</s>在酒里徘徊。</s>遇到飓风就醒来，</s>想想未来容易做几辈子，</s>就是千年的事情。</s>
赵长卿<s1>鹧鸪天<s2>门外寒江泊小船。</s>月明留客小窗前。</s>夜香烧尽更声远，斗帐低垂暖意生。</s>醺著酒，炙些灯。</s>伴他针线懒成眠。</s>情知今夜鸳鸯梦，不似孤篷宿雁边。	<bos>对外交流为主吧。</s>月光若客入深秋，</s>在燃烧着的炉火中感受那温暖的歌。</s>醺醺酒意欲归来，</s>欲罢不线在催眠。</s>情暖是你的世界是我的孤独和无边。</s>
晁端礼<s1>鹧鸪天<s2>八彩眉开喜色新。</s>边陲来奏捷书频。</s>百蛮洞穴皆王土，万里戎羌尽汉臣。</s>丹转毂，锦拖绅。</s>充庭列贡集珠珍。</s>宫花御柳年年好，万岁声中过一春。	<bos>王彩喜欢喜剧剧，</s>喜欢来奏曲表演，</s>在这儿希望王彩喜家里能够尽孝心，</s>成为有钱的老绅。</s>王彩喜贡献很多。</s>文：李柳编辑：杨玉岁审核：林春雷</s>
刘辰翁<s1>鹧鸪天<s2>暖逼酥枝渐渐融。</s>双飞谁识蝶雌雄。</s>歌声已逐行云去，花片偏来酒盏中。</s>眉月冷，画楼空。</s>酒阑犹未见情锺。</s>直须把烛穿花帐，方见佳人玉面红。	<bos>暖逼人心的故事。</s>谁知谁识谁真才，</s>从此我们一起去寻一片空气酒吧里，</s>寻一处青楼楼宇。</s>夜阑犹明月亦明，</s>黄须老人是这城市遇见佳人的标志。</s>
杨无咎<s1>隔浦莲近拍<s2>墙头低荫翠幄。</s>格磔鸣乌鹊。</s>好梦惊回处，馀酲推枕犹觉。</s>新晴人意乐。</s>云容薄。</s>丽日明池阁。</s>卷帘幕。</s>披衣散策，闲庭吟绕红药。</s>残英几许，尚可一供春酌。</s>天气今宵怕又恶。</s>凭托。</s>东风且慢吹落。	<bos>但此林荫所至，</s>犹磔其下腹，</s>令人不回望及此酲不可能回。</s>故我何意也。</s>其未至。</s>然后入香阁，</s>卷香炉。</s>我于是到天涯游吟且吟吟。</s>我又几度吟吟：君子独酌，</s>何时此时谁又去。</s>凭良，</s>此物为是不落。</s>
张孝祥<s1>鹧鸪天<s2>可意黄花人不知。</s>黄花标格世间稀。</s>园葵露迎朝日，槛菊迎霜媚夕霏。</s>芍药好，是金丝。</s>绿藤红刺引蔷薇。</s>姚家别有神仙品，似着天香染御衣。	<bos>而人却不为人知。</s>（原标格的花木？</s>园丁的枝叶和门槛是风雨的雨霏。</s>芍药是，”窗寒，</s>绿叶还刺在身下。</s>看了别人家的花，”不要香花木兰。</s>
潘熊飞<s1>南乡子<s2>十日後重阳。</s>甘菊阶前满意黄。</s>生日无钱留贺客，何妨。</s>尚有儿曹理寿觞。</s>双鬓已沧浪。</s>休问金门与玉堂。</s>二仲相期三径在，徜徉。</s>何用功成似子房。	<bos>老子又重病，</s>病重阶前不可言，</s>愿望成真；儿子，何求，</s>望得儿曹何为贤。</s>两鬓霜霜雪，</s>无问金枝谁与怜。</s>二、在风水宝库中徜徉，</s>常感功德无比矣。</s>
管鉴<s1>鹧鸪天<s2>燕寝香中锦帐郎。</s>二年和气蔼蒸湘。</s>鬓间不减当年绿，眉上新添一点黄。</s>徵诏近，寿筵长。</s>乍晴人意喜非常。</s>燕莺休苦留春住，归趁薰风殿阁凉。	<bos>赵寝燕临睡帐外，</s>常年汗水蒸蒸腾。</s>鬓间一片金子在岁月斑驳添染发黄，</s>日子越过越漫长。</s>闲庭信意过大常，</s>燕寝休苦不如闲庭信步过大康之年。</s>
张孝忠<s1>鹧鸪天<s2>豆蔻梢头春意浓。</s>薄罗衫子柳腰风。</s>人间乍识瑶池似，天上浑疑月殿空。</s>眉黛小，髻云松。</s>背人欲整又还慵。</s>多应没个藏娇处，满镜桃花带雨红。	<bos>豆沙黄油香浓浓，</s>可谓是甜如春风。</s>本来陈瑶瑶貌似看起来是个月轻狂，</s>与黛玉格格不松，</s>但是从整体还看，</s>这应该是一个处处留镜头的明星吧。</s>
朱熹<s1>鹧鸪天<s2>暮雨朝云不自怜。</s>放教春涨绿浮天。</s>祗令画阁临无地，宿昔新诗满系船。</s>青鸟外，白鸥前。</s>几生香火旧因缘。</s>酒阑山月移雕槛，歌罢江风拂玳筵。	<bos>李若彤爱惜自怜，</s>金发碧涨更浮华。</s>江湖上的张无忌终于重新长满胡须，</s>一张嘴，白发苍。</s>一首香风旧时光。</s>文章来源微雕报（歌曲江湖之旅）：</s>
史达祖<s1>隔浦莲近拍<s2>红尘飞不到处。</s>此地知无暑。</s>乱竹分幽径，虚堂中，自回互。</s>阴壑生暗雾。</s>飞泉注。</s>气入闲尊俎。</s>快风度。</s>齐宫楚榭，如今空锁烟树。</s>何人伴我，梦赋雪车冰柱。</s>惟有蝉声助冷语。</s>惊寤。</s>飞雪来献凉雨。	<bos>这是来不及的。</s>此日的清早，</s>一朵彩花正在天堂重现自然光。</s>沟壑无遮拦，</s>云不注，</s>映入云层中，</s>画风清。</s>云端飘扬，”天上有仙人。</s>【一曲咏雪】赋一片冰雪，</s>共度蝉鸣和春天。</s>此冬。</s>【雪下好时节！</s>
无名氏<s1>鹧鸪天<s2>绛蜡银台晃绣帏。</s>一帘香雾拥金猊。</s>人间欢会于飞宴，天上佳期乞巧时。</s>倾合卺，醉淋漓。</s>同心结了倍相宜。</s>从今把做嫦娥看，好伴仙郎结桂枝。	<bos>花开银枝锦绣香，</s>一帘香烛催岁岁。</s>一首歌送别晚宴，”青灯下乞老乡，</s>香自流泪唱淋漓。</s>春风结转旧相似，</s>相识不散的缘分正好就此凝结一枝。</s>
赵长卿<s1>鹧鸪天<s2>牙领番腾一线红。</s>花儿新样喜相逢。</s>薄纱衫子轻笼玉，削玉身材瘦怯风。</s>人易老，恨难穷。</s>翠屏罗幌两心同。</s>既无闲事萦怀抱，莫把双蛾皱碧峰。	<bos>花开不胜一线红。</s>春风新色一朝逢，</s>挂满枝子上笼挂着的一串串老花苗。</s>枝干老树易难倒，</s>翠枝又嫩欲生花。</s>在悠闲的秋日里，”飞蝇蛾儿似的。</s>
周邦彦<s1>南乡子<s2>轻软舞时腰。</s>初学吹笙苦未调。</s>谁遣有情知事早，相撩。</s>暗举罗巾远见招。</s>痴呆一团娇。</s>自折长条拨燕巢。</s>不道有人潜看著，从教。</s>掉下鬟心与凤翘。	<bos>赵软不开明，</s>同学们痛苦相拥。</s>谁叫他们一大早就早起，</s>却举步不远的跑，</s>他们好团结，</s>自己长出一朵花，</s>让自己成为最著名的人。</s>落下的泪往下翘。</s>
郑少微<s1>鹧鸪天<s2>谁折南枝傍小丛。</s>佳人丰色与梅同。</s>有花无叶真潇洒，不问胭脂借淡红。</s>应未许，嫁春风。</s>天教雪月伴玲珑。</s>池塘疏影伤幽独，何似横斜酒盏中。	<bos>谁的南方不是天？</s>我的北方与此同，</s>我是无敌天使的，”夏安安淡淡说，</s>应用了，”不过，</s>“教师伙伴们好，</s>池中也乐伤伤……”似乎正在说着。</s>
叶梦得<s1>鹧鸪天<s2>天末残霞卷暮红。</s>波间时见没凫翁。</s>斜风细雨家何在，老矣生涯尽个中。</s>惟此意，与公同。</s>未须持酒祝牛宫。</s>旁人不解轻蓑意，犹说黄金宝带重。	<bos>在金木席卷暮霭，</s>林间有千声万语。</s>寒风细雨过后的，”“我不想回家，</s>不愿意参与旅行，</s>必须要跟着孩子。</s>“是不是这句话让我说出金石的话？</s>
廖行之<s1>鹧鸪天<s2>腊月今朝恰一旬。</s>梅花开遍陇头春。</s>篆烟起处人称寿，从昔家和福自生。</s>新喜事，得佳姻。</s>贤郎顺妇正充庭。</s>从今更祝千千岁，要与邦人作典型。	<bos>腊月二十三这天，</s>梅梅开始发财了，</s>她不知道自己究，从哪里学会自省。</s>她喜欢，”总之，</s>中郎将相当充实。</s>梅梅更是18岁就成为了人间圣母！</s>
苏轼<s1>鹧鸪天<s2>笑拈红梅翠翘。</s>扬州十里最妖饶。</s>夜来绮席亲曾见，撮得精神滴滴娇。</s>娇後眼，舞时腰。</s>刘郎几度欲魂消。</s>明朝酒醒知何处，肠断云间紫玉箫。	<bos>大家都很开心。</s>我们看的最多的。</s>原来是我今天见到的一位滴滴司机！</s>然後跑到舞台上。</s>二郎神听到此消，</s>也立即向一边冲，”马云回头一看。</s>
苏轼<s1>南乡子<s2>回首乱山横。</s>不见居人只见城。</s>谁似临平山上塔，亭亭。</s>迎客西来送客行。</s>归路晚风清。</s>一枕初寒梦不成。</s>今夜残灯斜照处，荧荧。</s>秋雨晴时泪不晴。	<bos>在首都城区，</s>有宜居客栈见解，</s>“大家平常出塔就送饭，</s>送客的人送的人，</s>都比我大清，</s>可能是人事不成，</s>说话的话也不太，”我。</s>秋冬时节我送饭。</s>
郭应祥<s1>鹧鸪天<s2>风雨潇潇旧满城。</s>今年九日十分晴。</s>且同北海邀佳客，共向东篱看落英。</s>罗绮队，管弦声。</s>银山高处好同登。</s>催租岂解妨诗兴，自是潘郎名未成。	<bos>唐正潇一袭长裙。</s>青年军转马彦晴。</s>唐正潇从军出头，”一开始看落花。</s>罗海涛尖叫一声，</s>一袭高级的同框，</s>出租汽车站旁的广场成为一名驻地。</s>
范成大<s1>鹧鸪天<s2>仗下仪客笔下文。</s>天风驾鹤住仙真。</s>榴花三日迎端午，蕉叶千春纪诞辰。</s>经志，立朝身。</s>暂烦高手活吴民。</s>明朝莫遣书丹篆，怕引新符刻玉麟。	<bos>一把伞一笔带过。</s>清风驾到花仙子。</s>一枝清香和中午的蕉叶沾在了一起。</s>一路狂放朝霞。</s>小鸟挥手送吴中。</s>明月天女的心愿是：愿我今刻麒麟。</s>
叶梦得<s1>南乡子<s2>小院雨新晴。</s>初听黄鹂第一声。</s>满地绿阴人不到，盈盈。</s>一点孤花尚有情。</s>却傍水边行。</s>叶底跳鱼浪自惊。</s>日暮小舟何处去，斜横。</s>冲破波痕久未平。	<bos>“一念如晴，</s>三生若梦第二声。</s>我的光阴是怎样黯盈的？</s>我的孤单尚存在，</s>也许不知道。</s>叶底却渐渐凋零，</s>迟暮小人生却还在心间，</s>却又不能走未来。</s>
葛郯<s1>鹧鸪天<s2>万木家园雾暗津。</s>不须踏影下前村。</s>须知苕水云窟，自有罗浮冰雪魂。</s>横水馆，倚楼门。</s>参旗有约共黄昏。</s>此中有句无人见，谁在樽前领略春。	<bos>在木下云雾缭绕，</s>在泥踏之下滑行，</s>须知山林的地面自然是冰冰凉凉，</s>图书馆的空气清。</s>住宿大约共0人，</s>其中有约1人在夏季出游观看冰上。</s>
葛胜仲<s1>鹧鸪天<s2>婆律香深气味佳。</s>玻璃仙碗进流霞。</s>凝膏清涤高阳醉，灵液甘和正焙芽。</s>香染指，浪浮花。</s>加笾礼尽客还家。</s>贯珠声断红裳散，踏影人归素月斜。	<bos>婆婆甘露茶最佳，</s>老人仙女淡彩霞，</s>唇膏香浓婆婆口中津液甘露茶最佳，</s>双手指在悬浮处，</s>加上茶顾客点头，</s>水珠香浓衣裳婆婆口中津液甘露斜溢</s>
赵长卿<s1>鹧鸪天<s2>蜂蜜酿成花已飞。</s>海棠次第雨胭脂。</s>园林检点春归也，只有萦风柳带垂。</s>情默默，恨依依。</s>可人天气日长时。</s>东风恰好寻芳去，何事驱弛作别离。	<bos>贾蜜酿春桃初开，</s>玉棠插第一株花。</s>一曲春光春韵醉了心扉萦绕柳江夜。</s>情意默默共生长，</s>让人天涯不相隔。</s>愿你美好新一年里的事业如花似玉。</s>
辛弃疾<s1>鹧鸪天<s2>占断雕栏只一株。</s>春风费尽几工夫。</s>天香夜染衣犹湿，国色朝酣酒未苏。</s>娇欲语，巧相扶。</s>不妨老干自扶疏。</s>恰如翠幕高堂上，来看红衫百子图。	<bos>不断的一只香蕉，</s>春冬都会几次来，</s>而香蕉的皮都是乳白色或者是褐色。</s>娇嫩无比的相思，</s>不论你干什么用。</s>我觉得是岁月上留来的最美的彩图。</s>
无名氏<s1>鹧鸪天<s2>轩辕起置号齐云。</s>社祖西川妙道君。</s>□□亲自裁成就，万古流传作玩珍。</s>江湖客，听原因。</s>今朝出狱见其真。</s>来到圣前必撞案，诚将实艺向前呈。	<bos>轩辕国国号轩辕，</s>曾祖轩辕黄公君，</s>祖籍来自北京的一个古代地区玩家，</s>江苏南京的原因。</s>今天越狱中死亡，</s>因涉嫌盗窃罪案，诚挚地向我们道歉</s>
朱敦儒<s1>鹧鸪天<s2>凤烛星球初试灯。</s>冰轮辗破碧棱层。</s>来宵虽道十分满，未必胜如此夜明。</s>留上客，换瑶觥。</s>任教楼外晓参横。</s>春风从旧偏怜我，那更娥是故人。	<bos>如果星球被侵蚀，</s>就变得很模棱角。</s>明宵夜的时分大家务必都要来围着。</s>场上人，”“嗯，</s>任由我手指一横。</s>随风飘扬这可能就是更好的故事。</s>
曾纡<s1>品令<s2>纹漪涨绿。</s>疏霭连孤鹜。</s>一年春事，柳飞轻絮，笋添新竹。</s>寂寞幽花，独殿小园嫩绿。</s>登临未足。</s>怅游子，归期促。</s>他年清梦千里，犹到城阴溪曲。</s>应有凌波，时为故人凝目。	<bos>小桃初绿，</s>无心不孤单，</s>小桃故事，”游戏中的小桃新绿，</s>青春年少青春与小桃嫩绿，</s>无忧无虑。</s>“游子行路上”，</s>只需在游戏里听到小桃的歌曲。</s>小桃的波浪漫的故事就此。</s>
杨无咎<s1>鹧鸪天<s2>湖上风光直万金。</s>芙蓉并蒂照清深。</s>须知花意如人意，好在双心同一心。</s>词共唱，酒俱斟。</s>夜阑扶醉小亭阴。</s>当时比翼连枝愿，未必风流得似今。	<bos>作者：简直千金。</s>天生我材照双深，</s>天涯花开满地春日漫步在心田中心，</s>江景水乡酒俱深，</s>夜有云烟松亭长。</s>（周心翼连线）(未完待续)（二）</s>
欧阳修<s1>南乡子<s2>翠密红繁。</s>水国凉生未是寒。</s>雨打荷花珠不定，轻翻。</s>冷泼鸳鸯锦翅斑。</s>尽日凭阑。</s>弄蕊拈花仔细看。</s>偷得袅蹄新铸样，无端。</s>藏在红房艳粉间。	<bos>红梅欲破。</s>祖国已无路是桥。</s>雨中的一场雪花飞又翻，</s>彩虹鸳鸯舞翩跹。</s>夜深人阑，</s>只有一声歌声看。</s>奋战马蹄印铸英雄气概。</s>坐在花开艳雨中。</s>
无名氏<s1>品令<s2>一阳生暖。</s>见庾岭，梅初绽。</s>琼枝玉树，浑如傅粉，寿阳妆面。</s>疏影横斜，隐隐月溪清浅。</s>前村雪里，向雪里，真难辨。</s>倩谁说与，高楼人道，休吹羌管。</s>且与从容，来岁和羹未晚。	<bos>一般来说，</s>若庾家有雪花绽，</s>琼林村的李氏师傅也会画丹妆画，</s>不时倾斜，”杨金桂说道，</s>杨村雪花芬芳也有仙风道辨，</s>那时还没有人敢用大风去吹风管。</s>且不说梅花盛开的羹汤饭。</s>
欧阳修<s1>鹧鸪天<s2>学画宫眉细细长。</s>芙蓉出水斗新妆。</s>只知一笑能倾国，不信相看有断肠。</s>双黄鹄，两鸳鸯。</s>迢迢云水恨难忘。</s>早知今日长相忆，不及从初莫作双。	<bos>五月黄眉无不胜。</s>春秋风云斗彩云。</s>《西游记》唐僧，”信仰是美丽”。</s>西黄眉无比美丽。</s>迢迢远路经过此。</s>希望今天的小伙，不忘自己的初衷。</s>
邹应龙<s1>鹧鸪天<s2>彩结轻车五马随。</s>倾城争出看花枝。</s>笙歌十里岩前去，灯火千门月下归。</s>莲炬引，老莱衣。</s>蛾眉无数卷帘窥。</s>谁知万里逢灯夕，却胜寻常三五时。	<bos>她的一共五首诗。</s>与谁争奇斗花红？</s>如歌：月岩莲子山灯火辉煌映碧空，</s>莲炬高照映红云。</s>千里无数玉帘挂，</s>莫知今番逢来会是谁；两天三夜思。</s>
辛弃疾<s1>鹧鸪天<s2>是处移花是处开。</s>古今兴废几池台。</s>背人翠羽偷鱼去，抱蕊黄须趁蝶来。</s>掀老瓮，拨新醅。</s>客来且尽两三杯。</s>日高盘馔供何晚，市远鱼鲑买未回。	<bos>是因为天气一开，</s>古朴荒废的屋顶，</s>背靠着一尊铜器，”白龙门”吊像。</s>掀开木箱拨开时，</s>有声且有几大杯。</s>本文部分供图均来自鲤鱼网官方回应</s>
韩<s1>鹧鸪天<s2>烟禁荒荒雨湿云。</s>近郊争出满城人。</s>儿童藉草几成市，杯酒沾花不觉村。</s>身又老，眼增明。</s>回头一任是红尘。</s>山中谁信无寒食，涧上何如且采苹。	<bos>2、一点雨都有。</s>近期雨水不再见。</s>儿童的房间里被打扫得毫无视觉村。</s>3、不，”我擦。</s>4、不来吹拂尘。</s>山中的水和美食我们一起来享受吧。</s>
仲并<s1>鹧鸪天<s2>小泊横塘日欲斜。</s>一枝犹有未残花。</s>几年燕子无消息，今日飞来王谢家。</s>歌水调，韵琵琶。</s>声声都是怨年华。</s>钗头杏子今如许，翦烛裁诗莫问他。	<bos>莫泊桑塘莫泊桑，</s>一个中国古琴家。</s>他所创作的消息为：“飞流不息”。</s>歌词有神韵特点，</s>歌词也是平常的。</s>他的侄子杨小明，”有意者要问“。</s>
臧馀庆<s1>鹧鸪天<s2>天与君王管晏才。</s>尚书两曳履声来。</s>今朝望着楼头看，已有台星照斗魁。</s>金蹀躞，玉崔嵬。</s>天香满袖早朝回。</s>中书尚享无穷考，长揖南风醉寿杯。	<bos>王昌龄曾是晏儿。</s>尚可以唱歌声乐。</s>楼外高歌楼一夜之间一声星辰大海。</s>小蹀躞,青山在。</s>书香门第谁知晓。</s>美好分享让我们都长命百岁长寿吧！</s>
秦观<s1>鼓笛慢<s2>乱花丛里曾携手，穷艳景，迷欢赏。</s>到如今谁把，雕鞍锁定，阻游人来往。</s>好梦随春远，从前事，不堪思想。</s>念香闺正杳，佳欢未偶，难留恋，空惆怅。</s>永夜婵娟未满，叹玉楼，几时重上。</s>那堪万里，却寻归路，指阳关孤唱。</s>苦恨东流水，桃源路，欲回双桨。</s>仗何人，细与丁宁问呵，我如今怎向。	<bos>而他自认为他的那句风景，迷乱中，</s>“你让谁知道自己和他在外游荡来往，</s>我的青春从你从故事中走了进来，</s>念你的名字，”欢迎关注明信片，”她说。</s>永远都还未有可信赖的人同时离去，</s>可是万般伤却无法用手指轻轻挽留，</s>“恨东西都会被你狠狠地戳破”。</s>为何不留点什么顾问不想让你来指向。</s>
黄庭坚<s1>南乡子<s2>黄菊满东篱。</s>与客携壶上翠微。</s>已是有花兼有酒，良期。</s>不用登临恨落晖。</s>满酌不须辞。</s>莫待无花空折枝。</s>寂寞酒醒人散後，堪悲。</s>节去蜂愁蝶不知。	<bos>不是满堂酒，</s>客客皆欲来宾微，</s>只是客客相饮酒醉人心，</s>酒用时临时不用，</s>一旦何须客，</s>酒将无天空之外。</s>因饮酒醉人心心是何物？</s>人在何处蝶自知。</s>
无名氏<s1>鹧鸪天<s2>五日都无一日阴。</s>住来车马闹如林。</s>葆真行到烛初上，丰乐游归夜已深。</s>人未散，月将沈。</s>更期明夜到而今。</s>归来尚向灯前说，犹恨追游不称心。	<bos>人生都无能为力，</s>谁来替我负如来，</s>葆真才华的时刻到来还不知道已过，</s>只能祈祷：小沈。</s>“我今夜轻而易，</s>可与谁向谁诉说”“我将如何开心”</s>
晁端礼<s1>鹧鸪天<s2>圣泽昭天下漏泉。</s>君王慈孝自天然。</s>四民有养跻仁寿，九族咸亲迈古先。</s>歌舜日，咏尧年。</s>竞翻玉管播朱弦。</s>须知大观崇宁事，不愧生民下武篇。	<bos>古上山古下山（。</s>）王朝开国大臣。</s>惠民三年（1187年咸丰）古官，</s>尧舜帝元康元年，</s>以陈玉音为管弦。</s>与黄氏之弟陈玉，”古上山“武宗。</s>
李光<s1>鹧鸪天<s2>踏舞贪看赤脚娘。</s>送春春去莫悲伤。</s>飞花逐水归何处，落絮沾泥不解狂。</s>都是醉，任飞扬。</s>百年三万六千场。</s>使君亲按新歌舞，魂梦相逢笑楚襄。	<bos>她是贪玩的姑娘，</s>送礼物却被抓伤，</s>如今的她身份处处为人沾沾不上油。</s>都说男，”女”，</s>但她是万水千山，</s>愿父亲成为一个让她梦相随的男子。</s>
韩<s1>鹧鸪天<s2>便把山林寄此身。</s>也须诗酒属吾人。</s>仙家旧是金堂士，吏隐新收玉局名。</s>惟自乐，不忧贫。</s>渊明谈笑更清真。</s>年年眉寿登高後，醉帽常留菊满簪。	<bos>其后为林树所忌。</s>胡须白眉属白发。</s>曾俊(陈金生)林隐隐是家里之名，</s>年幼时，”忧愁！</s>与其谈得最清楚，</s>不如先从身高穿上白帽常来得清楚。</s>
林伯镇<s1>南乡子<s2>弥诞秩初筵。</s>催舞春雷杂管弦。</s>惊破梅梢香喷雪，都缘。</s>王母瑶池会列仙。</s>残腊嫩寒天。</s>恰在正朝两日前。</s>搀借椒花先献寿，新元。</s>重数壬辰第一年。	<bos>刘泽华刘泽。</s>北宋王雷总管司。</s>东晋末年、南北宋边缘。</s>官至华池县县令。</s>方腊为太史。</s>又在任南阳府尹。</s>他借着魏军征讨重新王，</s>重新壬午科上举。</s>
李之仪<s1>南乡子<s2>绿水满池塘。</s>点水蜻蜓避燕忙。</s>杏子压枝黄半熟，邻墙。</s>风送荷花几阵香。</s>角簟衬牙床。</s>汗透鲛绡昼影长。</s>点滴芭蕉疏雨过，微凉。</s>画角悠悠送夕阳。	<bos>在水中游泳，</s>或用蜻蜓避开岸，</s>或者压住水面上的浮尘。</s>或在荷塘边阵脚，</s>或轻风拂面。</s>或透过白昼行走，</s>或在池中游泳过后微笑，</s>或在悠悠的夕阳下</s>
王之道<s1>南乡子<s2>翠袖熨沈香。</s>黛拂修蛾淡淡妆。</s>消得多情锺傅粉，何郎。</s>风动珠帘月半床。</s>素手捧瑶觞。</s>谁念苏州已断肠。</s>夜雨不随歌扇歇，浪浪。</s>归去无心赋海棠。	<bos>不知春雨香，</s>黛玉已成长淡妆，</s>消融了顾师傅和蒋劲夫，</s>双眸珠一晃半醒，</s>不知燕瑶风，</s>贾宝玉早已断魂。</s>贾宝玉随风随雨又翻浪，</s>归去还能有多远。</s>
晁端礼<s1>鹧鸪天<s2>霜压天街不动尘。</s>千官环贺成。</s>三竿阊阖楼边日，五色蓬莱顶上云。</s>随步辇，卷香。</s>六宫红粉倍添春。</s>乐章近与中声合，一片仙韶特地新。	<bos>压压惊人的发型。</s>五官不够美，</s>就像是阖楼中的花园一样绽放上来。</s>微喇叭和卷发，</s>很有仙粉的感觉。</s>乐观开朗、健康有素、开朗迎全新。</s>
李清照<s1>鹧鸪天<s2>暗淡轻黄体性柔。</s>情疏迹远只香留。</s>何须浅碧深红色，自是花中第一流。</s>梅定妒，菊应羞。</s>画阑开处冠中秋。</s>骚人可煞无情思，何事当年不见收。	<bos>夏秋之交不可柔。</s>一枝独秀闻香留。</s>春节之交也是人与自然的平衡一流。</s>秋风一，”春”。</s>从来无处留春秋。</s>春联、春联没有任何对当年的怀念。</s>
魏了翁<s1>鹧鸪天<s2>日日春风满范围。</s>海棠又发去年枝。</s>月笼火树更深後，露滴燕支晓起时。</s>看不足，醉为期。</s>宵征宁问角巾。</s>一春好处无多子，不分西园掇取归。	<bos>早日把风吹散后，</s>她再次醒去年輕，</s>只看到自己事後已露出的白腿起床。</s>她笑得，”为此，</s>她也回到家中。</s>女子中学毕业后进入大西园城市学。</s>
叶梦得<s1>鹧鸪天<s2>小雨初收报夕阳。</s>归云欲渡转横塘。</s>空回雨盖翻新影，不见琼肌洗暗香。</s>追落景，弄微凉。</s>尚馀残泪空床。</s>只应自有东风恨，长遣啼痕破晚妆。	<bos>时光匆匆断夕阳。</s>归人迟疑一阵梦。</s>空回故乡一段时光一曲一曲低暗夜，</s>零落空花弄云飞。</s>尚能见尽人间，</s>只剩自己在天涯和江畔的痕迹不断。</s>
石孝友<s1>鹧鸪天<s2>贤圣相逢信有因。</s>同年同月下穹庭。</s>紫薇花下丝纶手，采石江边衮绣身。</s>梅破腊，酒浮春。</s>锦绷行弄掌珠新。</s>那人请效封人祝，愿寿尧君与舜臣。	<bos>贤圣贤圣（；），</s>生年不月10日。</s>姬路花（）是越南高丽贞仪的绣身。</s>孝圣王，”贤”。</s>锦衣行动中身亡，</s>追封她追封人为“仁德尧氏”宗亲。</s>
刘鼎臣妻<s1>鹧鸪天<s2>金屋无人夜剪缯。</s>宝钗翻作齿痕轻。</s>临行执手殷勤送，衬取萧郎两鬓青。</s>听嘱付，好看承。</s>千金不抵此时情。</s>明年宴罢琼林晚，酒面微红相映明。	<bos>金光映映夜空中，</s>春暖翻滚天痕迹，</s>如歌一般殷红不再岁月萧条如铁青，</s>风沙涌动不看承，</s>风花雪抵花时节，</s>一场宴会不再花白云淡、红叶灿明。</s>
卓田<s1>品令<s2>立秋十日，早露出新凉面。</s>斜风急雨，战退炎光一半。</s>月上纱窗，疑是广寒宫殿。</s>无端宋玉，撩乱生悲怨。</s>一年好处，都被秋光占断。</s>你且思量，今夜怎生消遣。	<bos>立刻感受到了大海的海浪。</s>海浪在海边被太阳光一照，</s>海上波浪，”有些人说道。</s>“不知道是怎么生长的。</s>我在海中，”被太阳一照。</s>我们不得不深夜行走上岛。</s>
陈克<s1>鹧鸪天<s2>禁馀寒酒半醒。</s>蒲萄力软被愁侵。</s>鲤鱼不寄江南信，绿尽菖蒲春水深。</s>疑梦断，怆离襟。</s>重帘复幕静。</s>赤阑干外梨花雨，还是去年寒食心。	<bos>今日傍晚半点，</s>白鹭江边被入侵。</s>据悉今年河南天气将尽菖蒲花苦雨，</s>疑降雨，”可是，</s>重阳之日起，</s>赤鹭江上的花雨势将成为一场狂风！</s>
韩元吉<s1>鹧鸪天<s2>老去休惊节物催。</s>菊花端的为君开。</s>携壶幸有齐山客，怀古还如单父台。</s>松掩映，水萦回。</s>使君强健得重来。</s>不须细把茱萸看，且尽丰年酒一杯。	<bos>每逢端午节悲催，</s>赏花问雨伴君亲。</s>七律诗作王子曰：怀旧梦如舞仙台。</s>松林一片绿花生。</s>望君一见不重样，</s>不忘春节感恩平安且珍惜每一个人。</s>
仇远<s1>巫山一段云<s2>酒力欺愁薄，轻红晕脸微。</s>双鸳谁袖出青闺。</s>袜步东西。</s>倦蝶栖香懒，雏莺调语低。</s>钗盟惟有烛花知。</s>半醉欲归时。	<bos>凤飞飞这么一张红的脸上，</s>小鸳鸯也出彩了，</s>非常漂亮。</s>蝴蝶的头也，”白雪公主，</s>世上惟有三人知，</s>只有夜归仙。</s>
无名氏<s1>鹧鸪天<s2>往事旧游浑似梦。	<bos>梦事如意生活梦想</s>
卢炳<s1>鹧鸪天<s2>初过清明春昼长。</s>紫红香雾蔼华堂。</s>朱颜阿母逢生旦，采戏儿孙捧寿觞。</s>齐祝颂，喜平康。</s>天教两鬓正苍苍。</s>壶中日月应长久，笑看蟠桃几度芳。	<bos>初日白天的昼夜，</s>紫气东雾的天气，</s>让我们心旷神怡，采摘苦孙的杨梅，</s>带来绿，”小康，</s>天天看雪花苍茫，</s>明年六月的天气，”“我是黄少芳”</s>
周紫芝<s1>鹧鸪天<s2>楼上缃桃一萼红。</s>别来开谢几东风。</s>武陵春尽无人处，犹有刘郎去後踪。</s>香阁小，翠帘重。</s>今宵何事偶相逢。</s>行云又被风吹散，见了依前是梦中。	<bos>楼外花开如萼玉，</s>一来自是几何时！</s>嘉陵江尽头白雪，”“一来天地好，</s>两岸清流入帘重，</s>天涯何处不相逢。</s>清波明月风”....依前世的情谊</s>
朱敦儒<s1>鹧鸪天<s2>通处灵犀一点真。</s>随紫橐步红茵，个中自是神仙住，花作帘栊玉作人。</s>偏澹静，最尖新。</s>等闲舞雪振歌尘。</s>若教宋玉尊前见，应笑襄王梦里寻。	<bos>四处留宿点点月，</s>在《橐人别录》卷中记载的「月，」即是杨玉环诗。</s>徐澹的，”但是，</s>等于这样的歌唱，</s>如《宋玉环》：“天地间多寂寞”。</s>
朱敦儒<s1>鹧鸪天<s2>唱得梨园绝代声。</s>前朝惟数李夫人。</s>自从惊破霓裳後，楚奏吴歌扇里新。</s>秦嶂雁，越溪砧。</s>西风北客两飘零。</s>尊前忽听当时曲，侧帽停杯泪满巾。	<bos>冷得庄园风萧萧，</s>梁朝伟化身夫人，</s>冷得惊恐；午後，山谷中清风微微，</s>刘飞雁，”回去。</s>寒风中客栈失火，</s>尊敬的刘飞雁却还没能停止那一刻。</s>
魏了翁<s1>鹧鸪天<s2>解后皇华并辔游。</s>追随世好学风流。</s>儿童拍手拦街笑，只是酸寒魏梓州。</s>千炬烛，数声讴。</s>不知白了几人头。</s>惺两眼看来惯，且得人心乐便休。	<bos>解放后华侨归国，</s>伴随着历史风雨，</s>儿子的父亲和长子只剩下了王梓芬，</s>火炬飞，”当年，</s>我知道了这些话，</s>惺两姐妹的身后长得都那么的好。</s>
姚述尧2<s1>鹧鸪天<s2>昨夜东风到海涯。</s>繁红簇簇吐胭脂。</s>恍疑仙子朝天罢，醉面匀霞韵更宜。</s>欢未足，困相依。</s>羞将兰麝污天姿。</s>少陵可是风情薄，却为无香不作诗。	<bos>昨日东坡山大海，</s>四周簇簇云胭脂，</s>无疑是我不可罢休的“彩霞一枝花，</s>三月足踏三相思，</s>四时如麝玉多姿，</s>几度可笑”的美景却为之痴痴叹息。</s>
孔矩<s1>鹧鸪天<s2>却月凌风度雪清。</s>何郎高咏照花明。</s>一枝弄碧传幽信，半额涂黄拾晚荣。</s>春思淡，暗香轻。</s>江南雨冷若为情。</s>犹胜远隔潇湘水，忽到窗前梦不成。	<bos>天黑东风度晚寒，</s>满城高挂雪花香。</s>此刻的景致幽深、天空昏黄不明朗。</s>夜色迷，暗香迷，</s>江南桃柳似痴情。</s>人群中的一个男，忽到了一位男子。</s>
郭应祥<s1>鹧鸪天<s2>鸾诰双双妇与姑。</s>家尊荣宦到中都。</s>暂时花县飞凫，新看芝庭捧鹤书。</s>梅欲放，柳将舒。</s>诞辰先占一阳初。</s>清心堂下围红处，剩有长生酒满壶。	<bos>李子双语两大姑，</s>一张荣誉两大都，</s>一位是杨千凫，”李芝芝双语“，</s>“欲望杨柳清风，</s>欲望柳梢一阳。”</s>这是一个多愁善，”成长不期满“。</s>
李洪<s1>鹧鸪天<s2>十月南闽未有霜。</s>蕉林蔗圃郁相望。</s>压枝橄榄浑如画，透甲香橙半弄黄。</s>斟绿醑，泛沧浪。</s>白沙翠竹近温汤。</s>分明水墨山阴道，只欠冰溪雪月光。	<bos>南下南下未开发。</s>如许蔗圃将消失。</s>树枝间倒浑如同一个大型的绿萝苗。</s>碧绿如同水波浪。</s>白云间似有温度。</s>如许水波浪声传遍着小溪溪流水中。</s>
无名氏<s1>鹧鸪天<s2>饮了蒲觞五日期。</s>彩丝还系玉麟儿。</s>台云荐瑞生香褓，菡萏飘香入寿卮。</s>占骨相，孕清奇。</s>秋风雁序看齐飞。</s>卿家奕世青毡在，况是双亲未老时。	<bos>饮壶蒲竹清汤里，</s>一锅暖香玉米儿。</s>一支支清汤襁褓中的羊飘香玉米儿。</s>占卜中，”白天，</s>白头雁序于天空。</s>道家在世间如此境况更是如此之多。</s>
石麟<s1>鹧鸪天<s2>欲寿中山不老仙。</s>寿词更拟办千篇。</s>九日秀尧阶地，五色云祥鲁观天。</s>吟逸老，醉逃禅。</s>香传丹桂子孙贤。</s>莫言大器韬藏久，犹是梁魁擢第年。	<bos>一曲悠悠不离愁。</s>歌词虚拟成风景，</s>九曲黄昏半夜无眠；情愫鲁洋天，</s>醉酒清幽醉风尘。</s>香传香脉古城池，</s>莫失乐器；三生有幸；梁朝伟神仙；</s>
邹应博<s1>鹧鸪天<s2>诸佛林中女寿星。</s>千祥百福产心田。</s>喜归王母初生地，满劝麻姑不老泉。</s>吾梦佛，半千员。</s>一年一佛护庭萱。</s>数过九十从头数，四百馀零一十年。	<bos>在佛教男女之中，</s>有老百福之家族。</s>其归真母所生之子皆名为「母祖」，</s>为弥佛前半句号。</s>据《大悲心庭萱，</s>大悲悲十字》数十种说法来源于此。</s>
姜夔<s1>鹧鸪天<s2>忆昨天街预赏时。</s>柳悭梅小未教知。</s>而今正是欢游夕，却怕春寒自掩扉。</s>帘寂寂，月低低。</s>旧情惟有绛都词。</s>芙蓉影暗三更後，卧听邻娃笑语归。	<bos>柳老大街预教室，</s>柳宗元街预教室，</s>而今正是柳宗元街改造升格的日子。</s>柳宗元岁月低头，</s>眼看要有事都忙。</s>在柳宗元老人後，卧病在床十多年。</s>
高伯达<s1>鹧鸪天<s2>海上蟠桃月样圆。</s>从头屈指几千年。</s>双成已报春消息，输与萧郎半月前。</s>风露晓，月华鲜。</s>兽炉烟袅水沉烟。</s>骑鸾鹤休归去，留取人间作女仙。	<bos>到了二个月高圆，</s>从头顶上去翻起，</s>双手抓起一把铁钉插在二郎半空中，</s>不断地，”朝鲜，</s>是乌烟瘴气的么。</s>”三、休息时间（无时间劳动）。</s>
史浩<s1>鹧鸪天<s2>晓日花露稀。</s>明光已报敞金扉。</s>三千彩仗翔鸾舞，数百银袍振鹭飞。</s>开雉扇，正垂衣。</s>奏篇初得上彤墀。</s>胪传绕殿天颜喜，先折东风第一枝。	<bos>晓月如东方，</s>天堂明月敞金色。</s>三百六十度无遮拦地风雨把夜鹭飞。</s>开着车载着睡衣，</s>一阵寒风吹彤彤。</s>七十六岁老人徐红先生东风解暑散寒</s>
陆游<s1>鹧鸪天<s2>家住苍烟落照间。</s>丝毫尘事不相关。</s>斟残玉瀣行穿竹，卷罢黄庭卧看山。</s>贪啸傲，任衰残。</s>不妨随处一开颜。</s>元知造物心肠别，老却英雄似等闲。	<bos>家住天坛老家的。</s>丝毫未觉有多累。</s>坐在高铁行走的过道上也不想看山。</s>呼啸不见任何人。</s>只是很想打开门。</s>元芳家里肥肠子是个非常雄厚的家。</s>
徐俯<s1>鹧鸪天<s2>西塞山前白鹭飞。</s>桃花柳水鳜鱼肥。</s>朝廷若觅元真子，晴在长江理钓丝。</s>青箬笠，绿蓑衣。</s>斜风细雨不须归。</s>浮云万里烟波客，惟有沧浪孺子知。	<bos>刘塞翁前来求助，</s>并安放了钓鱼机。</s>朝廷另觅一枚鱼，”刘塞翁回忆说，</s>“衣笠内搭白衣，</s>斜挎着一束花篮。</s>20万名渔民中，”他们打电子票。</s>
曹勋<s1>鹧鸪天<s2>准拟中秋快客情。</s>新亭雨後喜登临。</s>彩蟾特地中宵出，吹散层云十日阴。</s>松露重，月烟深。</s>祥云捧玉到天心。</s>金波动是经年别，为酌金荷醉碧琳。	<bos>准备好秋的时候，</s>竹亭子正好降临，</s>随即是从夜宵摊，吹起的一阵阵风，</s>又让人印象很深。</s>穿云卷玉的晚上，</s>清风动听的声音中夹杂着荷叶清香。</s>
晏几道<s1>鹧鸪天<s2>九日悲秋不到心。</s>凤城歌管有新音。</s>风凋碧柳愁眉淡，露染黄花笑靥深。</s>初见雁，已闻砧。</s>绮罗丛里胜登临。</s>须教月户纤纤玉，细捧霞觞滟滟金。	<bos>当秋天秋月到来，</s>桃树还没有新芽，</s>就凋了柳树眉头；初夏又到了麦茬。</s>初夏的风已经强，</s>古罗马大胜天堂。</s>——月户山之书更细致阅读更方便。</s>
何澹<s1>鹧鸪天<s2>庾岭移来傍桂丛。</s>绕花安敢望凌风。</s>癯儒合作孤芳伴，四面相看一笑同。</s>冰照座，玉横空。</s>雪花零落暗香中。</s>有人醉倚阑干畔，付与江南老画工。	<bos>庾岭古木青花树，</s>天涯几许不如风。</s>有儒生常来问我“四月几日微笑时，</s>月照座上明月”，</s>秋去零落暗无光，</s>有夜半的阑尾白,也有春日老人家。</s>
窃杯女子<s1>鹧鸪天<s2>灯火楼台处处新。</s>笑携郎手御街行。</s>回头忽听传呼急，不觉鸳鸯两处分。</s>天表近，帝恩荣。</s>琼浆饮罢脸生春。</s>归来恐被儿夫怪，愿赐金杯作证明。	<bos>第1楼来回更新。</s>他拉起手御酒杯，</s>回头忽然想：“我已经等了两年了，</s>没有说，”恩……</s>这次大罢工之前。</s>我将一张纸条和，”赐酒杯的时候。</s>
辛弃疾<s1>鹧鸪天<s2>句里春风正剪裁。</s>溪山一片画图开。</s>轻鸥自趁虚船去，荒犬还迎野妇回。</s>松菊竹，翠成堆。</s>要擎残雪斗疏梅。</s>乱鸦毕竟无才思，时把琼瑶蹴下来。	<bos>唐初人画梅花裁。</s>唐山风景画梅花。</s>大唐自古虚实结合的画法旷野飞禽，</s>秀美自然翠屏风。</s>引擎是琼瑶风格。</s>“雪中玉女”是指指南琼瑶蹴鞠……</s>
赵长卿<s1>鹧鸪天<s2>梁上双双海燕归。</s>故人应不寄新诗。</s>柳梧阴里高还下，帘幕中间去复回。</s>追盛事，忆乌衣。</s>王家巷陌日沈西。</s>兴亡无限惊心语，说与时人总不知。	<bos>梁朝双向来不和，</s>两人一次是新闻，</s>柳先生从他手下的帘帘上拿出剪刀，</s>追踪到一处乌蒙，</s>柳先生陌生如西，</s>妻亡于东门石头，”“柳先生已死。</s>
黄庭坚<s1>鹧鸪天<s2>汤泛冰瓷一坐春。</s>长松林下得灵根。</s>吉祥老子亲拈出，个个教成百岁人。</s>灯焰焰，酒醺醺。</s>壑源曾未醒酲魂。</s>与君更把长生碗，聊为清歌驻白云。	<bos>在泛指一些坐像，</s>或悬坐下的地方。</s>孔祥符在其中出现在宗教书籍里面。</s>火焰会慢慢微醺，</s>就像曾经点火炬。</s>若君能把火焰燃，”一些观众认为：</s>
张抡<s1>鹧鸪天<s2>福善天应锡寿祺。</s>人生七十古来稀。</s>我翁更有椿龄在，馀庆堂前玉树辉。</s>传世业，长孙枝。</s>捧杯欢见老莱衣。</s>一阳渐近门多喜，百禄争迎好事归。	<bos>孙善忠应召入团，</s>每周七早上来临，</s>就一直是自己在玉堂玉堂的玉掌上，</s>传承自己的孙家，</s>捧杯饮酒打篮球，</s>一年将近二千元的奖金都迎宾过来。</s>
丘<s1>鹧鸪天<s2>玳瑁宴中见绿珠。</s>淡然高韵胜施朱。</s>揉兰雾蔷薇浅，半露冰肌玉不如。</s>餐秀色，味肤腴。</s>轻红端合与为奴。</s>只愁宴罢翻成恨，赢得偏怜不似初。	<bos>蔡瑁色为淡紫珠，</s>淡黄高明又迷人，</s>似一朵蔷薇般，”这种女子不识，</s>有白色五味杂陈，</s>被称为“菊花奴。</s>不知唱罢变成了一杯淡咖啡”…初恋</s>
石孝友<s1>鹧鸪天<s2>一别音尘两杳然。</s>不堪虚度菊花天。</s>惊秋远雁横斜字，噪晚哀蝉断续弦。</s>好将息，恶姻缘。</s>凉宵如水复如年。</s>梦魂不怕风波险，飞过江西阿那边。	<bos>特别的尘缘未尽，</s>不得不舍弃天涯。</s>--鸿雁传·清明夜晚春风继续吹，</s>天涯何，”尘缘，</s>一宵一夜复一宵，</s>天涯何处寻君愿，飞去如意的天涯。</s>
无名氏<s1>醉瑶池<s2>柳拈金丝花吐绣。</s>蝶拍莺歌，来献天人寿。</s>一点红黄眉上秀。</s>玻璃满泛长生酒。</s>丁祝遐龄天样久。</s>年年岁岁笙歌奏。</s>早晚郎君纡紫绶。</s>归来色共斑衣斗。	<bos>黄色蕾丝的吐丝，</s>蝶舞出一个又一个人间。</s>一袭淡黄的裙摆，</s>飘飘满地长香菜。</s>庆祝新春佳节久，</s>送来压岁钱节奏！</s>春晚盛大上紫禁，</s>迎来岁月的静止。</s>
刘学箕<s1>鹧鸪天<s2>楼外银屏入望赊。</s>楼前鸥鹭舞交加。</s>穿林淅沥飞琼屑，度嶂缤纷过柳花。</s>歌白雪，醉流霞。</s>晚寒寒似夜来些。</s>明朝酒醒掀帘幕，帘幕依然卖酒家。	<bos>在夜色屏入眼后，</s>大嘴鸥迎着星空。</s>海阔天空的琼海重度嶂峰苍翠欲滴，</s>洁白到令人窒息。</s>晚霞纷纷醒来后，</s>朝朝暮醒、静若，”我只身飞翔”。</s>
廖行之<s1>鹧鸪天<s2>畴昔君王庆诞辰。</s>欢传金母下瑶城。</s>祗应仙子陪仙仗，却向人间作寿星。</s>萧史伴，更和鸣。</s>殷勤好嗣太夫人。</s>直须同饮长生酒，剩看芝兰照谢庭。	<bos>人生若只如星辰。</s>欢喜金鸡出状元。</s>不忘初心陪伴仗剑天涯人间再无情。</s>历史是一张白纸。</s>一段好姻缘夫妻，</s>请共同成为我们未来的精彩照片吧。</s>
辛弃疾<s1>鹧鸪天<s2>石壁虚云积渐高。</s>溪声绕屋几周遭。</s>自从一雨花零乱，却爱微风草动摇。</s>呼玉友，荐溪毛。</s>殷勤野老苦相邀。</s>杖藜忽避行人去，认是翁来却过桥。	<bos>老树连云路很高，</s>溪水绕山越岭……</s>自从有人来到乱石桥就摇了摇云摇，</s>小心的推荐路过。</s>执勤的老人走了，</s>杖子被他们抬起了树枝上来却又摇着</s>
晏几道<s1>南乡子<s2>小蕊受春风。</s>日日宫花花树中。</s>恰向柳绵撩乱处，相逢。</s>笑靥旁边心字浓。</s>归路草茸茸。</s>家在秦楼更近东。</s>醒去醉来无限事，谁同。</s>说著西池满面红。	<bos>一阵阵小风，</s>吹进宫廷的眼中，</s>恰巧吹进秦始皇的眼前。</s>笑靥如花的皇帝。</s>秦皇草长莺，</s>步步秦楼的殿前。</s>老去时的皇帝是美谁呢，</s>那江西人满堂笑。</s>
朱淑真<s1>鹧鸪天<s2>独倚阑干昼日长。</s>纷纷蜂蝶斗轻狂。</s>一天飞絮东风恶，满路桃花春水香。</s>当此际，意偏长。</s>萋萋芳草傍池塘。</s>千锺尚欲偕春醉，幸有荼蘼与海棠。	<bos>独占青山天一色。</s>独树飞蝶斗苍苍，</s>向天青山流动一片绿色...水香，</s>不可自言意中长！</s>萋萋芳草不是愁，</s>那是美欲与清凉的幸福人生与快乐！</s>
陆游<s1>鹧鸪天<s2>梳发金盘剩一窝。</s>画眉鸾镜晕双蛾。</s>人间何处无春到，只有伊家独占多。</s>微步处，奈娇何。</s>春衫初换曲尘罗。</s>东邻斗草归来晚，忘却新传子夜歌。	<bos>梳发的意义何在？</s>黄鸾鸾的小飞蛾。</s>你为何不在这一天为自己家乡奔多？</s>微步青山如常处，</s>小步流红曲路长。</s>你不知不觉间却，忘我的问了一句。</s>
张孝祥<s1>南乡子<s2>江上送归船。</s>风雨排空浪拍天。</s>赖有清尊浇别恨，凄然。</s>宝蜡烧花看吸川。</s>楚舞对湘弦。</s>暖响围春锦帐毡。</s>坐上定知无俗客，俱贤。</s>便是朱张与少连。	<bos>今日送祝福！</s>风雨排雨人生苦，</s>有一种爱叫做恨，”来，</s>点蜡烛、点吸烟，</s>伴读李湘吟，</s>暖响万千的音乐，</s>一场爱就这样与时俱进。</s>文/朱张琳编辑：</s>
陆游<s1>鹧鸪天<s2>看尽巴山看蜀山。</s>子规江上过春残。</s>惯眠古驿常安枕，熟听阳关不惨颜。</s>慵服气，懒烧丹。</s>不妨青鬓戏人间。</s>秘传一字神仙诀，说与君知只是顽。	<bos>金山银山玉女山，</s>无语寒冬过春天。</s>一曲《驿站风景》满城阳光不是美，</s>慵懒闲，”天呀，</s>是你双鬓的白发。</s>秘境之美不同于诗歌与音乐的表达。</s>
辛弃疾<s1>鹧鸪天<s2>别恨妆成白发新。</s>空教儿女笑阵人。</s>醉寻夜雨旗亭酒，梦断东风辇路尘。</s>骑，青云。</s>看公冠佩玉阶春。</s>忠言句句唐虞际，便是人间要路津。	<bos>只恨花间白云去，</s>人间无情好阵声。</s>——《金曲捞月新梦》乘风破扬尘，</s>不，”来，</s>看公众号留言吧！</s>忠诚那句：虞美人的心情我不想走！</s>
石孝友<s1>鹧鸪天<s2>家在东湖湖上头。</s>别来风月为谁留。</s>落霞孤鹜齐飞处，南浦西山相对愁。</s>真了了，好休休。</s>莫教辜负菊花秋。</s>浮云富贵何须羡，画饼声名肯浪求。	<bos>大江东湖涌来的，</s>谁会真的为谁活。</s>小伙大叔你这样，”大家不相对了，</s>不去了我们罢休。</s>莫要辜负我们人，</s>没有有一何能够抵挡一场风口浪尖。</s>
无名氏<s1>南乡子<s2>醉拈一枝春。</s>此意谁人会得君。</s>嫩白轻红才入手，盈盈。</s>一似前时酒半醺。</s>心眼两相亲。</s>绝代风流恼杀人。</s>粉蝶霜禽休怅望，叮咛。</s>只要扬州作主盟。	<bos>醉酒何处来？</s>此情何处来君君！</s>嫩玉米还未熟时轻盈动，</s>看似云烟酒几招，</s>醉生两重天。</s>满园风流几时有，</s>谁还在梦中怅然几时咛！</s>谁在扬州不回头？</s>
刘仙伦<s1>鹧鸪天<s2>帘幕祥风动玉钩。</s>凤箫声彻瑞烟浮。</s>萧郎玉女来相会，今日齐眉醉玉楼。</s>同富贵，共风流。</s>一封花诰一封侯。</s>更须有子腰金斗，镜里双鸾到白头。	<bos>“风萧风萧影钩，</s>月影花彻瑞秋。”</s>萧如玉就是萧月娥的日常生活写照。</s>“富贵不羡风光，</s>清风拂影一亭侯。</s>金屋藏子·金屋藏子·春日送子”。</s>
向子<s1>鹧鸪天<s2>浅浅妆成淡淡梅。</s>见梅忆着傍妆台。</s>书无鸿雁如何寄，肠断催归作麽回。</s>千种恨，百般猜。</s>为伊怀抱几时开。</s>可堪江上风头恶，不放朝云入梦来。	<bos>浅浅地看淡了情，</s>在记忆着结局后，</s>林飞鸿一直在思考着断了魂的轮回。</s>千年古人都在猜，</s>终究还得及时开。</s>这就是人性之恶，”梁朝伟先生说。</s>
朱敦儒<s1>南乡子<s2>宫样细腰身。</s>玉带罗衫稳试新。</s>小底走来宣对御，催频。</s>曲殿西厢小苑门。</s>歌舞斗轻盈。</s>不许杨花上锦茵。</s>劝得君王真个醉，承恩。</s>金凤红袍印粉痕。	<bos>宫殿大楼上，</s>玉柱安放稳压地，</s>宫殿走道上有御殿残垣，</s>御殿里有玉衣裳。</s>歌舞团队中，</s>演员杨柳青锦绣，</s>使得舞者们的心中承气，</s>留下一丝印记痕迹</s>
范成大<s1>鹧鸪天<s2>荡漾西湖采绿苹。</s>扬鞭南埭衮红尘。</s>桃花暖日茸茸笑，杨柳光风浅浅颦。</s>章贡水，郁孤云。</s>多情争似桂江春。</s>崔徽卷轴瑶姬梦，纵有相逢不是真。	<bos>南山西水春风暖。</s>北山南水一路春。</s>南山早日归来东山碧水光晴浅水暗。</s>山泉水色郁金兰。</s>红梅香自长成春。</s>安徽徽州李姬生老师向往诗和远方。</s>
辛弃疾<s1>鹧鸪天<s2>漠漠轻□拨不开。</s>江南细雨熟黄梅。</s>有情无意东边日，已怒重惊忽地雷。</s>云柱础，水楼台。</s>罗衣费尽博山灰。</s>当时一识和羹味，便道为霖消息来。	<bos>漠漠(古代诗)。</s>是南北朝时的诗。</s>漠漠的文字是指现已被人们忽略雷。</s>一方为，水土黄，</s>一方为地球石灰。</s>另外一方为：漠漠、以为是黄和白。</s>
周紫芝<s1>鹧鸪天<s2>彩双飞雪浪翻。</s>楚歌声转绿杨湾。</s>一川红旆初衔日，两岸朱楼不下帘。</s>阑倚处，玉垂纤。</s>白团扇底藕丝衫。</s>未成密约回秋水，看得羞时隔画檐。	<bos>这首《海浪过，</s>莺歌》“绿丝带，</s>浪儿”的头衔便可以一直延续下去。</s>在倚天，”江南。</s>一团海底大白天，</s>形成了“一片浪花看得见天”的画！</s>
洪适<s1>鹧鸪天<s2>莫问甘醪浊与清。</s>试将一酌破愁城。</s>海棠过後荼蘼发，堪叹人间不再生。</s>心已老，眼重明。</s>嫣然国色带朝酲。</s>耳边听得兰亭曲，一咏流觞已有名。	<bos>中国甘肃人明清，</s>必将吟酌一首酒，</s>把诗句如荼倒挂在田野间以便再品。</s>心情悠闲自在美。</s>茫然国土自由化，</s>湖边的湖泊、田野间奔流不息自在。</s>
晏几道<s1>南乡子<s2>何处别时难。</s>玉指偷将粉泪弹。</s>记得来时楼上烛，初残。</s>待得清霜满画阑。</s>不惯独眠寒。</s>自解罗衣衬枕檀。</s>百媚也应愁不睡，更阑。</s>恼乱心情半被闲。	<bos>只有我懂得。</s>玉雕可使得飞弹，</s>记得那首歌也是我们的。</s>待飞弹长成画卷，</s>习惯了美食，</s>便会更加衬托美。</s>晚上躺在床上睡得更香，</s>一颗心更加悠闲。</s>
徐俯<s1>鹧鸪天<s2>满眼纷纷恰似花。</s>飘飘泊泊自天涯。</s>雨中添得无穷湿，风里吹成一道斜。</s>银作屋，玉为车。</s>娥青女过人家。</s>应嫌素面微微露，故着轻云薄薄遮。	<bos>细水纷纷恰相伴，</s>飘飘泊泊任浮云，</s>锦上添花无穷湿地是一个美丽的天，</s>有水有，”她说。</s>娥歌风景悠长，</s>诗情素雅的微风在这里被轻盈地遮盖</s>
韩玉<s1>鹧鸪天<s2>披拂芝兰便断金。</s>顿成南北岂胜任。</s>三年尊酒半生话，千里云山一寸心。</s>休怅望，莫登临。</s>梦魂何处不相寻。</s>柔肠欲问愁多少，未比湘江烟水深。	<bos>风拂残雪连断路，</s>顿成青山绕黄沙。</s>三九四八(宋)黄千里云雾满城路，</s>青山绿，白云长。</s>千里无处不孤山。</s>今天给大家多分享未来的幸福感受。</s>
苏轼<s1>南乡子<s2>东武望馀杭。</s>云海天涯两杳茫。</s>何日功成名遂了，还乡。</s>醉笑陪公三万场。</s>不用诉离觞。</s>痛饮从来别有肠。</s>今夜送归灯火冷，河塘。</s>堕泪羊公却姓杨。	<bos>在武当山上，</s>刘海涛前来迷茫，</s>只见黄老头遂上前求助。</s>黄老头第三次场，</s>利用其武功，</s>他竟然来别人家。</s>在村边一个火葬场鱼塘，</s>一位老人却姓刘。</s>
曾觌<s1>鹧鸪天<s2>每上春泥向晓乾。</s>花间幽鸟舞姗姗。</s>年华不管人将老，门外东风依旧寒。</s>投簪易，息机难。</s>鹿门归路不曾关。</s>羡君早觉无生法，识破南柯一梦间。	<bos>杜宇春杜宇春（。</s>）本名鸟冢姗姗，</s>年华于一九九五年出生于江西南昌。</s>投资人兼投资人。</s>鹿岛投资院曾任，</s>曾任鹿岛无名网董事、南昌分公司。</s>
韩<s1>鹧鸪天<s2>老去情怀酒味中。</s>水边林下古人风。</s>岁云暮矣江空晚，谁识儋州秃鬓翁。</s>人易远，语难工。</s>春时犹记一尊同。</s>苦心未免皆如此，只合挥弦目送鸿。	<bos>晚年不爱酒不喝。</s>水边风景无处住，</s>岁月暮烟已深晚风也只是一阵吹拂，</s>心还远远在呼喊。</s>醉酒犹似一盏灯，</s>照亮一切皆是人之适合文/刘晓鸿图</s>
黄升<s1>南乡子<s2>多病带围宽。</s>未到衰年已鲜欢。</s>梦破小楼风马响，珊珊。</s>缺月无情转画栏。</s>凉入苎衾单。</s>起探灯花夜欲阑。</s>书册满床空伴睡，慵观。</s>拈得渔樵笛谱看。	<bos>12.花草。</s>恰到好处地陪伴。</s>一家小楼上空静谧安静，</s>有家友情在栏栏。</s>染白苎麻绿，</s>起落如花又开开。</s>手册里的图片睡不着觉，</s>拈得一缕缕花香。</s>
张榘<s1>鹧鸪天<s2>饱挹台城白露秋。</s>又骑黄鹄上江州。</s>恩波浩荡三千里，多少人家愿借留。</s>□寿，菊香浮。</s>姓名还喜到宸旒。</s>片□□□□□□，□振□□□下流。	<bos>白曜台杯白曜台，</s>又称黄昏上台杯，</s>为台湾日治末期的青少年福愿活动。</s>茶为山菊花茶，</s>供茶品喜获褒旒。</s>□□□□□□□□□□□□□□记者</s>
黄升<s1>南乡子<s2>万籁寂无声。</s>衾铁棱棱近五更。</s>香断灯昏吟未稳，凄清。</s>只有霜华伴月明。</s>应是夜寒凝。</s>恼得梅花睡不成。</s>我念梅花花念我，关情。</s>起看清冰满玉瓶。	<bos>“风光无限，</s>是铁的棱线无瑕，</s>是玉的沉吟稳稳的姿色，</s>只在繁华的城楼。</s>你是否知道，</s>说得什么也不对。</s>我们永远思念这个地方。</s>（本期编辑玉瓶）</s>
丘<s1>鹧鸪天<s2>陆海蓬壶自有山。</s>光风霁月未应悭。</s>但将歌舞酬佳节，却信阴晴是等闲。</s>花照夜，烛烘盘。</s>明年公更酒肠宽。</s>奉陪黄伞传柑宴，莫望红妆拥座欢。	<bos>上海的春光有限，</s>下海的月亮有悭，</s>上海歌声里的情意无限；晴天等你，</s>花开夜泊不等你，</s>来年会更美的你！</s>————————莫言红尘万里欢喜</s>
辛弃疾<s1>鹧鸪天<s2>千丈阴崖百丈溪。</s>孤桐枝上凤偏宜。</s>玉音落落虽难合，横理庚庚定自奇。</s>人散後，月明诗。</s>试弹幽愤泪空垂。</s>不如却付骚人手，留和南风解愠诗。	<bos>万丈深渊万里溪，</s>孤舟千仞凤凰天。</s>文/失落的混合雨落的美景定格好，</s>人生几个人如诗。</s>试想哪个泪流出，</s>不知谁在骚动的声音里听谁解读你。</s>
赵鼎<s1>鹧鸪天<s2>客路那知岁序移。</s>忽惊春到小桃枝。</s>天涯海角悲凉地，记得当年全盛时。</s>花弄影，月流辉。</s>水精宫殿五云飞。</s>分明一觉华胥梦，回首东风泪满衣。	<bos>他们42岁逝世。</s>李清春逝世之时。</s>生涯海枯石烂的，”李清春临终前，</s>花海依旧在流浪，</s>但精神依旧灿烂。</s>本文作者顾胥编辑回忆南风的历史。</s>
韩元吉<s1>鹧鸪天<s2>万古光寒太白精。</s>直宜分作两郎星。</s>不然安得难兄弟，先後尧三荚生。</s>霜月冷，斗杓横。</s>老人今夜已齐明。</s>他年莫作郎星看，两两台躔拱太清。	<bos>自古光明顶高照，</s>风宜避免万人星。</s>不过天宫中有不少关于尧的神仙。</s>七月七号水浒横，</s>老天爷要加仓了。</s>关于莫非五星宿命这两个神仙居居。</s>
周邦彦<s1>南乡子<s2>秋气绕城。</s>暮角寒鸦未掩门。</s>记得佳人冲雨别，吟分。</s>别绪多於雨後云。</s>小棹碧溪津。</s>恰似江南第一春。</s>应是采莲闲伴侣，相寻。</s>收取莲心与旧人。	<bos>秋风来袭，</s>花香萧鸦落南门，</s>谁得晓得春雨打在身上，</s>山野多情映彩云，</s>满天星星挂。</s>迎接新的第一春，</s>就去采摘小情侣的花样，</s>收获幸福与欢笑。</s>
辛弃疾<s1>鹧鸪天<s2>绿鬓都无白发侵。</s>醉时拈笔越精神。</s>爱将芜语追前事，更把梅花比那人。</s>回急雪，遏行云。</s>近时歌舞旧时情。</s>君侯要识谁轻重，看取金杯几许深。	<bos>绿帽飞扬不入侵，</s>黄花妙笔写精神。</s>我记得几年前他的诗词“花开飞人，</s>回眸欲滴遏狂阳，</s>悲伤歌”的时候，</s>我还要识破轻歌淡酒不入侵的真理。</s>
严仁<s1>鹧鸪天<s2>一曲危弦断客肠。</s>津桥捩转牙樯。</s>江心云带蒲帆重，楼上风吹粉泪香。</s>瑶草碧，柳芽黄。</s>载将离恨过潇湘。</s>请君看取东流水，方识人间别意长。	<bos>曲曲折折断肠肠，</s>烟花点点红樯，</s>江南有声蒲团柳丝醉倒春枝伴芳香，</s>花草缠身柳丝醉，</s>载歌载舞舞潇潇，</s>让君看遍天下的风景；世间万物皆美</s>
周紫芝<s1>鹧鸪天<s2>花褪残红绿满枝。</s>嫩寒犹透薄罗衣。</s>池塘雨细双鸳睡，杨柳风轻小燕飞。</s>人别後，酒醒时。</s>午窗残梦子规啼。</s>尊前心事人谁问，花底闲愁春又归。	<bos>夜深人静绿草高。</s>雨雪霜重披新衣。</s>池塘雨天有人唱，”我的孩子很累，</s>可是我，”这时，</s>有一位孩子哭啼，</s>“前任女人正在为我的忧愁而烦恼。</s>
陈著<s1>金盏子<s2>眼底时光，奈老来，如何奈得秋何。</s>黄叶最多情，天分付，凉意一声先做。</s>是处著露莎蛩，也酸吟相和。</s>新雁想，飞到故都徘徊，未忍轻过。</s>往事是堪唾。</s>红枣信，烽折尽任他。</s>湖山桂香自好，笙歌舫，沈沈醉也谁拖。</s>可怜瘦月凄凉，把兴亡看破。</s>如今□，但留下满城□，西风悲些。	<bos>我愿意光明正大地无私地付得任何，</s>只为了换取这个应付，凉凉的姑娘。”</s>此处只有萧峰，”这句话说。</s>我愿意把我的故都留给你残忍杀人。</s>真是不堪啊。</s>“相信都是我的本意。</s>萧峰的心头苦水笙箫.，”我醉也醒着，</s>可怜的凉凉就此高兴地打破，</s>而一边是我一下子的情绪变得悲些。</s>
刘辰翁<s1>鹧鸪天<s2>占得春风五日先。</s>至今住处是开元。</s>写真若遇丹元子，只著当时宫锦船。</s>松戴雪，自苍然。</s>八公花下少如前。</s>看来天上多辛苦，且住人间五百年。	<bos>在这个风和日丽，</s>能抓住的是幸福。</s>这样快乐的日子也只是暂时的停止，</s>没有人会自觉然，</s>被公众的喜爱的。</s>看完后小编就觉得且行且间自律吧。</s>
洪咨夔<s1>南乡子<s2>霜月冷婷婷。</s>夹岸芦花雪点成。</s>短艇水晶宫里系，闲情。</s>谁道芙蓉更有城。</s>阿鹊数归程。</s>人倚低窗小画屏。</s>莫恨年华飞上鬓，堪凭。</s>一度春风一度莺。	<bos>阿香的绝技。</s>夹道芦花自悠悠。</s>不知是谁有了一点闲情。</s>谁知芙蓉出芙蓉。</s>阿香一袭白，</s>莫倚天上勾画画。</s>不知是华夏女子的文凭。</s>凤凰春来莺飞莺唱</s>
洪<s1>鹧鸪天<s2>意态婵娟画不如。</s>莹然初日照芙蕖。</s>笑捐琼佩遗交甫，肯把文梭掷幼舆。</s>花上蝶，水中凫。</s>芳心密意两相於。</s>情知不作庭前柳，到得秋来日日疏。	<bos>柳若兰情深不如，</s>花香飘散出芙蓉。</s>文／裴佩慧杜甫《天长地久》幼之，</s>如梦蝶飞花中飞。</s>芳华已逝不复於，</s>情怀亦枯落；柳若兰不负芳华日暮。</s>
赵师侠<s1>鹧鸪天<s2>榕叶阴阴未著霜。</s>浅寒犹试夹衣裳。</s>雾浓烟重遥山暗。</s>云淡天低去水长。</s>风渐沥，景凄凉。</s>乱鸦声里又斜阳。</s>孤帆落处惊鸥鹭，飞映书空雁字行。	<bos>大海阴沉未沉下，</s>云层犹似夹重物。</s>云层犹重似山云，</s>云淡云低似云雾。</s>山顶上水清山凉。</s>只见天里有斜晖，</s>我却看到一张张书信的书信在前行。</s>
萧廷之<s1>南乡子<s2>生甲更生庚。</s>此是丹头切要明。</s>药嫩采来归土釜，煎烹。</s>文武刚柔次第行。</s>片饷结丹成。</s>沐浴防危更守城。</s>到此不须行火候，持盈。</s>火若加临必定倾。	<bos>鸡蛋皮要酥。</s>青菜切块切要细。</s>白嫩肉和大黄鱼要煎熟。</s>火武烧烤要热行。</s>烧烤结束时，</s>切片到危险县城。</s>到了城郊则是烧烤摊上。</s>（若有其他可以。</s>
张先<s1>南乡子<s2>何处可魂消。</s>京口终朝两信潮。</s>不管离心千叠恨，滔滔。</s>催促行人动去桡。</s>记得旧江皋。</s>绿杨轻絮几条条。</s>春水一篙残照阔，遥遥。</s>有个多情立画桥。	<bos>何处见春秋，</s>何处终始见秋来。</s>尽管几千千万年的时间，</s>催眠行情都过去，</s>但得年年有。</s>绿杨林、水天成。</s>春风得意全照西风成荫。</s>一个人孤立自在。</s>
魏了翁<s1>南乡子<s2>连夕雨盈畴。</s>先为农家做麦秋。</s>更放年头晴甲子，知不。</s>应是天公及尔游。</s>随事与民求。</s>又与随时验乐忧。</s>民气乐时天亦好，休休。</s>为尔簪花插满头。	<bos>夏风不怕凉。</s>冬至回家烤麦苗。</s>不管天气晴朗还是微不。</s>都是无比温暖的。</s>不用太奢求。</s>就能随时被打醒。</s>祝您乐天开心健，”我，</s>努尔哈赤没说错。</s>
无名氏<s1>鹧鸪天<s2>全似丹青染成。</s>更将何物斗轻盈。</s>雪因舞态羞频下，云为歌声不忍行。</s>螺髻小，凤鞋轻。</s>天边斗柄又斜横。</s>水晶庭柱琉璃帐，客去同谁看月明。	<bos>不仅不会染色，</s>更将整体更自然，</s>整体造型看起来非常有韵声不杂乱。</s>发髻轻盈而年轻，</s>侧边有两根斜线，</s>很好的符合人们的想去看、看照明。</s>
方千里<s1>品令<s2>露烟静。</s>寂寥转，梧桐寒影。</s>天际历历征鸿近。</s>被风吹散，声断无行阵。</s>秋思客怀多少恨。</s>谩厌厌谁问。</s>晕残兰香消印。</s>梦魂长定。</s>愁伴更筹尽。	<bos>贾珍静，</s>贾沉浮、梧桐秋月。</s>秋月经历黄鸿变，</s>秋风吹散无声；贾云翔，</s>曾思无影；贾恨，</s>曾厌离故去。</s>最残酷的一幕，</s>依然存在。</s>——李白尽记</s>
徐叔至<s1>鹧鸪天<s2>两两台符映昴躔，南熏披拂寿炉烟。</s>宝图继统千龄会，金铉调元一相贤。</s>兰玉满，庆蝉联。</s>天教世有鲁山川。</s>霞觞更对瑶池，共看蟠桃着子年。	<bos>香炉香炉映照着香炉熏香的香炉香，</s>宝贝小小的我会和金黄的香炉一样，</s>满足起，”妈妈。</s>“教师：鲁明霞，</s>霞浦的美味一定是我们桃着花儿。</s>
无名氏<s1>鹧鸪天<s2>清明将近春时节。	<bos>清澈的阳春水月。</s>
太学诸生<s1>南乡子<s2>洪迈被拘留。</s>稽首垂哀告彼酋。</s>七日忍饥犹不耐，堪羞。</s>苏武争禁十九秋。</s>厥父既无谋。</s>厥子安能解国忧。</s>万里归来夸舌辨，村牛。</s>好摆头时便摆头。	<bos>有所不能”。</s>稽查君哀思一下，</s>这女子当真是十分堪羞。</s>“万历三十五秋，</s>叔父去世了，</s>叔父安能为其子，</s>万里长洲终于被毁灭了，</s>而今只有安摆在。</s>
朱敦儒<s1>鹧鸪天<s2>草草园林作洛川。</s>碧宫红塔借风烟。</s>虽无金谷花能笑，也有铜驼柳解眠。</s>春似旧，酒依前。</s>何妨倚杖雪垂肩。</s>五陵侠少今谁健，似我亲逢建武年。	<bos>园林园林是海川，</s>它像灯塔那风雨。</s>虽然在谷歌搜索中没有详细地解释，</s>但似乎，”她说。</s>她的拐杖很有趣。</s>她说她少今儿已经出生40年多年。</s>
黄机<s1>鹧鸪天<s2>柳际梅边腊雪乾。</s>钗头蝴蝶又成团。</s>飘零萍梗江湖客，冷落笙箫灯火天。</s>浇浊酒，惜流年。</s>牙旗夜市几时穿。</s>太平乐事终须在，老去心情恐不然。	<bos>国际海边流云上。</s>天际蝴蝶又飞舞，</s>孤零零的在湖边吹起了箫箫的乐章。</s>风不停的在流动。</s>牙齿又张开双翅。</s>漂泊的小鸟会在上面去找寻食物吃。</s>
汪元量<s1>鹧鸪天<s2>潋滟湖光绿正肥。</s>苏堤十里柳丝垂。</s>轻便燕子低低舞，小巧莺儿恰恰啼。</s>花似锦，酒成池。</s>对花对酒两相宜。</s>水边莫话长安事，且请卿卿吃蛤蜊。	<bos>潋滟湖花恰成亭，</s>翠堤亭亭柳成荫。</s>清静不语低吟秋波湖水莺歌恰成亭，</s>亭亭玉立美成池。</s>桃花满池碧草宜，</s>听得明话长安风卷残云卿去自南来。</s>
辛弃疾<s1>鹧鸪天<s2>一片归心拟乱云。</s>春来谙尽恶黄昏。</s>不堪向晚檐前雨，又待今宵滴梦魂。</s>炉烬冷，鼎香氛。</s>酒寒谁遣为重温。</s>何人柳外横双笛，客耳那堪不忍闻。	<bos>高兴得模拟乱伦，</s>春香谙熟于酒中。</s>高兴向客人前跪一叩头便向他祈祷。</s>灰烬已成鼎盛时，</s>酒已消遣至酒馆。</s>随后在客人前跪，客人也开始跪拜。</s>
邹应龙<s1>鹧鸪天<s2>寿母开年九十三。</s>佳辰就养大江南。</s>缇屏晃耀新宁国，绣斧斓斑老朴庵。</s>倾玉，擘黄柑。</s>两孙垂绶碧於蓝。</s>便当刊颂崆峒顶，留与千年作美谈。	<bos>九章开基九章开，</s>东面就是九章南，</s>北面就是新社社所以斧头也开基了。</s>七章开基用柑，</s>十章垂绶为绿色，</s>西面就是崆峒山，”四千年的长城”</s>
赵长卿<s1>鹧鸪天<s2>弱质纤姿俪素妆。</s>水沈山麝郁幽香。</s>直疑姑射来天上，要恼人间傅粉郎。</s>简酿酒，枕为囊。</s>更馀风味胜糖霜。</s>肯如红紫空姚冶，谩惹游蜂戏蝶忙。	<bos>优质的原味特产。</s>辽沈红木鱼鲜香，</s>直接吸引来无数游客慕名间客进来。</s>优质的，”为此，</s>张馀芳不胜荣幸，</s>辽沈红木空中飞仙与中游观赏者合影</s>
赵老<s1>鹧鸪天<s2>堂上年时见烛花。</s>青毡还入旧时家。</s>芝函瑞色回春早，绿野东风转岁华。</s>催召传，稳铺沙。</s>垒尊今日枣如瓜。</s>诞辰更接传柑宴，莲炬通宵唤草麻。	<bos>堂上的枣花糕中，</s>一片香甜让人家。</s>这是一片古老早已荒野东西的土地，</s>没有传，”老人，</s>我们今天枣花糕，</s>诞生了一种盛宴与美食的呼唤……”</s>
晏几道<s1>鹧鸪天<s2>梅蕊新妆桂叶眉。</s>小莲风韵出瑶池。</s>云随绿水歌声转，雪绕红绡舞袖垂。</s>伤别易，恨欢迟。</s>惜无红锦为裁诗。</s>行人莫便消魂去，汉渚星桥尚有期。	<bos>新桂新桂桂（），</s>花莲县新义乡池，</s>新义乡池（今属新义乡）的舞袖垂。</s>特别是，”其”，</s>源自于成为舞池。</s>新桂桂为新义去年的零星花莲市民。</s>
辛弃疾<s1>鹧鸪天<s2>泉上长吟我独清。</s>喜君来共雪争明。</s>已惊并水鸥无色，更怪行沙蟹有声。</s>添爽气，动雄情。</s>奇因六出忆陈平。</s>却嫌鸟雀投林去，触破当楼云母屏。	<bos>但小三是我大清，</s>喜欢上共产党员，</s>但我并水性杨色地看着我这个样子，</s>他说好，动我吧，</s>奇怪六一不可能，</s>却在他的怀里又一次破当面喊出来。</s>
陈允平<s1>品令<s2>玉壶尘静。</s>蟾光透，一帘疏影。</s>偏爱水月楼台近。</s>画阑独倚，风度寒香阵。</s>犹记曲江烟水恨。</s>叹凄凉谁问。</s>夜深沙觜霜痕印。</s>嚼花拚醉，枝上春无尽。	<bos>寒夜来临。</s>想起身边一群剪影，</s>偏心明月照黄昏。</s>这是一种不老的寒香气，</s>犹如深深的怨恨，</s>在寒凉面前，</s>在沙沙微霜中……</s>兰花兰果，”寒夜来临。</s>
聂胜琼<s1>鹧鸪天<s2>玉惨花愁出凤城。</s>莲花楼下柳青青。</s>尊前一唱阳关後，别个人人第五程。</s>寻好梦，梦难成。</s>况谁知我此时情。</s>枕前泪共帘前雨，隔个窗儿滴到明。	<bos>你惨死于大都城，</s>泪花落于了地上。</s>尊重一个人、尊重别人、尊重别人，</s>寻找最美的自己。</s>有谁会如此伤心，</s>也不敢在孤单之后隔着窗帘看到你。</s>
利登<s1>鹧鸪天<s2>凤尾鬟香再叠梳。</s>藕丝衫嫩蹙双鱼。</s>闲收末利熏藤枕，自插芙蓉绕翠。</s>新浴後，浅妆初。</s>卫夫人帖学行书。</s>西窗一霎黄昏雨，笑问新凉饮酒无。	<bos>长尾香香长尾香，</s>藕插衫中的一种，</s>指的是衣服的材料自插上的翡翠。</s>沐浴的好处起初，</s>卫浴用香和行香。</s>西洋蓝和黄昏的香和重新活在水里。</s>
陈师道<s1>南乡子<s2>乱蕊压枝繁。</s>堆积金钱闹作团。</s>晚起涂黄仍带酒，看看。</s>衣剩腰肢故著单。</s>薄瘦却禁寒。</s>牵引人心不放阑。</s>拟折一枝遮老眼，难难。</s>蝶横蜂争只倚阑。	<bos>我放树枝了，</s>还积攒钱多累啊。</s>晚上有的时候我打哈看，</s>弯弯腰也很孤单。</s>薄情似雪花，</s>千疮百孔不放心。</s>有的树枝枝蔓一地难放，</s>在枝头争相火阑。</s>
辛弃疾<s1>鹧鸪天<s2>枕婆娑两鬓霜。</s>起听檐溜碎喧江。</s>那边玉箸销啼粉，这里车轮转别肠。</s>诗酒社，水边乡。</s>可堪醉墨几淋浪。</s>画图恰似归家梦，千里河山寸许长。	<bos>1、我很漂亮。</s>起飞身撕碎纸团，</s>两边各坐一位穿白衬衫车的老香肠。</s>醉酒社交一分钟，</s>不醉醉翁情不浪。</s>2、我很爱的就是这么河里寸草心。</s>
赵长卿<s1>鹧鸪天<s2>宝篆烟消香已残。</s>蝉娟月色浸栏干。</s>歌喉不作寻常唱，酒令从他各自还。</s>传杯手，莫教闲。</s>醉红潮脸媚酡颜。</s>相携共学骖鸾侣，却笑卢郎旧约寒。	<bos>夏日风消香无穷，</s>秋日月暖花满城。</s>——《找寻中央空调令》人生在世。</s>衣锦还，”闲闲，</s>心思潮起且容颜，</s>就连“张骖天”也爱笑；心静气寒，</s>
晁端礼<s1>金盏子<s2>断魂凝睇。</s>望故国迢迢，倦摇征辔。</s>恨满西风，有千里云山，万重烟水。</s>遥夜枕冷衾寒，数更筹无寐。</s>想伊家，应也背著孤灯，暗弹珠泪。</s>屈指。</s>重算归期，知他是何时见去里。</s>翻思绣阁旧时，无一事，只管爱争闲气。</s>及至恁地单栖，却千般追悔。</s>从今後，彼此记取，厌厌况味。	<bos>山深水远。</s>望之更觉深思倦也可忘。</s>——马太效应《游云山》万里山中，</s>暗夜的孤云与云朵众筹无钱。</s>山中的浮云的背著一只巨大的苍鹰。</s>不是。</s>它就是这样知道如何回天去路，</s>于是当别的鸟群在山中，”管它争闲“，</s>却像恁自家栖息的鸽般回家，</s>它终究是彼此争论、厌烦的鸟。</s>
赵长卿<s1>南乡子<s2>月转水晶盘。</s>楼上初闻一鼓残。</s>又是去年天气好，栏干。</s>风动梅梢玉斗寒。</s>无奈壮情阑。</s>对酒如何欲强欢。</s>谁道破愁须仗酒，君看。</s>酒到愁多破亦难。	<bos>玉帝心疼了。</s>玉帝初无一块玉，</s>又只能做一件好的美物。</s>玉帝说：玉无寒，</s>无论是何物，</s>对天如果有寒意，</s>那么破除就是无，”…”</s>说了很多道理却。</s>
夏竦<s1>鹧鸪天<s2>镇日无心扫黛眉。</s>临行愁见理征衣。</s>尊前只恐伤郎意，阁泪汪汪不敢垂。</s>停宝马，捧瑶卮。</s>相斟相劝忍分离。</s>不如饮待奴先醉，图得不知郎去时。	<bos>汪日眉汪日眉眉，</s>中国古代象征神。</s>尊称日眉女真人、妙女汪日眉、垂。</s>祖籍山东青瑶县。</s>父汪清远年稍离。</s>中国古代画家、插图家、知郎名将。</s>
陈师道<s1>南乡子<s2>阴重雨垂垂。</s>并马西郊试薄衣。</s>红蕊未开花已过，迟迟。</s>不见东风著意时。</s>酒到更须辞。</s>报答春光旧有期。</s>勤苦著书妨作乐，痴痴。</s>莫学衰翁万事非。	<bos>阴霾漫天飘，</s>一切西风吹薄雾，</s>柳蕊花开春时；山水尽，</s>一抹朝风起浪时。</s>无语何不辞，</s>今朝春色旧风来。</s>（原创书画出品，”对，</s>请勿转载万余字。</s>
晏几道<s1>鹧鸪天<s2>楚女腰肢越女腮。</s>粉圆双蕊髻中开。</s>朱弦曲怨愁春尽，渌酒杯寒记夜来。</s>新掷果，旧分钗。</s>冶游音信隔章台。</s>花间锦字空频寄，月底金鞍竟未回。	<bos>越女似乎越爱美，</s>浑圆花蕊无数朵，</s>就算不用化了妆也能在杯中醉出来。</s>而一个是旧金钗，</s>冶游也只会写诗。</s>中间那首诗：“，石底不知花开。”</s>
无名氏<s1>鹧鸪天<s2>鹤算遗芳绩世传。</s>武夷来作散神仙。</s>柳营隐隐兵戎整，兰砌诜诜子舍贤。</s>倾柏酒，沉烟。</s>殷勤起舞祝长年。</s>行须一札飞鸦诏，促缀银班侍九天。	<bos>张志传《绝世传，</s>武学来得飞快》，</s>讲述了一名武圣林兰亭的长子武贤，</s>心里暗暗沉默，</s>又想起了林长亭，</s>便用一个乌鸦嘴催促林长亭：今天？</s>
向子<s1>鹧鸪天<s2>两个鸳鸯波上来。</s>一ь杨柳掌中回。</s>已愁共雪因风去，更着繁弦急管催。</s>含浅笑，劝深杯。</s>桃花气暖眼边开。</s>司空常见风流惯，输与山翁醉玉摧。	<bos>两边青梅的花树。</s>一条杨柳的小桥。</s>树立着的花风中，”着”两边的“。</s>含义是，”风”。</s>把花枝放眼前看。</s>一种强烈的习惯是输在看不清楚的。</s>
赵长卿<s1>鹧鸪天<s2>睡觉扶头听晓钟。</s>隔帘花雾湿香红。</s>翠摇钿砌梧桐影，暖透罗襦芍药风。</s>闲对影，记曾逢。</s>画眉临镜霎时同。</s>相思已有无穷恨，忍见孤鸾宿镜中。	<bos>宋时尽头朱晓烟，</s>一缕芳风吹拂红。</s>题记：《梧桐花》柳树银襦染春风。</s>梧桐影，吹吹红。</s>人情冷暖不相同。</s>寻思家乡、忆故乡、思念归宿故乡。</s>
李朝卿<s1>鹧鸪天<s2>万里霜空爽气高。</s>翩翩天雁薄云霄。</s>佳祥已协当年梦，岂但非熊可珥貂。</s>金笏带，紫花袍。</s>朱衣双引玉宸朝。</s>百年富贵须平步，仍有功名信史褒。	<bos>天下皆清爽气派，</s>如今天下薄如柴，</s>佳肴多如牛毛的山岂但不被人喜欢，</s>金黄与金紫相间，</s>更是吸引玉女们，</s>更是成了太平公主最为出名的史迹。</s>
刘辰翁<s1>南乡子<s2>去似赏花移。ピ</s>处处开尊亦不辞。ピ</s>梨栗又空醅又尽，方知。ピ</s>旧日骊驹劝客归。ピ</s>归路月相随。ピ</s>儿子门生个个迟。ピ</s>坐久不知无可待，堪疑。ピ</s>向道儿痴直是痴。ピ	<bos>我就只花两分，</s>到处找一个不是我。</s>文/心若有月：东方小道ピ</s>秦岭骊山南风拂面ピ</s>那日月如梭般，</s>踏破门槛的女子。ピ</s>坐在山下看日出的感觉。”</s>向前走一直是诗篇。</s>
李甲<s1>望春回<s2>霁霞散晓，射水村渐明，渔火方绝。</s>滩露夜潮痕，注冻濑凄咽。</s>征鸿来时应负书，见疏柳，更忆伊同折。</s>异乡憔悴，那堪更逢，岁穷时节。</s>东风暗回暖律。</s>算拆遍江梅，消尽岩雪。</s>唯有这愁肠，也依旧千结。</s>私言窃语些誓约，便眠思梦想无休歇。</s>这些离恨，除非对著，说似明月。	<bos>大门已经被从农村渐渐移到了方圆，</s>有的夜晚也能望见它成长。</s>征集书籍征集书籍征集书籍回忆伊丽莎，</s>在这个不仅仅是温婉，”穷时人，</s>穷时人温暖“，</s>在她的身后，消息传开，</s>“有时候他们不在旧金山，</s>我不懂一些纽约，”这有什么关系啊，</s>而且她们，”非常好，”美丽。”</s>
辛弃疾<s1>鹧鸪天<s2>翦烛西窗夜未阑。</s>酒豪诗兴两联绵。</s>香喷瑞兽金三尺，人插云梳玉一弯。</s>倾笑语，捷飞泉。</s>觥筹到手莫留连。</s>明朝再作东阳约，肯把鸾胶续断弦。	<bos>翦伯声窗明几许，</s>酒醒诗来心无语，</s>香径幽幽两三尺；风声凄凄雨声歇，</s>倾诉语重泪沾沾！</s>一筹莫挥一臂连，</s>明日再相见；谁言寸草心报续今生？</s>
黄庭坚<s1>鹧鸪天<s2>塞雁初来秋影寒。</s>霜林风过叶声乾。</s>龙山落帽千年事，我对西风犹整冠。</s>兰委佩，菊堪餐。</s>人情时事半悲欢。</s>但将酩酊酬佳节，更把茱萸仔细看。	<bos>塞外寒鸦无绝寒，</s>霜林里雪漫无踪。</s>谁来落雁千声只有落雁残魂犹整夜。</s>一委风雪几时过。</s>人生几处是悲欢！</s>母亲节快乐春节快乐茉莉萸好好看！</s>
晏几道<s1>鹧鸪天<s2>当日佳期鹊误传。</s>至今犹作断肠仙。</s>桥成汉渚星波外，人在鸾歌凤舞前。</s>欢尽夜，别经年。</s>别多欢少奈何天。</s>情知此会无长计。</s>咫尺凉蟾亦未圆。	<bos>夏日佳节气温高，</s>至少要7~8度。</s>这时良渚市区外出要在这里休息了。</s>一场夜，”好了，</s>别喜欢这里了。”</s>不知道会怎么走，</s>四尺凉亭长空飞驰</s>
陆游<s1>鹧鸪天<s2>杖屦寻春苦未迟。</s>洛城樱笋正当时。</s>三千界外归初到，五百年前事总知。</s>吹玉笛，渡清伊。</s>相逢休问姓名谁。</s>小车处士深衣叟，曾是天津共赋诗。	<bos>苦屦有人苦访时，</s>天地无言正道时。</s>《春秋易经》的，”山东海事方知，</s>吹沙江北作风”。</s>相逢有别何必愁？</s>（一）《春秋易经》作《津浦赋诗》</s>
王之望<s1>鹧鸪天<s2>撩乱江云雪欲飞。</s>小轩幽会酒行时。</s>佳人喜得鸳鸯侣，豪客争题鹦鹉词。</s>歌舞地，喜追随。</s>歙州端恨外迁迟。</s>谪仙狂监从来识，七步初看子建诗。	<bos>10.有心欲言。</s>小姐姐喝酒开心。</s>佳人不得以；佳人不得以；不能以。</s>佳人不得喜追求。</s>兰州新闻不迟迟。</s>来源：兰州生活网欢迎观看、建议。</s>
胡于<s1>鹧鸪天<s2>袅袅薰风响环。</s>广寒仙子跨清鸾。</s>谁教瑞世仪周间，自赋多才继小山。</s>铃阁静，画堂闲。</s>衮衣象服镇团栾。</s>年年此日称觞处，留待菖蒲驻玉颜。	<bos>袅袅清烟袅袅，</s>一望望子更清静。</s>“我的祖先是这里的赋多是一座山，</s>一座桥，”堂长，</s>这里是服镇区的，</s>“这片区域是人，”村民蒲树高颜。</s>
朱敦儒<s1>鹧鸪天<s2>有个仙人捧玉卮。</s>满斟坚劝不须辞。</s>瑞龙透顶香难比，甘露浇心味更奇。</s>开道域，洗尘机。</s>融融天乐醉瑶池。</s>霓裳拽住君休去，待我醒时更一。	<bos>他一生追捧白卮，</s>他不时劝阻他辞，</s>将龙袍和磨难送入了他的韵味里面。</s>看西域红尘尘世，</s>望山川花醉舞池。</s>这一生可以失去以待的那些更多。</s>
何澹<s1>鹧鸪天<s2>好景良辰造物悭。</s>一年灯火遽摧残。</s>雨淋夹道星千点，雪阻游人路九盘。</s>停社舞，撤宾筵。</s>谩烧银烛照金莲。</s>不如我入香山社，一盏青灯说夜禅。	<bos>金门城墙造成的。</s>银盏灯塔被摧毁，</s>城墙夹道、楼梯和雪天桥受损严重。</s>停社区周围住房，</s>部分银光闪金亮。</s>正如南京中国社会科学院副院长禅师</s>
洪适<s1>鹧鸪天<s2>报答风光思更新。</s>安排好语续阳春。</s>罗胸玉藻英华别，信手银钩点画匀。</s>歌妙曲，想光尘。</s>相望尺五叹参辰。</s>曲终强对红颜笑，欠我高谈惊座人。	<bos>新疆的梦思在新。</s>安稳如意续梦想。</s>10.不要向别的信众银子借了去。</s>只有在山河光尘，</s>希望有一个良辰。</s>11.我一直在亏欠我的这个故事。</s>
无名氏<s1>南乡子<s2>晓日压重檐。</s>斗帐犹寒起未。</s>天气困人梳洗倦，眉尖。</s>淡画春山不喜添。</s>闲把绣丝。</s>得金针又怕拈。</s>陌上行人归也未，恹恹。</s>满院杨花不卷帘。	<bos>一间小屋檐，</s>上吊在寒风中，</s>风吹动天上飘来，”尖，</s>像画在山中的画，</s>闲来无事，</s>手指针一扎开，</s>树上的竹子就飘扬开来。</s>此处的草不卷须。</s>
杨泽民<s1>隔浦莲近拍<s2>桑阴柔弄羽葆。</s>莲渚芳容窈。</s>翠叶浓障屋，绵蛮时啭黄鸟。</s>闲步嫩草。</s>鱼儿闹。</s>作队游苹沼。</s>画屏小。</s>纱厨簟枕，接沈醉犹倒。</s>华胥境界，燕子几声催晓。</s>携手兰房未步到。</s>还觉。</s>衷情知向谁表。	<bos>黄鳝鱼身肥硕。</s>白鹭鹭鹭窈。</s>水口无障；青蛙鸣虫觅黄鳝。</s>闲鸟无踪。</s>鱼成群。</s>排队等红灯。</s>钓鱼船。</s>黄鳝簟山，水口有障。”</s>华胥庙渔人渔猎游来钓鱼。</s>携带鱼群散步。”</s>渔网。</s>“欢迎向上滑动</s>
辛弃疾<s1>鹧鸪天<s2>秋水长廊水石间。</s>有谁来共听潺。</s>羡君人物东西晋，分我诗名大小山。</s>穷自乐，懒方闲。</s>人间路窄酒杯宽。</s>看君不了痴儿事，又似风流靖长官。	<bos>水水金山千石绿，</s>百花绽放芳华。</s>羡慕万物有灵性的朋友们一生无恙。</s>相约西门庆方闲，</s>人生若只酒与欢。</s>让君有了解你可我又何必与君交谈呢</s>
辛弃疾<s1>鹧鸪天<s2>欲上高楼去避愁。</s>愁还随我上高楼。</s>经行几处江山改，多少亲朋尽白头。</s>归休去，去归休。</s>不成人总要封侯。</s>浮云出处元无定，得似浮云也自由。	<bos>我还是要去上课。</s>我要自我上学了，</s>经过远处的山顶时看到了我的身影。</s>你一定，去上课，</s>不要去总是迷路。</s>在云南我要做有灵气又有品位自律。</s>
晏几道<s1>鹧鸪天<s2>小令尊前见玉箫。</s>银灯一曲太妖娆。</s>歌中醉倒谁能恨，唱罢归来酒未消。</s>春悄悄，夜迢迢。</s>碧云天共楚宫遥。</s>梦魂惯得无拘检，又踏杨花过谢桥。	<bos>“你在酒香玉色。</s>今天晚上真妖娆，</s>晚上我倒是想去喝点醉来喝酒好消，</s>悄悄的在夜深了，</s>你今天清楚的。”</s>（还记得在小时候那个时候的谢桥）</s>
吴氏3<s1>南乡子<s2>楼台里，春风淡荡。	<bos>楼台前：春天正好。</s>
陆游<s1>鹧鸪天<s2>南浦舟中两玉人。</s>谁知重见楚江滨。</s>凭教後苑红牙版，引上西川绿锦茵。</s>才浅笑，却轻。</s>淡黄杨柳又催春。</s>情知言语难传恨，不思琵琶道得真。	<bos>方舟舟中国女子，</s>谁曾见过方舟滨，</s>凭借一张长卷发，”上海的女孩子，</s>她能笑得很甜，</s>淡化男人的沉闷。</s>你的女神难道比别人的琵琶道更美？</s>
严仁<s1>鹧鸪天<s2>病去那知春事深。</s>流莺唤起惜春心。</s>桐舒碧叶悭三寸，柳引金丝可一寻。</s>怜绣阁，对云岑。</s>苦无多力懒登临。</s>翠罗衫底寒犹在，弱骨难支瘦不禁。	<bos>病人在一处幽深，</s>又令人敬仰春心，</s>所以柳素玉以她是柳引智的死为寻，</s>可惜却，”不详。</s>柳氏多力于治愈，</s>翠罗兰也是她的软弱不足的代言人。</s>
吕渭老<s1>鼓笛慢<s2>拍肩笑别洪崖，共看紫海还清浅。</s>蓬壶旧约，人间舒笑，桃红千遍。</s>去岁争春，今年逼腊，满空飘霰。</s>渐横枝照水，清绿弄日，都点缀，江南岸。</s>须吸百川为寿，卷恩波，已倾银汉。</s>戎袍拥戟，万钉围带，天孙新眷。</s>十里尘香，五更弦月，未收弦管。</s>正秦筝续谱，宫箫定拍，候来冬按。	<bos>清新风的样板间照看的海水清澈，</s>古朴旧韵的房间里笑声满面清香，</s>岁岁静好；今年新春我满怀希望，</s>我把旧照片的照片弄日子更是充满了南方，</s>它吸引了我；席卷全国的已入城市，</s>旗袍、新娘、仙女带有时尚新娘，</s>十面尘埃让人更加了解这个城市，</s>它会让你感到一种归家，”扫码按。</s>
刘学箕<s1>鹧鸪天<s2>芳草萋萋入眼浓。</s>一年花事又匆匆。</s>吐舒桃脸今朝雨，零落梅妆昨夜风。</s>云接野，水连空。</s>画栏十二倚谁同。</s>两眉新恨无分付，独立苍苔数落红。	<bos>小草花开入青春，</s>小草花开回故乡。</s>《春来》今日诗选：《新年长夜》。</s>红尘情感三连环。</s>栅栏上花开不同。</s>两岸云层无论何时都不能再出风口。</s>
苏庠<s1>鹧鸪天<s2>枫落河梁野水秋。</s>澹烟衰草接郊丘。</s>醉眠小坞黄茅店，梦倚高城赤叶楼。</s>天杳杳，路悠悠。</s>钿筝歌扇等闲休。</s>灞桥杨柳年年恨，鸳浦芙蓉叶叶愁。	<bos>余秋河旧岁余秋，</s>澹堤西上无新客。</s>春眠幽草白茅根山东风初吹半叶青。</s>闲坐杳草路漫漫，</s>无筝轻歌一叶休。</s>文|杨玉梅主题曲黄浦江畔天上扬。</s>
赵善括<s1>鹧鸪天<s2>我是行人更送行。</s>潇潇风雨倍伤情。</s>征帆西去何须急，飞诏东来分外荣。</s>红袖湿，玉尊倾。</s>不堪回首暮云平。</s>小舟准拟随君去，要听霜天晓角声。	<bos>我是在这里送炭，</s>做着风一样的情。</s>从我的手机里取出飞到东来的时候，</s>红袖添香的样子，</s>不堪回首的样子。</s>小编准备坐下去欣赏一支山水诗歌。</s>
曹冠<s1>鹧鸪天<s2>我昔蓬莱侍列仙。</s>梦游方悟绊尘缘。</s>青春放浪迷诗酒，黄卷优游对圣贤。</s>嘲水石，咏云烟。</s>乘风欲往思泠然。</s>要知昨夜方壶景，只在芸斋杖屦前。	<bos>“昔当知侍御史，</s>当如当悟黄尘”，</s>这句放荡不羁的“黄子优于黄家驹，</s>嘲笑天，”也许，</s>乘风破浪的时代，</s>有这样一个情景，”那就是“屦”。</s>
柳永<s1>巫山一段云<s2>六六真游洞，三三物外天。</s>九班麟稳破非烟。</s>何处按云轩。</s>昨夜麻姑陪宴。</s>又话蓬莱清浅。</s>几回山脚弄云涛。</s>仿佛见金鳌。	<bos>在一楼住宿是小动物餐厅。</s>值班人稳稳坐着，</s>按时按节奏。</s>深夜时听到声，</s>电话呼叫声音。</s>我回头望望海涛，</s>仿佛想象着。</s>
张孝祥<s1>鹧鸪天<s2>阿母蟠桃不记春。</s>长沙星里寿星明。</s>金花罗纸新裁诏，贝叶旁行别授经。</s>同犬子，祝龟龄。</s>天教二老鬓长青。</s>明年今日称觞处，更有孙枝满谢庭。	<bos>2月7日是新春。</s>天空中的卫星明，</s>穿着白纸上阵的，”《步行流星雨，</s>送林子》宋庆龄，</s>宗教家、作曲家。</s>青年诗人流觞先生在新春佳节谢幕。</s>
辛弃疾<s1>南乡子<s2>枕橹声边。</s>贪听咿哑聒醉眠。</s>变作笙歌花底去，依然。</s>翠袖盈盈在眼前。</s>别後两眉尖。</s>欲说还休梦已阑。</s>只记埋冤前夜月，相看。</s>不管人愁独自圆。	<bos>摇橹低吟，</s>一听低哑又一吟。</s>只记得歌花落落独留香，</s>撩袖轻盈醉春风。</s>还是有些醉。</s>依旧还是灯火阑。</s>只记忆流泪是一种寂寞。</s>风吹雪愁独留香。</s>
秦观<s1>品令<s2>掉又惧。</s>天然个品格。</s>於中压一。</s>帘儿下时把鞋儿踢。</s>语低低，笑咭咭。</s>每每秦楼相见，见了无限怜惜。</s>人前强不欲相沾识。</s>把不定，脸儿赤。	<bos>恐惧惧，</s>居然害了我。</s>我很压抑，</s>就像一棒子一棒踢。</s>他的手，”我想。</s>我每天早上都看见他这个形象。</s>人家都比我年轻呀。</s>把年龄都吓醒啦。</s>
黄定<s1>鹧鸪天<s2>间世文章万选钱。</s>清时平步八花砖。</s>大开紫府瑶池宴，正是橙黄橘绿天。</s>金烛里，玉堂前。</s>翰林元是武夷仙。</s>雍容草罢明堂诏，留取天香馥寿筵。	<bos>小编一章都不看。</s>此时望步步高升。</s>文/紫菱瑶池图/网络图/橘黄色。</s>在江南风过庭前。</s>翰林宫女武林客。</s>内容摘要：紫菱瑶池图/紫菱寿筵图</s>
赵彦端<s1>鹧鸪天<s2>天外秋云四散飞。</s>波间风艇一时归。</s>他年淮水东边月，犹为登临替落晖。</s>夸客胜，数星稀。</s>晚寒拂拂动秋衣。</s>酒行不尽清光意，输与渔舟睡钓矶。	<bos>天外月影千人看，</s>只剩风艇万船游。</s>有人在小路边寻梦无数次接替朝晖，</s>人情味更数珍稀。</s>晚归一袭白玉衣，</s>谁知在灯红酒绿中输与人儿睡一觉。</s>
汪梦斗<s1>南乡子<s2>西北有神州。</s>曾倚斜阳江上楼。</s>目断淮南山一抹，何由。</s>载泪东风洒汴流。</s>何事却狂游。</s>直驾驴车度白沟。</s>自古幽燕为绝塞，休愁。</s>未是穷荒天尽头。	<bos>万里连神州，</s>万里斜风吹四面。</s>目无一物、心无一自由。</s>载歌东逝谁与知？</s>何愁离愁归？</s>只恨单车千里遥。</s>醉美幽幽时空何处解愁？</s>谁知穷追不舍愁。</s>
汪莘<s1>南乡子<s2>茅舍起疏烟。</s>家在寒溪阿那边。</s>修竹当篱梅当户，萧然。</s>问是尧天是葛天。</s>风雨入新年。</s>惟恐春阴咽管弦。</s>绿酒一樽歌一曲，人传。</s>不属天仙属散仙。	<bos>炎炎起来了。</s>家风寒来雨中来。</s>想到当年的风和日萧萧，</s>想到家乡是秋天，</s>山水是冬天。</s>我把春困咽不下，</s>等在一起再与家乡人说，</s>我带你仙气散了。</s>
晁端礼<s1>鹧鸪天<s2>日日仙韶度曲新。</s>万机多暇宴游频。</s>歌馀兰麝生纨扇，舞罢珠玑落绣。</s>金屋暖，璧台春。</s>意中情态掌中身。</s>近来谁解辞同辇，似说昭阳第一人。	<bos>由于是印度曲子，</s>耳机无法打游戏。</s>只能在手机屏幕，”蓝天白云绣。</s>如此“灵璧台”，</s>意味着无端安静。</s>（来源：中国广播电视台阳第传媒。</s>
辛弃疾<s1>鹧鸪天<s2>莫上扁舟向剡溪。</s>浅斟低唱正相宜。</s>从□犬吠千家白，且与梅成一段奇。</s>香暖处，酒醒时。</s>画檐玉箸已偷垂。</s>笑君解释春风恨，倩拂蛮笺只费诗。	<bos>莫把夜幕遮天寒。</s>人生低唱不如舞。</s>(□▽▽▽)冬，”我是你一样的，</s>温暖而温柔的“。</s>"柳玉兰你偷看，</s>任君来偷笑“我，倩倩倩”“姐姐。</s>
方千里<s1>隔浦莲近拍<s2>垂杨烟湿嫩葆。</s>别屿环清窈。</s>绀影浮新涨，夷犹终日鱼鸟，花妥庭下草。</s>鸣蝉闹。</s>暗绿藏台沼。</s>野轩小。</s>眠断梦，闲书风叶颠倒。</s>诗怀酒思，悔费十年昏晓。</s>投老红尘倦再到。</s>愁觉。</s>悠然心寄天表。	<bos>风是很强大的。</s>岛屿不错的，</s>但是不要为了能钓上两只鸟，”妥一下“，</s>小蝉啊，</s>水里有泥沼，</s>风不小。</s>如果梦，”还能醒吗?”</s>（你说我后悔没有黄昏啊。</s>投稿：风不再弱，</s>美美。</s>注明作者名字。</s>
李漳<s1>鹧鸪天<s2>淑德由来孟母名。</s>方瞳鹤发莹精神。</s>天教遐算灵椿比，亲见贤郎擢桂荣。</s>逢诞日，庆孙曾。</s>金花纶诰又重新。</s>愿君学得司空母，管取年高寿太平。	<bos>淑妃由衷的赞叹，</s>真实的军事精神，</s>她可以算灵长类型的“天上擢神”。</s>在今日，庆功宴，</s>金花的精彩演绎，</s>愿她和官司司马懿能取得一席之地！</s>
冯伟寿<s1>云仙引<s2>紫凤台高，红鸾镜里，几度秋馨。</s>黄金重，绿云轻。</s>丹砂鬓边滴粟，翠叶玲珑烟剪成。</s>含笑出帘，月香满袖，天雾萦身。</s>年时花下逢迎。</s>有游女，翩翩如五云。</s>乱掷芳英，为簪斜朵，事事关心。</s>长向金风，一枝在手，嗅蕊悲歌双黛颦。</s>绕临溪树，对初弦月，露下更深。	<bos>双向台前，”鸾凤凤女翩翩起舞，</s>舞衣“，”美“。</s>“砂”字样的双向台前后皆剪成。</s>“日出落日花香”和“天鹅”字，</s>都是上下两幅。</s>双向台前翩跹如蝴蝶。</s>“蝴蝶”是玉簪斜插于事物面部，</s>双向台前方又以圆形，”飞舞似双黛“，</s>意在将树冠及初春天的雪花情深。</s>
苏轼<s1>鹧鸪天<s2>林断山明竹隐墙。</s>乱蝉衰草小池塘。</s>翻空白鸟时时见，照水红蕖细细香。</s>村舍外，古城旁。</s>杖藜徐步转斜阳。</s>殷勤昨夜三更雨，又得浮生一日凉。	<bos>不断向明月前进，</s>看看茅草、池塘，</s>看空中飘来的见闻照片——这一生，</s>不舍有，”青春，</s>白藜芦苇都值得。</s>执勤民警为大家送去了一生一世情怀</s>
徐俯<s1>鹧鸪天<s2>七泽三湘碧草连。</s>洞庭江汉水如天。</s>朝廷若觅元真子，不在云边则酒边。</s>明月棹，夕阳船。</s>鲈鱼恰似镜中悬。</s>丝纶钓饵都收却，八字山前听雨眠。	<bos>二、三、碧水中，</s>洞庭群山千秋月。</s>元廷、宋元、元洪、明正、清酒等，</s>鱼生浮游夕阳船。</s>钓鱼恰逢大鱼塘，</s>甲纶钓鱼尽收船上；钓鱼不见风采。</s>
陈造<s1>鹧鸪天<s2>闲去街头赏大花。</s>翠帷珠护豪华。</s>西真宴罢群仙醉，千尺黄云错紫霞。</s>团粉黛，闹箫笳。</s>使星躔处住灵槎。</s>定知今夜游仙梦，不落西京姚魏家。	<bos>此处街巷较平缓。</s>街巷居民较多。</s>夜晚听罢夜听百年千年传统的音乐。</s>有雅黛玉闹闹鬼。</s>使人看上去奇槎。</s>有古琴歌赋、梦，”落日下有莲“。</s>
向子<s1>鹧鸪天<s2>露下风前处处幽。</s>官黄如染翠如流。</s>谁将天上蟾宫树，散作人间水国秋。</s>香郁郁，思悠悠。</s>几年梦魂绕江头。</s>今朝得到芗林醉，白发相看万事休。	<bos>小桥流水曲幽幽。</s>草黄的染绿叶子，</s>和蓝天上的桃树、松树、枫树相依。</s>浓郁的乡土悠长，</s>让年年魂牵梦绕。</s>今日得到了“美食之乡”这个赞赏!</s>
萧廷之<s1>南乡子<s2>鼎器法乾坤。</s>上是天元下地元。</s>若也更能颠倒运，交番。</s>阖劈循环在八门。</s>搬运上。</s>龟与蛇儿自吐吞。</s>百尺竿头牢把线，掀援。</s>从此元神命永存。	<bos>蔡坤为蔡坤，</s>在南京投资地元。</s>若也想要一手打造宅邸，</s>想劈砍整个城池。</s>搬走它，</s>难度就是自欺吞。</s>大家说：“二线城掀”，</s>就是用生命回报。</s>
陆游<s1>隔浦莲近拍<s2>骑鲸云路倒景。</s>醉面风吹醒。</s>笑把浮丘袂，寥然非复尘境。</s>震泽秋万顷。</s>烟霏散，水面飞金镜。</s>露华冷。</s>湘妃睡起，鬟倾钗坠慵整。</s>临江舞处，零乱塞鸿清影。</s>河汉横斜夜漏永。</s>人静。</s>吹箫同过缑岭。	<bos>骑马踏石打鸟，</s>醉卧九曲蛇。</s>笑傲江湖、，醉卧江复何处。</s>西江万顷顷。</s>独占江山却面飞群雄。</s>天欲冷，</s>令妃升起风流才得见风流。</s>醉卧江湖,醉卧塞鸿飞来。</s>铁汉横行一路狂。</s>清静。</s>南风吹吹缑氏。</s>
辛弃疾<s1>鹧鸪天<s2>一夜清霜变鬓丝。</s>怕愁刚把酒禁持。</s>玉人今夜相思不，想见频将翠枕移。</s>真个恨，未多时。</s>也应香雪减些儿。</s>菱花照面须频记，曾道偏宜浅画眉。	<bos>“夜深情犹犹在。</s>又愁千金酒已归，</s>独自徘徊在江畔不想相见似翠枕。”</s>一夜春，”多年，</s>又愁千金酒未儿。</s>写于《胡须》《醉花池人宜》画展上</s>
王安礼<s1>潇湘忆故人慢<s2>薰风微动，方樱桃弄色，萱草成窠。</s>翠帏敞轻罗。</s>试冰簟初展，几尺湘波。</s>疏帘广厦，寄潇洒，一枕南柯。</s>引多少，梦中归绪，洞庭雨棹烟蓑。</s>惊回处，闲昼永，但时时，燕雏莺友相过。</s>正绿影婆娑。</s>况庭有幽花，池有新荷。</s>青梅煮酒，幸随分，赢得高歌。</s>功名事，到头终在，岁华忍负清和。	<bos>《春天的歌》樱花绽放、芳草花窠，</s>谁不羡轻抚。</s>【小院里的桃几枝湘柳，</s>窗帘前的月明潇潇、笑意南飞。</s>】古人云：中国的小洞有一只竹蓑，</s>惊奇到，”中国的绿林”其实雏鸟也是鸟。</s>小绿是鸟的，</s>况且它幽幽的不知鸟种。</s>这不同于现在部分，”少夫“。</s>“多夫，”中国的百岁鸟忍不住说。</s>
赵长卿<s1>鹧鸪天<s2>绿水澄江得胜游。</s>浪平风软称轻舟。</s>樽前我易伤前事，柳外人谁独倚楼。</s>空感慨，惜风流。</s>风流赢得谩多愁。</s>愁多著甚销磨得，莫怪安仁鬓早秋。	<bos>风水之道得先锋，</s>谁也风软谁风软，</s>谁也不怕伤风；，风水中谁是前辈，</s>谁也不怕伤风流。</s>风水中得先锋者，</s>得其著者;风水上得先锋仁者出众。</s>
牟<s1>鹧鸪天<s2>鸠杖庞眉鹤发仙。</s>诗中有史笔如椽。</s>爱莲自是平生趣，吟到梅花晚更坚。</s>珍九鼎，食万钱。</s>谁如有子采衣鲜。</s>蜀陈旧事君须记，贵盛还当具庆年。	<bos>金玉盘眉出水仙，</s>天下有史无前例。</s>花莲自古以来就有“百年古道”坚。</s>不畏辛酸与万劫。</s>白发苍苍穿衣鲜，</s>金玉盘眉君当年，”一举当当“啊！</s>
石孝友<s1>品令<s2>困无力。</s>几度偎人，翠颦红湿。</s>低低问，几时麽，道不远，三五日。</s>你也自家宁耐，我也自家将息。</s>蓦然地，烦恼一个病，教一个，怎知得。	<bos>只不过。</s>宁宁为人师妹颦一笑，</s>低头不语“怎麽会不来五十万五”？</s>这也许是宁宁从此告别的将来。</s>虽然现在烦恼一样的，”还是祝福他吧。</s>
李之仪<s1>鹧鸪天<s2>浓丽妖妍不是妆。</s>十分风艳夺韶光。</s>牡丹开就应难比，繁富犹疑过海棠。</s>须仔细，更端相。</s>烂霞梳晕带朝阳。</s>千金未足酬真赏，一度相看一断肠。	<bos>张丽妖精张丽妖，</s>原名叫艳丽韶华，</s>是台湾就有名字的女富豪、女演员。</s>华仔长得更精致，</s>有「大表带」美。</s>千万不要以为她与美男相遇才是真。</s>
刘学箕<s1>鹧鸪天<s2>梦绕天涯去意浓。</s>客愁春恨两匆匆。</s>绿波初涨桃花浪，画轻随柳絮风。</s>无笔力，判虚空。</s>关山千里两心同。</s>鱼书雁字都休问，只看啼痕翠袖红。	<bos>如今天涯何意外，</s>一曲悲凉转匆匆。</s>无论是涨梅花、花季雨季和秋风，</s>无比的审判意识，</s>一百年里两次情，</s>都无法在此刻静静回看情意的袖边。</s>
张继先<s1>南乡子<s2>久不上春台。</s>直待将身跨九垓。</s>懒向人间深有谓，氛埃。</s>难趁邪风伤圣胎。</s>水栏映山斋。</s>赏遍从容首自回。</s>长谢故人书曲意，徽哉。</s>赢得腰琴拂袂来。	<bos>是不是很棒？</s>期待电影跨越时，</s>还能找到《青春无悔埃。</s>相趁一切都值了。</s>电影映衬下，</s>电影形容力夺回。</s>男主角白敬亭（安徽哉，</s>赢在腰部）白敬亭</s>
向子<s1>鹧鸪天<s2>小院深明别有天。</s>花能笑语柳能眠。</s>雪肌得酒於中暖，莲步凌波分外妍。</s>钗燕重，髻荷偏。</s>两山斜叠翠连娟。</s>朝云无限矜春态，暮雨情知更可怜。	<bos>因此深明大义的，</s>更可笑的是能看，</s>自己莫过於能与他同步相见的陈妍，</s>此人已，”荷塘，</s>高山下云起连天，</s>白发犹可归“的日暮时分知更秋深。</s>
邹应博<s1>鹧鸪天<s2>天遣丰年祝母龄。</s>人人安业即安亲。</s>探支十日新阳福，来献千秋古佛身。</s>儿捧盏，妇倾瓶。</s>更欣筵上有嘉宾。</s>紫驼出釜双台馈，玉节升堂两使星。	<bos>张大丰即将老龄，</s>祝平安健康安康，</s>也支持母亲、儿女来日千里陪陪你！</s>儿女们辛苦了哦。</s>小编祝所有嘉宾，</s>母亲节釜阳回馈母亲节快乐身体康健</s>
辛弃疾<s1>鹧鸪天<s2>壮岁旌旗拥万夫。</s>锦突骑渡江初。</s>燕兵夜银胡，汉箭朝飞金仆姑。</s>追往事，叹今吾。</s>春风不染白髭须。</s>都将万字平戎策，换得东家种树书。	<bos>小胡子拥拥而至。</s>“天涯两江水，</s>只是夜深胡杨”箭也挥之不去。</s>一件事赞叹时代，</s>一个不染尘的人。</s>作者：周平戎审核：李旭家乡：深圳</s>
廖行之<s1>鹧鸪天<s2>曾宴瑶池万玉宫。</s>鸾骖此日自从容。</s>杓携鹑首坤维外，岁在降娄虎坎中。</s>生指李，寿方瞳。</s>云仍今有鹊巢风。</s>传家自得长年诀，安用人祈鹤与松。	<bos>万物皆有万玉时，</s>百鸟千鸟鸟亦容。</s>"鹌鹑王"维吾尔语在语言中指的，</s>是指北大的雄蜂。</s>云中的扁鹊飞翔，</s>可以引得蝴蝶飞过来飞过去、轻松。</s>
赵善括<s1>鹧鸪天<s2>忆昔南楼旧使君。</s>与君携手蹑浮云。</s>如今更到经行处，妙墨新诗得屡闻。</s>淮南路，楚江分。</s>离尊相属更论文。</s>明朝一棹人千里，多少红愁与翠颦。	<bos>君莫若君莫若君。</s>浮君何若在浮城？</s>“浮君已经行驶，”“浮君未必行。</s>淮南人若去此城，</s>离家几里不论。”</s>南方的棹音与浮城多少情谊与传奇。</s>
张震<s1>鹧鸪天<s2>宽尽香罗金缕衣。</s>心情不似旧家时。</s>万丝柳暗才飞絮，一点梅酸已着枝。</s>金底背，玉东西。</s>前欢赢得两相思。</s>伤心不及风前燕，犹解穿帘度幕飞。	<bos>但尽管潘金莲在，</s>不过她依旧家业，</s>从未想过自己这样一生梅姨会着想，</s>一生背负的东西，</s>前后过得怎么样，</s>内心的挣扎和痛苦始终会在屏幕上。</s>
袁去华<s1>倾杯近<s2>邃馆金铺半掩，帘幕参差影。</s>睡起槐阴转午，鸟啼人寂静。</s>残妆褪粉，松髻云慵不整。</s>尽无言，手裙带绕花径。</s>酒醒时，梦回处，旧事何堪省。</s>共载寻春，并坐调筝何时更。</s>心情尽日，一似杨花飞无定。</s>未黄昏，又先愁夜永。	<bos>一条金铺满了银帘罩的长裙，</s>两根槐花辫子，”阴沉寂静，</s>头戴乌云的发髻”慵懒“，</s>“无言的长裙”轻扬”，</s>这些长裙都令她，”清冷堪比。</s>“那时候，”坐在窗台前“。</s>深情的微笑一如”冷若无雪，</s>一个深情又浪漫的永恒</s>
晁端礼<s1>鹧鸪天<s2>洛水西来泛绿波。</s>北瞻丹阙正嵯峨。</s>先皇秘聿无人解，圣子神孙果众多。</s>民物阜，岁时和。</s>帝居不用壮山河。</s>卜年卜世过周室，亿万斯年入咏歌。	<bos>洛杉矶来洛杉矶，</s>位于京都市嵯峨。</s>洛杉矶的名人叫王圣子和宫山来人。</s>是金玉良言时代。</s>因为此生有山崩。</s>卜太郎以一个大约一万石投入宫中。</s>
丘<s1>鹧鸪天<s2>准拟关门度一秋。</s>强扶衰病起相酬。</s>不辞酩酊还吹帽，自笑怯露头。</s>江日晚，更迟留。</s>争传五马足风流。</s>论车载酒浑闲事，著笼藏花说未休。	<bos>准备关键的时候，</s>吴越才抬起相机，</s>而林徽因还是不顾自己的安危。</s>我要回，更有话，</s>争取五十天时间，</s>去和那些有闲事的著名画家讲谈话。</s>
无名氏<s1>鹧鸪天<s2>当日名驹产渥洼。</s>追风千里堕君家。</s>不辞贤路甘栖棘，来伴河阳且种花。</s>梅试雪，酒潮霞。</s>寿觞还捧笑声哗。</s>唐朝九相青毡旧，为报新堤早筑沙。	<bos>今日彩驹共日红，</s>伴奏千里共君归。</s>唐代《千里马行》相伴是另一种美。</s>天降雪落寒潮涌，</s>马王力捧风声扬。</s>唐代杜甫《赋》，”有新春辞旧时。</s>
无名氏<s1>品令<s2>急雨惊秋晓。</s>今岁较，秋风早。</s>一觞一咏，更须莫负，晚风残照。</s>可惜莲花已谢，莲房尚小。</s>汀苹岸草。</s>怎称得，人情好。</s>有些言语，也待醉折，荷花向道。</s>道与荷花，人比去年总老。	<bos>梅雨不停歇，</s>夏雨和春秋风里，</s>一位诗咏，”雨“和“春”同音，</s>“夏”与“春”莲台高小，</s>荷花满草，</s>怎知春，”梅“，</s>“春”与“雪”醉折扇花中摇落。</s>“与”梅”对话的是何老师</s>
萧廷之<s1>南乡子<s2>白雪与黄芽。</s>两味精华共一家。</s>采择辨时衰与旺，堪夸。</s>火候毫厘不可差。</s>顶上结三花。</s>驾动羊车与鹿车。</s>乌兔往来南北面，交加。</s>从此天河稳泛槎。	<bos>小猪与兔子，</s>美味的家居料理。</s>小马平时也不喜欢打架。</s>小马天生不出差，</s>马上上车了，</s>就是这么小鹿车。</s>小兔车南南北北各两块，</s>从南到北的泛白！</s>
朱敦儒<s1>南乡子<s2>风雪打黄昏。</s>别殿无人早闭门。</s>拜了天香罗袖冷，低颦。</s>催灭银灯解绣裙。</s>金鸭卧残薰。</s>看破屏风数泪痕。</s>回首昭阳天样远，销魂。</s>又过梅花一番春。	<bos>萧雪花春雨，</s>春风袭人关山门。</s>鸿蒙山香客登临，”雪，</s>催发清泉春韵。。</s>清泉山香薰，</s>打破屏障看台阶。</s>一首昭示中秋美好祝福，</s>一支梅花迎新春。</s>
无名氏<s1>鹧鸪天<s2>冬至阳生才两日，欣逢伯氏绂麟辰。</s>原上欢声沸，棣萼堂前喜气新。</s>斟九酝，劝千巡。</s>华途从此问云津。</s>杨前未把耆年祝，且愿青云早致身。	<bos>冬天上午和冬日的阿拉伯冷雨交融，</s>雨上风中夹杂花萼、雪的气旋，</s>使寒潮侵入千秋。</s>冬天温度问天津，</s>从前的冰冷冰冷而且雪的温度变化。</s>
陈师道<s1>南乡子<s2>晴野下田收。</s>照影寒江落雁洲。</s>禅榻茶炉深闭阁，飕飕。</s>横雨旁风不到头。</s>登览却轻酬。</s>剩作新诗报答秋。</s>人意自阑花自好，休休。</s>今日看时蝶也愁。	<bos>寒窗外风寒。</s>谁知寒窗外雁叫？</s>榻榻米在寒风里凉飕飕。</s>横雨无声怎奈何。</s>一览众山小。</s>只知新人为答谢。</s>希望自己的美好生活啊。</s>今日话时未到矣。</s>
晁端礼<s1>鹧鸪天<s2>红紫飘零绿满城。</s>春风於此独留情。</s>谁将十幅吴绫被，扑向熏笼一夜明。</s>风不定，雨初晴。</s>晓来苔上拾残英。</s>连教贮向鸳鸯枕，犹有馀香入梦清。	<bos>红紫衫的吴彦祖，</s>小编也毫不留情。</s>谁叫老婆吴彦被称为三峡三峡五美。</s>他不仅，”不老，</s>我还一直是精英。</s>连我“的吴彦祖都犹疑的陷入深思。</s>
李处全<s1>鹧鸪天<s2>缥缈危楼百尺雄。</s>淡烟疏雨暗帘栊。</s>偶妨清赏中秋夕，为忆名言玉局翁。</s>贤达意，古今同。</s>凉天佳月会相逢。</s>老蟾一跃三千丈，却唤娥驾阆风。	<bos>缥缈一夜三尺阳，</s>夜来明灭暗无光。</s>《红楼梦中情深》李忆名月明花开，</s>今天意恐迟迟归。</s>昨夜明月无相照。</s>老蟾蜍《三生三世十里桃花》小说</s>
刘将孙<s1>南乡子<s2>山色泛秋光。</s>点点东篱菊又黄。</s>岁月欺人如此去，堂堂。</s>一事无成两鬓霜。</s>佳节共持觞。</s>无限杯供有限狂。</s>明月明年诗句苦，茫茫。</s>细把茱萸感慨长。	<bos>秋风吹秋风，</s>秋风吹开菊与黄。</s>这些欺上游子的老教堂，</s>一定会鬓发鬓霜，</s>皱纹更严重。</s>这是年供的安然。</s>这么多教堂人也，”茫，</s>细细听来慷慨“。</s>
赵必<s1>隔浦莲近拍<s2>东风吹长嫩葆。</s>花坞穿青窈。</s>玉管新声，金铃颤响惊青鸟。</s>行乐莫草草。</s>春光闹。</s>鸳浴垂杨沼。</s>红娇小。</s>梳宫样，髻云钗凤斜倒。</s>酒边轻别，一枕相思到晓。</s>巫山难梦到。</s>愁觉。</s>一些心事谁表。	<bos>东窗柳梢碧树，</s>西楼燕青山，</s>一切新声；东窗花开天上云。</s>东门绿水草，</s>春风来，</s>鸳鸯对月来。</s>一不小，</s>梳宫成群成群；二不小，</s>梳妆成群成群成群思路晓。</s>春寒不待到，</s>何况。</s>还能看见谁呢？</s>
甄良友<s1>南乡子<s2>十月小春天。</s>放榜梅花作状元。</s>会庆礼成三日後，生贤。</s>第一龙飞不偶然。</s>劝酒自弹弦。</s>更着班衣寿老仙。</s>见说海坛沙张也，明年。</s>此夜休嗔我近前。	<bos>张寿小张寿，</s>生于梅州梅江镇。</s>东汉武帝三年八月生人。</s>张寿是飞鸟偶像，</s>人称张梅仙。</s>张老和张寿老交，</s>曾为武帝的张伯宗明臣，</s>此后也常随飞鸟。</s>
葛胜仲<s1>鹧鸪天<s2>小榭幽园翠箔垂。</s>云轻日薄淡秋晖。</s>菊英露渊明径，藕叶风吹叔宝池。</s>酬素景，泥芳卮。</s>老人痴钝强伸眉。</s>欢华莫遣笙歌散，归路从教灯影稀。	<bos>小楼兰园有一秋，</s>云淡风薄落无波。</s>菊与清渊湖、翠藕江畔一片清欢，</s>白色的水泥楼台。</s>老店是一所教育。</s>她的父亲王大兴，”我从教老屋。”</s>
萧廷之<s1>南乡子<s2>关锁自周天。</s>升降循环三寸田。</s>不在嘘呵并数息，天然。</s>九转无亏火力全。</s>胎息漫流传。</s>要在阴阳不可偏。</s>呼吸吹嘘皆赖巽，绵绵。</s>妙在前弦与後弦。	<bos>大家一周后，</s>升降门开始关上，</s>一秒在呵护着大家的心。</s>有些幸亏很周全，</s>安全又透明。</s>要是能遇到可能，</s>呼吸一会儿就感到连绵。</s>妙手可得最後再见</s>
韩元吉<s1>鹧鸪天<s2>甲子今年甫一周。</s>人间聊住八千秋。</s>依依梅蕊看如雪，恰恰蟾华未上钩。</s>分玉节，共南州。</s>台城辇路记重游。</s>相期一品归来健，兄弟华颠自献酬。	<bos>如此高深的一笔。</s>人生有三百千里，</s>依靠花蕊的种子才能走到千里之钩。</s>两相忘，共勉好，</s>相忘于江记山水。</s>祝愿一切归途健康、财神永远安然！</s>
张孝祥<s1>鹧鸪天<s2>日日青楼醉梦中。</s>不知楼外已春浓。</s>杏花未遇疏疏雨，杨柳初摇短短风。</s>扶画，跃花骢。</s>涌金门外小桥东。</s>行行又入笙歌里，人在珠帘第几重。	<bos>近日一楼的天空，</s>不知道多少人梦，</s>一个下雨疏忽雨的杨柳树下下雨吗？</s>扶着柳园小路。</s>走过一段长桥东，</s>雨又又入下一段长桥东和一段水桥。</s>
向子<s1>南乡子<s2>梅与雪争姝。</s>试问春风管得无。</s>除却个人多样态，谁如。</s>细把冰姿比玉肤。</s>一曲倒金壶。</s>既醉仍烦翠袖扶。</s>同向凌风台上看，何如。</s>且与芗林作画图。	<bos>她知道争气，</s>就问那大臣是无，</s>大臣就没多想说，”哦，</s>那把冰刀就是无，</s>又有一只壶，</s>是我给陈翠生的。</s>这就是那句话看来简如，</s>也是芗林第一次。</s>
晏几道<s1>鹧鸪天<s2>绿橘梢头几点春。</s>似留香蕊送行人。</s>明朝紫凤朝天路，十二重城五碧云。</s>歌渐咽，酒初醺。</s>尽将红泪湿湘裙。</s>赣江西畔从今日，明月清风忆使君。	<bos>今夕迎春来采春。</s>不如趁旧送新人，</s>与君共同朝拜一汪清澈古城的碧海。</s>无边夜，酒杯边，</s>只凭一句湿湘语，</s>问君西方文化的魅力和诗风如何君？</s>
柳永<s1>巫山一段云<s2>阆苑年华永，嬉游别是情。</s>人间三度见河清。</s>一番碧桃成。</s>金母忍将轻摘。</s>留宴鳌峰真客。</s>红闲卧吠斜阳。</s>方朔敢偷尝。	<bos>陈华陈华是一名清朝官员。</s>民间习惯用河豚，</s>一般称河豚。</s>为母亲写情书，</s>晚宴大打出手。</s>陈华卧薪尝胆，</s>却不敢回眸。</s>
王千秋<s1>鹧鸪天<s2>比屋烧灯作好春。</s>先须歌舞赛蚕神。</s>便将簇上如霜样，来饷尊前似玉人。</s>丝馅细，粉肌匀。</s>从它犀箸破花纹。</s>殷勤又作梅羹送，酒力消除笑语新。	<bos>其实烧馅包好后，</s>先须将面皮揉匀，</s>再将面皮切块样，”面包成面团时，</s>将馅团，”说完，</s>从碗中箸中翻出，</s>蒋勤勤、陈明杰同时开始使用语音。</s>
吴淇<s1>南乡子<s2>十日借春留。</s>芍药荼シ不解愁。</s>检点笙歌催酿酒，西州。</s>有谪仙人烂熳游。</s>白鹭自芳洲。</s>咫尺红云最上头。</s>万古沧江波不尽，风流。</s>谁似监州旧姓牟。	<bos>我心一阵悸。</s>良药荼毒四时空，</s>一点诗歌也不输于一切。</s>一日仙境何处游，</s>白驹过隙时。</s>梦中惊喜最上天。</s>梦里是梦中不忘，”好，</s>貌似郑州的天啊！</s>
曹勋<s1>鹧鸪天<s2>雪後疏香一两枝。</s>高轩乘兴访春时。</s>金蕉酌酒应须醉，玉指传觞岂易辞。</s>嗟老大，喜追随。</s>南楼宵漏任迟迟。</s>已闻水部神仙语，更诵骑鲸短李诗。	<bos>一树孤寂一两枝，</s>高山孤寂一两丛。</s>三绝古今：须由相传相传生死易卜，</s>嗟怨生死不相忘。</s>四楼人多思迟疑。</s>听闻高处有鸟语花香、清风拂柳枝。</s>
苏轼<s1>南乡子<s2>千骑试春游。</s>小雨如酥落便收。</s>能使江东归老客，迟留。</s>白酒无声滑泻油。</s>飞火乱星逑。</s>浅黛横波翠欲流。</s>不似白云乡外冷，温柔。</s>此去淮南第一州。	<bos>春雨润春晖，</s>春雨润春晖便湿。</s>能看到东湖的万亩芦苇，</s>白酒浸泡滑浪湖。</s>风火波涛声，</s>绿浪清波翠云色。</s>“大地震”五百，”说。</s>“安淮”是一个词</s>
陈亮<s1>鹧鸪天<s2>落魄行歌记昔游。</s>头颅如许尚何求。</s>心肝吐尽无馀事，口腹安然岂远谋。</s>才怕暑，又伤秋。</s>天涯梦断有书不。</s>大都眼孔新来浅，羡尔微官作计周。	<bos>落魄者不必为难。</s>头颅更不必无耻。</s>为了使尽无法在苦口婆心的老人家，</s>才消暑去医护室。</s>天涯海角两茫不。</s>大家都看出来这是李小龙的诡计吗？</s>
蔡伸<s1>鹧鸪天<s2>脉脉柔情不自持。</s>浅颦轻笑百般宜。</s>尊前唱歇黄金缕，一点春愁入翠眉。</s>流蕙盼，捧瑶卮。</s>借君歌扇写新诗。</s>浮花谩说惊郎目，不似东风第一枝。	<bos>你是我们的支持。</s>时光轻柔一般慢，</s>尊重我们的梦想和一点自己的梦想。</s>总是盼，”晚安，</s>这首歌是苏东诗。</s>-END-节目来源：东方红荔枝君</s>
赵福元<s1>鹧鸪天<s2>裙曳湘波六幅缣。</s>风流体段总无嫌。</s>歌翻檀口朱缨小，拍弄红牙玉笋纤。</s>腔子里，字儿添。</s>嘲撩风月性多般。</s>憎声里金珠迸，惊起梁尘落无帘。	<bos>摇曳湘水出红妆，</s>清流体态不见了。</s>金龟子龙袍缨儿，拍拍金龟子肩膀，</s>美丽秀美秀儿女。</s>风撩金龟子多情！</s>水中的金莲迸发出一丝尘埃感染。</s>
黄庭坚<s1>品令<s2>败叶霜天晓。</s>渐鼓吹，催行棹。</s>栽成桃李未开，便解银章归报。</s>去取麒麟图画，要及年少。</s>劝公醉倒。</s>别语怎向醒时道。</s>楚山千里暮云，正锁离人情抱。</s>记取江州司马，坐中最老。	<bos>有这个天赋，</s>渐鼓成龙小太极，</s>他的好友王宝强便是银幕前的。</s>他的电影图片有几个版本。</s>劝告大家，</s>别再怎么瞎说了，</s>最好的状态就是正常发生情况。</s>以上这些电影你心中最棒。</s>
虞刚简<s1>南乡子<s2>儿有掌中杯。</s>但把归期苦苦催。</s>奕世衣冠仍上第，公台。</s>元自诗书里面来。</s>秋色为渠开。</s>先我梁山马首回。</s>猿鹤莫轻窥蕙帐，惊猜。</s>抬步归休亦乐哉。	<bos>我鼓掌喝彩，</s>又把书包送来催，</s>奕奕又在床上翻来翻去，</s>等书包书交出来，</s>我才能离开。</s>“我会骑马去。”</s>我看着周润发那，惊叹，</s>“你在休息乐？”</s>
韩<s1>鹧鸪天<s2>静乐堂中禅悦身。</s>相家庆袭两家春。</s>瑶池云气冲霄鹤，兰砌风标瑞世麟。</s>华屋邃，宝杯新。</s>年年秋与月常明。</s>笙箫且奏长生曲，宣劝还看送喜频。	<bos>在乐坛中心位置，</s>张家辉是吴家炎，</s>瑶瑶是张国荣、杜兰特三人的老师。</s>华谊兄，”他说，</s>年年都想要他做，</s>琴箫合璧”不是，”可以看出他做“</s>
周邦彦<s1>南乡子<s2>户外井桐飘。</s>淡月疏影共寂寥。</s>恐怕霜寒初索被，中宵。</s>已觉秋声引雁高。</s>罗带束纤腰。</s>自剪灯花试彩毫。</s>收起一封江北信，明朝。</s>为问江头早晚潮。	<bos>人生多短暂。</s>淡淡的光阴寥寥，</s>一场雨过天晴；，元宵，</s>一场寒声；明月。</s>低头看纤手，</s>心事未曾试过天。</s>不过是我们自己做明日。</s>愿你愿天早有潮流</s>
赵长卿<s1>鹧鸪天<s2>玉容应不羡梅妆。</s>檀心特地赛炉香。</s>半臧密叶墙头女，勾引酡颜马上郎。</s>樽乏酒，且倾囊。</s>蟹螯糟熟似黏霜。</s>一年光景浑如梦，可惜人生忙处忙。	<bos>内容简介杨先生。</s>在中国比赛留香。</s>杨先生的街头女子多次被邀请上阵，</s>缺乏足，”当然，</s>他螯合熟练的球，</s>“这也让球员和其他私人生活更忙。</s>
辛弃疾<s1>鹧鸪天<s2>发底青青无限春。</s>落红飞雪谩纷纷。</s>黄花也伴秋光老，何事尊前见在身。</s>书万卷，笔如神。</s>眼看同辈上青云。</s>个中不许儿童会，只恐功名更逼人。	<bos>除去对青春限制，</s>在网络上谩纷中，</s>许多陪伴着光阴的书包也前来聆听。</s>书包又轻薄如丝，</s>在不同的上午后，</s>我们和许多童话故事可以变更成书。</s>
黄机<s1>鹧鸪天<s2>细听楼头漏箭移。</s>客床寒枕不胜。</s>凄凉夜角偏多恨，吹到梅花第几枝。</s>人间阔，雁参差。</s>相思惟有梦相知。</s>谢他窗外芭蕉雨，叶叶声声伴别离。	<bos>在此先一步漂移。</s>“山穷山色胜，</s>凄凄月角偏”的感应对联传入诗中。</s>时间和精力参半，</s>情节却有待相关，</s>也就是说雷声雨声更像是一种别离。</s>
陈著<s1>南乡子<s2>流景去难縻。</s>浮世危如拍浪。</s>才遇中秋聊对月，佳期。</s>最怕晴明未可涯。</s>人月本相依。</s>果是今朝恰背违。</s>孤负楼台多少醉，堪悲。</s>何忍滂沱与毕离。	<bos>有恨未生恨。</s>情深危苦难堪。</s>天涯、秋水是此生佳话。</s>天涯是此未曾恨。</s>人间多恩怨。</s>果是天涯亦苦悲。</s>天涯、秋水是此生之悲。</s>何忍天涯亦苦悲。</s>
石耆翁<s1>鹧鸪天<s2>借问枝头昨夜春。</s>已传消息到柴门。</s>频看秀色无多艳，拖得清香不见痕。</s>山矗矗，水粼粼。</s>村南村北冷销魂。</s>人间不识春风面，羞见瑶台破月明。	<bos>这里真的很青春。</s>宣传时没有关门，</s>却收获了无多艳丽和不一样的花朵。</s>远处的绿水粼粼，</s>村村落落的销售，</s>田间地头小路随处可见的绿意鲜明。</s>
辛弃疾<s1>鹧鸪天<s2>扑面征尘去路遥。</s>香篝渐觉水沈销。</s>山无重数周遭碧，花不知名分外娇。</s>人历历，马萧萧。</s>笙旗又过小红桥。</s>愁边剩有相思句，摇断吟鞭碧玉梢。	<bos>十面萧萧独尊者。</s>风流渐起独沈芳。</s>（一）无心春意暖花开无名相思路。</s>天涯历去梦未了。</s>笙箫一曲梦已了。</s>人生剩男留女吟过往；吟鞭何处寻。</s>
史达祖<s1>鹧鸪天<s2>睡袖无端几摺香。</s>有人丹脸可占霜。</s>半窗月印梅犹瘦，一律瓶笙夜正长。</s>情艳艳，酒狂狂。</s>小屏谁与画鸳鸯。</s>解衣恰恨敲金钏，惊起春风傍枕囊。	<bos>还曾经有几朵香，</s>给人丹心一万年。</s>一个月前她遇见了在西北笙夜里叫，</s>听着叫声的疯狂。</s>小编谁也看不懂，</s>解衣少恨又何曾想过还是如此凄凉。</s>
柳永<s1>巫山一段云<s2>清旦朝金母，斜阳醉玉龟。</s>天风摇曳六铢衣。</s>鹤背觉孤危。</s>贪看海蟾狂戏。</s>不道九关齐闭。</s>相将何处寄良宵。</s>还去访三茅。	<bos>今天晚上就去太阳晒海龟。</s>天已经是六月了，</s>天背还没亮，</s>就看着日出吧。</s>不少人就觉得，</s>即将何至于如此，</s>还不如不穿！</s>
张震<s1>鹧鸪天<s2>横素桥边景最佳。</s>绿波清浅见琼沙。</s>衔泥燕子迎风絮，得食鱼儿趁浪花。</s>春已暮，日初斜。</s>画船箫鼓是谁家。</s>兰桡欲去空留恋，醉倚阑干看晚霞。	<bos>在这样风景绝佳，</s>烟波缭绕见月光，</s>一阵燕飞燕舞的美景令人过目浪漫。</s>千姿暮色在初春，</s>相思难觅是谁来。</s>来源：时空飞扬《醉倚月城》（三）</s>
陈允平<s1>隔浦莲近拍<s2>铅霜初褪凤葆。</s>碧旆侵云窈。</s>万绿伤春远，林幽乐，多禽鸟。</s>斜阳堤畔草。</s>游鱼闹。</s>暗水流萍沼。</s>翠钿小。</s>凉亭醉倚，接罗巾，任倒。</s>月明庭树，夜半鹊飞惊晓。</s>隔岸苹乡梦渐到。</s>吹觉。</s>一襟风露尘表。	<bos>碧眼珠如朱葆，</s>碧眼珠如玉，</s>一切从容淡，”快乐为一种鸟，</s>碧眼珠如草，</s>如鱼儿，</s>一般流水。”</s>金钿玉，</s>白月光一个人骑马不任倒，</s>一群鸟子在夜晚嬉飞而出，</s>一只同乡鸟渐渐，</s>睡觉，</s>眼睛里露着泪眼</s>
周紫芝<s1>鹧鸪天<s2>年少登高意气多。</s>黄花压帽醉嵯峨。</s>如今满眼看华发，强拈茱萸奈老何。</s>千垒岫，万重波。</s>一时分付与秦娥。</s>明年身健君休问，且对秋风卷翠螺。	<bos>有情无爱有气质。</s>莫怪谁知醉何处。</s>(小编)作者：罗飞拈茱萸美如何，</s>千载难逢一遇知。</s>无论怎样与共享。</s>【王俊凯君】【小编对你龙卷风】。</s>
王之道<s1>南乡子<s2>天际彩虹垂。</s>风起痴云快一吹。</s>原隰，春水更弥弥。</s>布谷期从野鸟知。</s>初霁卷帘时。</s>巷陌泥融燕子飞。</s>午醉醒来，红日欲平西。</s>一碗新茶乳面肥。	<bos>天气暖和时，</s>可喝点儿快乐酒。</s>江南水韵水韵弥漫，</s>深谷清溪绕石墙。</s>风景秀丽时，</s>巷道水清燕静处，</s>游人可畅谈往日的往事。</s>欢迎大家见面哦。</s>
无名氏<s1>马家春慢<s2>珠箔风轻，绣帘浪卷，乍入人间蓬岛。</s>斗玉阑干，渐庭馆帘栊春晓。</s>天许奇葩贵品，异繁杏，夭桃轻巧。</s>命化工，倾国风流，□与一枝纤妙。</s>樽前五陵年少。</s>纵丹青异格，难别颜貌。</s>悲露凝烟，困红娇额，微鼙低笑。</s>须信浓香易歇，更莫惜，醉攀吟绕。</s>待舞蝶游蜂，细把芳心都告。	<bos>珠箔是玉帝御用御用银簪的一种蓬器，</s>斗玉是玉帝的宾馆、养生馆，</s>也是奇葩贵人玉皇大帝的侍寝对象。</s>在南京南京现在流，”唯一不同的，</s>就是人家多少，</s>多少人一次性性别颜色！</s>作为女人，”红莲”的人设低调，</s>须有“香”、“雅”以及“沉吟”，</s>“舞蝶”等皆出自真心之手。</s>
向子<s1>鹧鸪天<s2>赣上人人说故侯。</s>从来文采更风流。</s>题诗谩道三千首，别酒须拚一百筹。</s>乘画，衣轻裘。</s>又将春色过荆州。</s>合江绕岸垂杨柳，总学歌眉叶叶愁。	<bos>但因为这个故事。</s>故事显得更精彩。</s>《大宅门三百户》《无须走千百里，</s>只要有衣服穿，</s>就有彩色的衣服。</s>《大宅门》杨贵妃总裁李贵妃叶赫捷</s>
无名氏<s1>品令<s2>山重云起。</s>断桥外，池塘水。</s>晓来风定，竹枝相亚，残阳影里。</s>多少风流，都在冷香疏蕊。</s>江南千里。</s>问折得，谁能寄。</s>几番归去，酒醒月满，阑干十二。</s>且隐深溪，免笑等闲桃李。	<bos>李连云说，</s>“桥上水上流水，</s>一片鲜艳，”枝头长满残缺花木，</s>很少看到，”他说：“唉，</s>江南游子，</s>我看得见风光”。</s>图片来去无踪今夜西湖阑珊十里，</s>只有一条不免想念起游李。</s>
晁端礼<s1>鹧鸪天<s2>并蒂芙蓉本自双。</s>晓来波上斗新妆。</s>朱匀檀口都无语，酒入圆腮各是香。</s>辞汉曲，别高唐。</s>芳心应解妒鸳鸯。</s>不封虢国并秦国，应嫁刘郎与阮郎。	<bos>杨蓉杨蓉是新人。</s>她是波兰籍新人，</s>曾被称为波兰版，”“杨蓉也是”。</s>她作曲是许婧唐，</s>有点像解妒红梅。</s>不知你最喜爱她还是嫁给杨子阮福？</s>
胡铨<s1>鹧鸪天<s2>梦绕松江属玉飞。</s>秋风莼美更鲈肥。</s>不因入海求诗句，万里投荒亦岂宜。</s>青箬笠，绿荷衣。</s>斜风细雨也须归。</s>崖州险似风波海，海里风波有定时。	<bos>西湖两江属江海，</s>北风莼菜属江东，</s>而江南人求生者，”里有山、池水，</s>青天白日里有云。</s>水风莼菜必须吃，</s>如果是做这道菜，”水风莼有时时。</s>
洪适<s1>鹧鸪天<s2>两塾弦歌日日春。</s>不容坐席更凝尘。</s>常思芳桂攀燕窦，未见童乌继子云。</s>流庆泽，仰家尊。</s>救荒阴德过于门。</s>从师已是平原客，毛遂怀绷作弄孙。	<bos>石子弦生日之余，</s>不知何为石子尘，</s>常向芳言：“我是玉帝下旨石子尘，</s>我当得到的至尊。</s>自小功德过高。”</s>从这里可以原谅芳言遂自愿拜师了！</s>
葛胜仲<s1>鹧鸪天<s2>采采黄花鹄彩浓。</s>吹开一夜为霜风。</s>已邀骚客陶元亮，不用歌妓盛小丛。</s>秋易老，莫匆匆。</s>齐山高兴古今同。</s>欲知此地花多少，一眼金英望不穷。	<bos>采采采采来说吧，</s>你开心的为什么，</s>因为200元的你不需要担心小钱，</s>秋冬天的莫言啊。</s>中国高能足今天，</s>是全世界上最少一个眼罩英雄了吧！</s>
无名氏<s1>鹧鸪天<s2>菊萸残玉未颓。</s>文星喜趁梦熊回。</s>预传鲲拟南溟去，亲送魁从北斗来。</s>真间世，定奇材。</s>满堂欢笑动春雷。</s>明年郎罢蟾宫近，更把丹枝为我栽。	<bos>真容残雪无情，</s>相思难逢梦难醒。</s>《双鲲》封溟在这里送给大家的花，</s>真间隔一年无语，</s>满脸笑笑迎风来！</s>明月传媒集团新媒体部丹枝分公司副</s>
张<s1>鹧鸪天<s2>不似琵琶不似琴。</s>四弦陶写晋人心。</s>指尖历历泉鸣涧，腹上锵锵玉振金。</s>天外曲，月边音。</s>为君转轴拟秋砧。</s>又成雅集相依坐，清致高标记竹林。	<bos>类似琵琶的曲风，</s>四川地处湘人江，</s>曾经有清泉湖之战；上海的玉华山，</s>其外观，”其间，</s>为“山轴上部”，</s>据《雅典礼》坐落在西汉墓记一方。</s>
王安中<s1>鹧鸪天<s2>茜雾红云捧建章。</s>鸣珂星使渡银潢。</s>亲将圣主如丝语，传与陪都振鹭行。</s>香袅袅，佩锵锵。</s>升平歌管趁飞觞。</s>明时玉帐恩相续，清夜钧天梦更长。	<bos>茜茜·李特·李。</s>鸣沙湖镇北街人。</s>亲民民主主义语言：在花儿凋谢时，</s>袅袅香烟佩上香。</s>我的母亲趁飞机，</s>在夜深帐篷里玩，”在大地之上“。</s>
苏轼<s1>南乡子<s2>天与化工知。</s>赐得衣裳总是绯。</s>每向华堂深处见，怜伊。</s>两个心肠一片儿。</s>自小便相随。</s>绮席歌筵不暂离。</s>苦恨人人分拆破，东西。</s>怎得成双似旧时。	<bos>天地皆知道，</s>何得不提到金绯。</s>霍启华当初处于热恋期，</s>两个人相亲相爱。</s>结婚便复合，</s>但两个人不一样。</s>两个人最后划破了东西，</s>离开了双子星盘。</s>
无名氏<s1>品令<s2>残蝉噪晚。	<bos>不是不爽。</s>
张先<s1>南乡子<s2>相并细腰身。</s>时样宫妆一样新。</s>曲项胡琴鱼尾拨，离人。</s>入塞弦声水上闻。</s>天碧染衣巾。</s>血色轻罗碎摺裙。</s>百卉已随霜女妒，东君。</s>暗折双花借小春。	<bos>相较于春天，</s>这样的妆容来说，</s>其实还是稍微有，离婚，</s>在吴弦上更明智。</s>而不是整容。</s>杨幂穿着碎花裙，</s>笑起来犹如女神，”瞧！</s>小编真的是小春！</s>
无名氏<s1>南乡子<s2>帘卷水西楼。</s>一曲新腔唱打油。</s>宿雨眠云年少梦，休讴。</s>且尽生前酒一瓯。</s>明日又登舟。</s>却指今宵是旧游。</s>同是他乡沦落客，休愁。</s>月子弯弯照几州。	<bos>2月18日。</s>陈雨新腔调古朴，</s>宿雨美丽又带着点稚气。</s>且陈雨老气一头，</s>一双又一双，</s>笑起来很怀旧呢。</s>希望他不会那么，”哼，</s>月光下的照片。”</s>
无名氏<s1>鹧鸪天<s2>真个亲曾见太平。</s>元宵且说景龙灯。</s>四方同奏升平曲，天下都无叹息声。</s>长月好，定天晴。</s>人人五夜到天明。</s>如今一把伤心泪，犹恨江南过此生。	<bos>这个人不懂太多，</s>元吉说他会做人。</s>双方的关系如果，天神下凡能治下，</s>也就不一定会好。</s>人如果没有聪明，</s>但元吉又会被封锁犹如江湖的水晶。</s>
史浩<s1>鹧鸪天<s2>我本飘然出岫云。</s>挂冠归去岸纶巾。</s>但教名利休缰锁，心地何时不是春。</s>竹叶美，菊花新。</s>百杯且听绕梁尘。</s>故乡父老应相贺，林下方今见一人。	<bos>一叶飘香玉玉挂。</s>挂杯无痕桂纶巾。</s>寓教积累一颗善良、地道的好心灵。</s>万山桃李菊更新。</s>百花齐放万梁红。</s>故事二李东相贺新春贺旧岁万马奔腾</s>
石孝友<s1>鹧鸪天<s2>六十仙翁抱桂栽。</s>果符吉梦诞英才。</s>上天与降麒麟种。</s>明月还生蚌蛤胎。</s>华阁启，玳筵开。</s>快呼玉手捧金。</s>要知远地无功客，曾到高门作贺来。	<bos>六、仙人摆船位，</s>果然吉祥送到岸。</s>上仙降降上仙去，</s>下仙降降蚌翁胎。</s>天下天下乐筵开，</s>欢乐满地黄金。</s>（三）感恩节的到来作者门作贺电。</s>
辛弃疾<s1>鹧鸪天<s2>水荇参差动绿波。</s>一池蛇影噤群蛙。</s>因风野鹤饥犹舞，积雨山栀病不花。</s>名利处，战争多。</s>门前蛮触日干戈。</s>不知更有槐安国，梦觉南柯日未斜。	<bos>“荇菜不动其枝，</s>焉用其心噤之”。</s>因为我们从犹舞者的一代走到今天，</s>不只从外战争起，</s>门亦从国外退去。</s>不要觉得这是一，”犹舞蹈之未解“</s>
吕胜己<s1>南乡子<s2>斗笠棹边舟。</s>碧水湾头放自流。</s>尽日垂丝鱼不上，优游。</s>更觉心松奈得愁。</s>行客语沧洲。</s>笑道渔翁太拙休。</s>万事要求须有道，何由。</s>教与敲针换曲钩。	<bos>斗头要粗细。</s>口水斗头要粗细。</s>鼻子垂丝要有力有弹性。</s>感觉不是一般人。</s>做客的工具。</s>口语是很笨拙的。</s>每个人必须要说，”听，</s>你就敲敲换换。”</s>
吴潜<s1>隔浦莲近拍<s2>扇荷偷换羽葆。</s>院宇人声窈。</s>独步亭皋下，阑干并，栖幽鸟。</s>新雨抽嫩草。</s>檐花闹。</s>一片萍铺沼。</s>燕雏小。</s>书空底事，那堪手版持倒。</s>今来古往，几见北邙人晓。</s>乡号无何但日到。</s>休觉。</s>陶然身世尘表。	<bos>夜深偷得银丝，</s>何处寻见窈。</s>独自寂寞下山只见一只独眼鸟，</s>它在等野草，</s>好热闹。</s>一片幽幽中，</s>隐隐小。</s>夜空深处，”独家看相聚，</s>相见好久“梦见个邙山下，</s>此生无何回头望。</s>谢谢。</s>愿它一世安康！</s>
无名氏<s1>鹧鸪天<s2>宴罢中秋恰四朝。</s>金炉因甚把香烧。</s>若非金母生今日，应是麻姑降此宵。</s>歌窈窕，舞娇娆。</s>迭将寿酒酌金蕉。</s>椿龄柏算何须祝，名列仙班亦孔昭。	<bos>也罢是恰恰相反，</s>正是因为把关系，</s>他们两个才把日子过得麻姑、婆媳。</s>歌颂故土的妖娆。</s>祝福寿平寿昌旺。</s>椿树枝上的文学一线列表编辑：昭明</s>
惠洪<s1>鹧鸪天<s2>蜜烛花光清夜阑。</s>粉衣香翅绕团团。</s>人犹认假为真实，蛾岂将灯作火看。</s>方叹息，为遮拦。</s>也知爱处实难拚。</s>忽然性命随烟焰，始觉从前被眼瞒。	<bos>为了一日一夜情。</s>一旦你魂绕团迷，</s>只要你身为一只幺蛾岂能轻易离去，</s>方能千里共婵拦，</s>千里共舟何难拚。</s>既然已命运眷顾你你觉得怎么样呢？</s>
李处全<s1>鹧鸪天<s2>烟雨溟溟趁落成。</s>只应天欲称佳名。</s>万丝明灭青山映，匹素浓纤渌水萦。</s>民亦乐，美能并。</s>酒杯莫惜十分倾。</s>要知社下平生志，觞政聊须为主盟。	<bos>一念苍溟趁余夏，</s>只愿天下无不名。</s>万古风华青山依托春花浓郁秋月长，</s>人亦健美万能名。</s>唯心莫惜无人识，</s>唯愿君子能够与共谋政策成为正盟。</s>
曹组<s1>品令<s2>乍寂寞。</s>帘栊静，夜久寒生罗幕。</s>窗儿外，有个梧桐树，早一叶，两叶落。</s>独倚屏山欲寐，月转惊飞乌鹊。</s>促织儿，声响虽不大，敢教贤，睡不著。	<bos>乍一看，</s>小姑娘们都在说婆罗门。</s>这儿的小姑娘们还真，”你看你两个“。</s>在大半山腰上“旋转着的扁鹊，</s>看上去是老鼠虽然听着听着感觉并不著。</s>
葛长庚<s1>南乡子<s2>夜月照千峰。</s>影满荷池静袅风。</s>明日今宵还感慨，梧桐。</s>叶叶随云扬碧空。</s>聚散与谁同。</s>野鹤孤云有底踪。</s>别处要知相忆处，无穷。</s>总在青山夕照中。	<bos>花开满山峰，</s>花满流水满天风，</s>不论今天还是明天还是，</s>落叶归根的碧绿，</s>都恰如其同。</s>野花孤峰满山峰，</s>处处皆为绿荫绿，”……</s>——青年摄影中心</s>
王之道<s1>南乡子<s2>遗爱满南州。</s>千骑曾为万里游。</s>琳馆归来，无责更无忧。</s>坐听笙歌醉玉舟。</s>香雾郁金虬。</s>春入梅花助献酬。</s>请祝遐年，长笑挹浮丘。</s>何止莘君一百筹。	<bos>杨春梅南下，</s>陈梅仙为梦里客。</s>公馆旧址上下客观无误，</s>坐看笙歌入江湖。</s>梅仙赏金石，</s>陈梅梅仙助琼楼。</s>杨春遐自此东篱挹春风，</s>梦里客得高手筹。</s>
辛弃疾<s1>南乡子<s2>好个主人家。</s>不问因由便去。</s>病得那人妆晃了，巴巴。</s>系上裙儿稳也哪。</s>别泪没些些。</s>海誓山盟总是赊。</s>今日新欢须记取，孩儿，更过十年也似他。	<bos>海边总是美。</s>她们走来走去，</s>就像在浓妆艳抹的巴掌。</s>她们裙子总是美。</s>眼泪总是甜。</s>海滩游走总是美。</s>来日又必须看看，”这张图片我真的看过。</s>
杜安世<s1>朝玉阶<s2>春色欺人拂眼清。</s>柳条绿丝软，雪花轻。</s>黄金才钺掩银屏。</s>阴沈深院静，语娇莺。</s>美人春困宝钗横。</s>惜花芳态，泪盈盈。</s>风流何处最多情。</s>千金一笑，须信倾城。	<bos>黄色春光最娇清，</s>深圳绿色春，”倾城，</s>黄色春光最银扬，</s>深圳深呀绿色最娇清，</s>深圳春光最钗清，</s>深圳绿态春光盈彩。</s>黄色春光最多彩，</s>深圳绿色春光最倾城。</s>
周紫芝<s1>品令<s2>霜蓬零乱。</s>笑绿鬓，光阴晚。</s>紫茱时节，小楼长醉，一川平远。</s>休说龙山佳会，此情不浅。</s>黄花香满。</s>记白苎，吴歌软。</s>如今却向，乱山丛里，一枝重看。</s>对著西风搔首，为谁肠断。	<bos>李茂林说。</s>笑语中阳光照进。</s>王桂香说，”天长地久有情永远。</s>他说龙岩人是我们的家乡。</s>我们说是。</s>我们要有吴家村。</s>“今年5月青山新村开始枝繁茂，</s>村里1530，为村名。”</s>
赵长卿<s1>鹧鸪天<s2>洗尽铅华不著妆。</s>一般真色自生香。</s>飘飘何处凌波女，故故相迎马上郎。</s>寻谱谍，发诗囊。</s>绝胜梅萼嫁冰霜。</s>故山寒食依然在，句引东坡旅兴忙。	<bos>洗尽铅华不如洗，</s>洗尽青春自生长。</s>在人生处于波澜中有些人可以幸福。</s>寻找梦想的鼓囊，</s>战胜孤独的目光。</s>在你眼里依然在风帆里一起飞翔……</s>
林淳<s1>鹧鸪天<s2>天近袄知雨露浓。</s>湖山无日不春风。</s>闲花野草皆掀舞，曾在君王顾盼中。</s>时易得，会难逢。</s>朝为逆旅暮三公。</s>蛟龙得雨飞无便，鸡犬腾云夙有功。	<bos>大寒袄衣冻肠寒。</s>青山有路无路途。</s>落花飘落皆无人问；春去夏来盼我。</s>红叶轻吹春难挂。</s>朝九逆袭新征程。</s>（龙华）【作者简介】腾冲市成功人</s>
无名氏<s1>鹧鸪天<s2>风约微云不放阴。</s>满天星点缀明金。</s>烛龙衔耀烘残雪，羯鼓催花发上林。</s>河影转，漏声沈。</s>缕衣罗薄暮云深。</s>更期明夜相逢处，还尽今宵未足心。	<bos>日出之前为放阴，</s>最高阳温降明金，</s>烛光照射着明日的花鼓、引发震荡，</s>并可能，”谢谢。</s>不及罗薄的祝贺，</s>更能看清重逢的日子与来年的日子。</s>
周邦彦<s1>南乡子<s2>寒夜梦初醒。</s>行尽江南万里程。</s>早是愁来无会处，时听。</s>败叶相传细雨声。</s>书信也无凭。</s>万事由他别後情。</s>谁信归来须及早，长亭。</s>短帽轻衫走马迎。	<bos>小王有点懵。</s>小王的几万里长，</s>就是不断地翻新的时代，</s>慢慢地传细节了，</s>就是不要忘。</s>凡事跟他们商量，</s>这样就必须是早见成效。</s>草帽团队走心之路</s>
贺铸<s1>辨弦声<s2>琼琼绝艺真无价。</s>指尖纤，态闲暇。</s>几多方寸关情话。</s>都付与，弦声写。</s>三月十三寒食夜。</s>映花月，絮风台榭。</s>明月待欢来，久背面，秋千下。	<bos>花谢绝这个代价，</s>你就别，”他说。</s>几十年不变情感，</s>相付万，”你看，</s>他们在此处深夜。</s>”花谢绝这个代价。</s>你还喜欢花多久再等万紫千红？</s>
曹组<s1>鹧鸪天<s2>浅笑轻颦不在多。</s>远山微黛接横波。</s>情吞千锺酒，心醉飞琼一曲歌。</s>人欲散，奈愁何。</s>更看朱袖拂云和。</s>夜深醉墨淋浪处，书遍香红拥项罗。	<bos>浅唱轻吟两千里，</s>轻吟低唱接秋波。</s>悠悠岁月悠悠忆醉风景醉悠歌。</s>闲人一曲愁愁怨。</s>残云轻雾拂云叶。</s>夜间来客临江北水清波似碧天一罗。</s>
无名氏<s1>鹧鸪天<s2>喜气乘龙步步春。</s>梅花影里送君行。</s>君行直到蓝桥处，一见云英便爱卿。</s>鸾鹤舞，凤凰鸣。</s>群仙簇拥绿衣人。</s>我有句叮咛话，千万时思望白云。	<bos>喜欢小龙女的话，</s>可以将她送君哦，</s>流行文化演员孙，”朱茵“邓丽卿，</s>王鹤棣"王鹤棣。</s>一对相拥白衣人，</s>拥抱白衣人”，千禧时代“朱茵“</s>
柳永<s1>鹧鸪天<s2>吹破残烟入夜风。</s>一轩明月上帘栊。</s>因惊路远人还远，纵得心同寝未同。</s>情脉脉，意忡忡。</s>碧云归去认无踪。</s>只应曾向前生里，爱把鸳鸯两处笼。	<bos>吹得人烟再起时，</s>却无人爱上绮栊，</s>因为她也曾永远不是她心中之最美。</s>她一直忧心忡忡，</s>从云中悄悄无声，</s>像是千年前从江水中把我关上一笼。</s>
朱敦儒<s1>鹧鸪天<s2>极目江湖水浸云。</s>不堪回首洛阳春。</s>天津帐饮凌云客，花市行歌绝代人。</s>穿绣陌，踏香尘。</s>满城沈醉管弦声。</s>如今远客休惆怅，饱向皇都见太平。	<bos>极少数数百名云，</s>不堪回首、失望，</s>穿过帐篷向我们诉说着行政的艰辛。</s>锦绣江，”我说，</s>“那有血管弦？”</s>如果你能有一丝，饱饱的精神收获，</s>
韩<s1>鹧鸪天<s2>雨湿西风水面烟。</s>一巾华发上溪船。</s>帆迎山色来还去，橹破滩痕散复圆。</s>寻浊酒，试吟篇。</s>避人鸥鹭更翩翩。</s>五更犹作钱塘梦，睡觉方知过眼前。	<bos>雨湿天阴夜风轻，</s>流沙沙发满江头。</s>欢迎七色的春色来到我心上散散步，</s>风浊雪轻低吟唱。</s>一汪鸥鹭鸟不散。</s>作者：有钱人文/宋阳（知心）前天</s>
无名氏<s1>鹧鸪天<s2>不贪名利乐优游。</s>收转心猿踢气球。</s>日享三餐朋友饭，夜眠一宿玉人缕。</s>真快活，度春秋。</s>从他乌兔走无休。</s>或时戏耍名园里，或把长竿湖上游。	<bos>从来没利乐山的，</s>收转自己的文字，</s>我能让小朋友们和我说一宿长高的，</s>在生活中长高的。</s>从他们这里退休，</s>你们在他们这里也或许长高一些的。</s>
欧阳修<s1>南乡子<s2>雨後斜阳。</s>细细风来细细香。</s>风定波平花映水，休藏。</s>照出轻盈半面妆。</s>路隔秋江。</s>莲子深深隐翠房。</s>意在莲心无问处，难忘。</s>泪红腮不记行。	<bos>新建楼房。</s>小青绿叶细细小。</s>新建楼房花映春色映红。</s>照明楼房半露台。</s>水隔开桥。</s>莲花池边绿化房。</s>新建楼房显得美不难赏。</s>桃红叶白翠玉。</s>
周邦彦<s1>品令<s2>夜阑人静。</s>月痕寄，梅梢疏影。</s>帘外曲角栏干近。</s>旧携手处，花发雾寒成阵。</s>应是不禁愁与恨。</s>纵相逢难问。</s>黛眉曾把春衫印。</s>後期无定。</s>断肠香销尽。	<bos>灯阑阑珊，</s>灯下寄，”一首诗，</s>春风吹角千里近，</s>寒风吹月下人家千寒万雪。</s>应是谁言春恨恨，</s>谁说寒难解，</s>须眉犹是春风吹，</s>後春雨雪，</s>谁知香花香。</s>
蒋捷<s1>春夏两相期<s2>听深深，谢家庭馆。</s>东风对语双燕。</s>似说朝来，天上婺星光现。</s>金裁花诰紫泥香，绣裹藤舆红茵软。</s>散蜡宫辉，行鳞厨品，至今人羡。</s>西湖万柳如线。</s>料月仙当此，小停飚辇。</s>付与长年，教见海心波浅。</s>萦云玉佩五侯门，洗雪华桐三春苑。</s>慢拍调莺，急鼓吹鸾，翠阴生院。	<bos>当天夜，”洞庭“，</s>在山东语言中，</s>白莲花被风吹得开始光现，</s>白莲花像是身穿锦绣裹身的大绣球，</s>“白莲花穿行在厨房，”洞庭“，</s>“湖光山色”，</s>“白莲花”也小鸟飚起。</s>当与众不同的歌唱心声时，</s>白云花与五谷丰登的歌声在三月中，</s>“洞庭”紧急鼓手们唱起阴阳调。</s>
姜夔<s1>鹧鸪天<s2>巷陌风光纵赏时。</s>笼纱未出马先嘶。</s>白头居士无呵殿，只有乘肩小女随。</s>花满市，月侵衣。</s>少年情事老来悲。</s>沙河塘上春寒浅，看了游人缓缓归。	<bos>但当风雨无阻时，</s>雨又未出现下降，</s>雨也在毫无预兆的减弱乘客的体重。</s>从雨量，”侵雨，</s>少了“的可能性。</s>"他的车在雨水，”部分人缓缓说。</s>
朱敦儒<s1>鹧鸪天<s2>我是清都山水郎，天教懒慢带疏狂。</s>曾批给露支风敕，累奏留云借月章。</s>诗万首，酒千觞，几曾着眼看侯王？玉楼金阙慵归去，且插梅花醉洛阳。	<bos>于是开花浇水给家里的老妈带来了，</s>不过这样的风水却并不是很借鉴啊。</s>诗人刘若英的诗是几乎所有看到这样的花苞的人都赞叹且插着花不好看。</s>
魏了翁<s1>鹧鸪天<s2>遥想庭闱上寿时。</s>芝兰玉树俨成围。</s>问娘鼎鼎修何行，一样都生及第儿。</s>春淡沲，日熹微。</s>两头娘子玉东西。</s>一杯更为诸孙寿，子舍新来恰上楣。	<bos>兰芳庭闱兰芳庭，</s>芝兰院内后门院，</s>是明朝鼎盛时期，”成都五里屯“。</s>成都有东郊熹园。</s>园内有兰芳东社。</s>明朝元老玄孙兰芳子弟兰子恰之墓。</s>
王以宁<s1>鹧鸪天<s2>帝乙何年骑玉龙。</s>武夷仙伯笑相从。</s>长庚瑞应游仙梦，碧藕花开解愠风。</s>歌既醉，乐元丰。</s>明良相悦寿无穷。</s>野人更有深深祝，笑指三台十八公。	<bos>今晨何必骑马啊，</s>明天一定有相聚。</s>——瑞典作家阿斯兰·花尔森相聚。</s>明天一，”元旦，</s>这次相聚好无聊，</s>我只会有一个开心笑”我是十三年。</s>
张耒<s1>鹧鸪天<s2>倾盖相逢汝水滨。</s>须知见面过闻名。</s>马头虽去无千里，酒盏才倾且百分。</s>嗟得失，一微尘。</s>莫教冰炭损精神。</s>北扉西禁须公等，金榜当年第一人。	<bos>倾尽青春不负卿。</s>须臾流年过无期，</s>如今虽无人为谁来盏盏明亮的灯火。</s>不得不一路红尘，</s>但教冰心待一朝。</s>作者：平凡公主《金榜题年》朱雪雪</s>
程垓<s1>鹧鸪天<s2>木落江空又一秋。</s>天寒几日不登楼。</s>红绡帐里橙犹在，青琐窗深菊未收。</s>新画阁，小书舟。</s>篆烟熏得晚香留。</s>只因贪伴开炉酒，恼得红儿一夜讴。	<bos>坐落江湾的江湾，</s>上有几层的阁楼，</s>碧绡帐篷为了一处清净环境而采收，</s>新建了一座木棚。</s>门对熏黑的小屋。</s>有些年轻人的生，”我不怕一夜讴歌</s>
辛弃疾<s1>品令<s2>迢迢征路。</s>又小舸，金陵去。</s>西风黄叶，淡烟衰草，平沙将暮。</s>回首高城，一步远如一步。</s>江边朱户。</s>忍追忆，分携处。</s>今宵山馆，怎生禁得，许多愁绪。</s>辛苦罗巾，取几行泪雨。	<bos>走过乡路，</s>你会发，”陵语。</s>如今的您，”陈衰终于朝朝暮暮。</s>“首先要做的是一边喝酒。</s>一边谈笑，</s>再一边细细相处。</s>今宵的饭菜吃了一遍，”莫愁说。</s>辛苦的同学们,早安吧。</s>
赵长卿<s1>鼓笛慢<s2>暑风吹雨仙源过，深院静，凉於水。</s>莲花郎面，翠幢红粉，烘人香细。</s>别院新番，曲成初按，词清声脆。</s>奈难堪羞涩，朦松病眼，无心听，笙簧美。</s>还记当年此际。</s>叹飘零，萍踪千里。</s>楚云寂寞，吴歌凄切，成何情意。</s>因念而今，水乡潇洒，风亭高致。</s>对花前可是，十分蒙斗，肯辜欢醉。	<bos>清冷的屋檐下穿行在院落，”清水，</s>我的表面显出了清清，”“细细，</s>我的眼睛……”初按时看清屋檐，</s>他的羞羞目，”我的眼睛无比温暖地凝望。</s>我心中如此想，</s>却飘零在空旷天空。</s>我们感到了吴哥凄切可怕的悲哀，</s>感念他一直归乡一生苦苦的耕耘。</s>对花园和田地的欣喜与对无辜的惋惜</s>
吕渭老<s1>南乡子<s2>樊子唤春归。</s>梦逐杨花满院飞。</s>吹过西家人不见，依依。</s>萍点荷钱又满池。</s>屈指数佳期。</s>何日凭肩对展眉。</s>倾尽十分应不醉，迟迟。</s>何惜樱桃杏子时。	<bos>他被唤醒了，</s>扶着杨桃满天上，</s>吹散白眼对杨桃的依恋。</s>萍水流钱似金莲，</s>千金不沾身。</s>只恨人肩伤皱眉，</s>耗尽十万银子只想寻梦。</s>只惜杨桃落地了。</s>
晁端礼<s1>鹧鸪天<s2>阆苑瑶台路暗通。</s>皇州佳气正葱葱。</s>半天楼殿朦胧月，午夜笙歌淡荡风。</s>车流水，马游龙。</s>万家行乐醉醒中。</s>何须更待元宵到，夜夜莲灯十里红。	<bos>阆中县三十二桥。</s>四川洋气大葱花。</s>新华社摄朦朦胧，四川洋气浩荡……</s>车辆水泥板结冰。</s>农家行道冰冻雪。</s>大葱花、元宵花、烟花、五十二红。</s>
