晏几道<s1>鹧鸪天<s2>十里楼台倚翠微。</s>百花深处杜娟啼。</s>殷勤自与行人语，不似流莺取次飞。</s>惊梦觉，弄晴时。</s>声声只道不如归。</s>天涯岂是无归意，争奈归期未可期。	<bos>一片翠绿的翠山。</s>莲花到处是花卉，</s>在远处的行人群中显得苍翠而优美。</s>一团团，”花啊。</s>声声的花的芬芳。</s>美丽的风景使人们争相向往未可知。</s>
高观国<s1>隔浦莲近拍<s2>银湾初霁暮雨。</s>鹊赴秋期去。</s>浅月窥清夜，凉生一天风露。</s>纤巧云暗度。</s>河桥路。</s>缥缈乘鸾女。</s>正容与。</s>西厢旧约，玉娇谁见私语。</s>柔情不尽，好似冰绡云缕。</s>回首天涯又怨阻。</s>无语。</s>西风魂断机杼。	<bos>七月雪霁时节。</s>鹊林无影踪。</s>独步窥窗夜晓凉风吹起风筝。</s>夕阳明暗处。</s>无云路。</s>缥缈云外来。</s>真容易。</s>不要再把情绪写在自私里。</s>人间不尽知己与闲人相处，</s>谁言寸草又怨人。</s>莫愁。</s>想起你的时候。</s>
王沂孙<s1>金盏子<s2>雨叶吟蝉，露草流萤，岁华将晚。</s>对静夜无眠，稀星散，时度绛河清浅。</s>甚处画角凄凉，引轻寒催燕。</s>西楼外，斜月未沈，风急雁行吹断。</s>此际怎消遣。</s>要相见，除非待梦见。</s>盈盈洞房泪眼，看人似，冷落过秋纨扇。</s>痛惜小院桐阴，空啼鸦零乱。</s>厌厌地，终日为伊，香愁粉怨。	<bos>雨后的一路上不时传，”“嗯”。</s>晴空下无数条河流从天上的小河涌上。</s>大大的角落里还飘荡着小燕。</s>这条河倾斜的方向在风中连连不断。</s>此时的秋季，</s>只有春天才期待遇见，</s>那一双双泪眼深深地锁住了经过的纨绔，</s>让他在院子里显得啼笑皆乱，</s>而这场，终日的思念也止不住。</s>
黎廷瑞<s1>南乡子<s2>醉罢黑瑶池。</s>渺渺春云海峤归。</s>画楝珠帘成昨梦，谁知。</s>百姓人家几度非。</s>相对语斜晖。</s>肠断江城柳絮飞。</s>再见玉郎应不认，堪悲。</s>也被缁尘染素衣。	<bos>醉汉不在朝，</s>君子何能出峤归？</s>画里江南的昨夜一个人，</s>梦里梦里几人知。</s>谁言语不当，</s>恨断江陵今日情。</s>可见那人应该是谁在场，</s>也被关在屋子里。</s>
赵长卿<s1>鹧鸪天<s2>落魄东吴二十春。</s>风流诗句得清新。</s>今年却恨花星照，再见温卿与远真。</s>分楚佩，染巫云。</s>赤绳结得短花茵。</s>若非京口初相识，安得毗陵作故人。	<bos>落叶东渐春落叶，</s>寒流无处得花香。</s>新年佳节五星红灯一盏暖灯一盏暖。</s>分外红火惹人醉。</s>红绳玉带一团茵。</s>（北京晨报）（北京得宠）作品展示</s>
米芾<s1>鹧鸪天<s2>云液无声白似银。</s>红霞一抹百花新。</s>觞多莫压频频劝，一片花飞减却春。</s>蜂翅乱，蝶眉颦。</s>花间啼鸟劝游人。</s>人生无事须行乐，富贵何时且健身。	<bos>云雾缭绕不似春，</s>晚霞一片似天涯，</s>太多的梦幻空气，”一缕春风拂春，</s>摇曳在凤蝶眉间，</s>清晨啼啼不如人，</s>太多的美好快乐都是贵人扶养而身。</s>
刘学箕<s1>鹧鸪天<s2>山色都如归兴浓。</s>春融融处客匆匆。</s>岸花影里莺吟雾，江阁阴中燕受风。</s>凭画，睇层空。</s>情衷待说几时同。</s>不如且尽樽中绿，图得醉脸红。	<bos>每日都有新鲜看。</s>金融界一片静好。</s>夜听江南风吟雾绕天上阴阳看流星。</s>有风必睇波澜。</s>情义相逢必相见。</s>情在缘尽之中才能见得多彩……</s>
郭应祥<s1>鹧鸪天<s2>贺了生辰却贺冬。</s>今年乐事又重重。</s>寿香喷处芝兰馥，寿洒斟时琥珀浓。</s>偕桂隐，到花封。</s>迎长介寿恰三逢。</s>明年此日称觞罢，稳上肩舆九里松。	<bos>贺年盛宴贺贺年，</s>古人乐乐有尊重。</s>寿平年间春有高山挥洒斟酒的风俗。</s>偕桂花共同上香，</s>共度佳节二三天。</s>今年春有清波荡漾、比肩清云轻松。</s>
孙惟信<s1>南乡子<s2>璧月小红楼。</s>听得吹箫忆旧游。</s>霜冷阑干天似水，扬州。</s>薄声名总是愁。</s>尘暗裘。</s>针线曾劳玉指柔。</s>一梦觉来三十载，休休。</s>空为梅花白了头。	<bos>三千水暖楼，</s>千树万树百花游。</s>一万山青三千水，”春，</s>一千水暖风愁。</s>尘烟里，</s>针线清劳谁相助，</s>一万人红三千树；山间，</s>一万梅花争日出。</s>
黄叔达<s1>南乡子<s2>落帽晚风回。</s>又报黄花一番开。</s>扶杖老人心未老，堪。</s>漫有才情付与谁。</s>芳意正徘徊。</s>传与西风且慢吹。</s>明日馀尊还共倒，重来。</s>未必秋香一夜衰。	<bos>因为有风浪，</s>回报才有一群人。</s>扶贫攻坚才干好，”。</s>慈母才能胜与怒。</s>芳草长须青，</s>传承才干爱和平。</s>明日推介:红土一方红。</s>未成年梦一场空。</s>
洪咨夔<s1>鹧鸪天<s2>天理从来屈有信。</s>东风到处物皆春。</s>门前骢马权奇种，台上慈乌反哺心。</s>花岛屐，柳湖尊。</s>好将长健傲长贫。</s>诸孙认取翁翁意，插架诗书不负人。	<bos>天欲将来必先登，</s>东风必有南山前。</s>门外风声吟：柳枝摇曳慈乌古路斜，</s>南墙屐齿柳树长。</s>东风不惧傲骨长。</s>江边钓鱼渔翁作者插图来源于网人社</s>
柳永<s1>巫山一段云<s2>萧氏贤夫妇，茅家好弟兄。</s>羽轮飙驾赴层城。</s>高会尽仙卿。</s>一曲云谣为寿。</s>倒尽金壶碧酒。</s>醺酣争撼白榆花。</s>踏碎九光霞。	<bos>黄龙子是孙悟空的大师兄。</s>坐轮盘一身层皮。</s>高举铁扇子。</s>手里童谣悠扬。</s>倒挂在天上飞。</s>酒酣肚明戏更酣。</s>谁堪重操心。</s>
赵师侠<s1>鹧鸪天<s2>烟霭空江上春。</s>夕阳芳草渡头情。</s>飞红已逐东风远，嫩绿还因夜雨深。</s>情脉脉，思沈沈。</s>卷帘愁与暮云平。</s>栏干倚遍东西曲，杜宇一声肠断人。	<bos>不觉思绪上动，</s>夕阳已化为诗情，</s>落叶上的凉风只剩秋雨还带着柔情。</s>一脉柔情似江南。</s>江南愁绪暮如烟，</s>栏竿一帘随着风吹起、江南夜断时。</s>
晏几道<s1>南乡子<s2>眼约也应虚。</s>昨夜归来凤枕孤。</s>且据如今情分里，相於。</s>只恐多时不似初。</s>深意托双鱼。</s>小翦蛮笺细字书。</s>更把此情重问得，何如。</s>共结因缘久远无。	<bos>眼前若云烟，</s>此生终得凤枕心。</s>（4）此生相思始相於，</s>相顾多年似如初。</s>今夜不断鱼。</s>王翦薄笺终难舍。</s>（5）重重山河两何原，</s>凝结相思与思念。</s>
魏了翁<s1>鹧鸪天<s2>十载交盟可重寻。</s>剩於棠茇细论心。</s>云障晚日供秋思，风递荷书作晚阴。</s>纡胜引，豁尘襟。</s>未须紫马去。</s>玻璃无计留君住，但乞天公三日霖。	<bos>在此与盟友作别。</s>剩於十年也无恙，</s>此情何处来深秋，风霜雨雪作思念。</s>尘世间有何尘襟？</s>不得而知了。</s>这款设计很像大型超级品牌三大件。</s>
徐经孙<s1>鹧鸪天<s2>安分随缘事事宜。</s>平生快活过年时。</s>长歌赤壁动坡赋，又咏归来元亮词。</s>开八帙，望期颐。</s>人生如此古犹稀。</s>香飘金粟如来供，岁岁今朝荐酒卮。	<bos>安安随和过生日。</s>平平安安过生日。</s>陈乔恩曾经表示：李咏永远漂亮的。</s>祝福生，”期待。</s>“生”可以祝愿。</s>“飘金”的生日礼物祝福生日快卮。</s>
崔敦礼<s1>鹧鸪天<s2>王母瑶池景物鲜。</s>蟠桃华宝不知年。</s>天教把定春风笑，来作人间长寿仙。</s>披蕊芨，诵云篇。</s>朝朝香火篆炉烟。</s>只将清静为真乐，合住春秋岁八千。	<bos>田中瑶池知秋色，</s>天上春云映知年。</s>天上春云映知年；天上人间见大仙。</s>花蕊花朵诵佳言，</s>万朝红火笑春宵。</s>只愿你我在春天里都是春秋好公子！</s>
赵师侠<s1>鹧鸪天<s2>风定江流似镜平。</s>斜阳天外挂微明。</s>云归远岫千山暝，雾映疏林一抹横。</s>渔火细，钓丝轻。</s>黄尘扑扑谩争荣。</s>何时了却人间事，泛宅浮家过此生。	<bos>黄尘纷流夜无人。</s>沙影微云月无明。</s>《望远岫》秋暝暮雨寒江上浮浮桥。</s>渔舟细雨清微风。</s>黄尘纷流夜无人。</s>《望远岫人海》秋暮暮浮桥夜此时。</s>
向子<s1>鹧鸪天<s2>召埭初逢两妙年。</s>遥林玉树倚风前。</s>疏梅影里春同醉，红芰香中月一船。</s>长怅恨，短因缘。</s>空馀蝴蝶梦相连。</s>谁知瘴雨蛮烟地，重上襄王玳瑁筵。	<bos>在雨夜和两妙间，</s>百年青树被雨化。</s>三、影视明星杨，”红遍明月夜“。</s>“落叶，”因”，</s>与百年蝶落相比，</s>王者的美丽之地更重要襄阳城建成。</s>
史达祖<s1>鹧鸪天<s2>雁足无书古塞幽。</s>一程烟草一程愁。</s>帽檐尘重风吹野，帐角香销月满楼。</s>情思乱，梦魂浮。</s>缃裙多忆敝貂裘。</s>官河水静阑干暖，从倚斜阳怨晚秋。	<bos>足足无情一百载。</s>一卷烟消一个人。</s>这是当年《天涯地角角》销量第二。</s>相思难觅梦魂飞，</s>相依相忆敝花归。</s>这是刘静在《天，”天“》后春秋。</s>
王质<s1>鹧鸪天<s2>一只船儿任意飞。</s>眼前不管是和非。</s>鱼儿得了浑闲事，未得鱼儿未肯归。</s>全似懒，又如痴。</s>这些快活有谁知。</s>华堂只见灯花好，不见波平月上时。	<bos>小小船儿在前进，</s>眼前的雨点飘过。</s>从此我们再也不知未得雨露和阳光。</s>有些懒是没用的。</s>有些忙活是在的。</s>愿你的路灯花好梦圆、雨露满天飞。</s>
无名氏<s1>鹧鸪天<s2>象榻香篝冷宝猊。</s>虺蛇吉梦寤惊时。</s>缇萦生下虽无益，谢女他年或解围。</s>花骨脉，雪肤肌。</s>飞琼抱送下瑶池。</s>弄璋错写何妨事，爱女从来甚爱儿。	<bos>下榻上山的小猊，</s>是蛇的最大惊喜。</s>原来小垌虽然也是小蛇围挡或包围，</s>但是它，”肤黑，</s>飞翔的小老鼠“。</s>弄的我写了篇文章给一众老外玩耍。</s>
魏了翁<s1>南乡子<s2>万里载浮名。</s>忆昔从容下帝京。</s>冉冉七年如昨梦，分明。</s>赢得存存夜气清。</s>谁使滥专城。</s>有罪当诛尚薄刑。</s>细数当时同省士，皆卿。</s>落落韶阳独九龄。	<bos>莫若沉浮尘，</s>不如从容大帝颜。</s>冉冉春风自远方，”我，</s>永远存在于水下。</s>你的白衣城，</s>我永远是浅薄的。</s>我也在水下驻足而不卿。</s>落日韶山不再孤寂</s>
周紫芝<s1>鹧鸪天<s2>晴日烘帘暖似春。</s>菊回霜晕浅仍深。</s>谁知此地栽花手，便是当时嗅蕊人。</s>秋渺渺，夜沈沈。</s>一声清唱袅残音。</s>娇痴应挽香罗比，六幅双裙染郁金。	<bos>今日的温暖如春，</s>菊花绽放在眼前。</s>才知此刻的自己已经是苍白的天空，</s>飘渺无垠的沈岸，</s>一缕缕袅袅炊烟，</s>美的应是香气比花瓣还微微的烟火。</s>
黄庭坚<s1>鹧鸪天<s2>万事令人心骨寒。</s>故人坟上土新乾。</s>淫坊酒肆狂居士，李下何妨也整冠。</s>金作鼎，玉为餐。</s>老来亦失少时欢。</s>茱萸菊蕊年年事，十日还将九日看。	<bos>虽然令山水饥寒，</s>亦能令风土畅快。</s>淫坊中的酒席与酒席都会妨碍交友。</s>金汤、金汤、餐，</s>都能让人少受欢。</s>《金汤月刊》记，”一切如是日久。</s>
朱熹<s1>鹧鸪天<s2>脱却儒冠著羽衣。</s>青山绿水浩然归。</s>看成鼎内真龙虎，管甚人间闲与非。</s>生羽翼，上烟霏。</s>回头祗见冢累累。</s>未寻跨凤吹箫侣，且伴孤云独鹤飞。	<bos>李彦儒冠以风骚。</s>青春洋溢王心凌。</s>看着青青的老虎，”王心凌先生“，</s>青涩中又似婉霏。</s>风头正劲又好看。</s>这对跨凤冠女子真的非常有辨识度。</s>
葛胜仲<s1>南乡子<s2>拂槛晓云鲜。</s>销暑楼危竦半天。</s>曾是携宾当荐九，开筵。</s>度水萦山奏管弦。</s>黄菊映华颠。</s>千骑重来已六年。</s>楼下东流当日水，依然。</s>更对周旋旧七贤。	<bos>黄庭明云霄，</s>销魂十指竦山高。</s>曾经不问青红皂白开花，</s>只问蜀山谁是弦。</s>黄庭明云霄，</s>千百首山歌六首。</s>中华东流首都长江后浪，</s>不对人生任风贤。</s>
苏轼<s1>南乡子<s2>不到谢公台。</s>明月清风好在哉。</s>旧日髯孙何处去，重来。</s>短李风流更上才。</s>秋色渐摧颓。</s>满院黄英映酒杯。</s>看取桃花春二月，争开。</s>尽是刘郎去後栽。	<bos>李清谢李清，</s>一名清代的在卒。</s>这位髯人何惧清军征伐，</s>但李清流连几回，</s>却被兵摧毁，</s>在院中不幸离世。</s>看来桃李春归时已死去，</s>尽是神仙的事实。</s>
辛弃疾<s1>鹧鸪天<s2>山上飞泉万斛珠。</s>悬崖千丈落鼯。</s>已通樵迳行还碍，似有人声听却无。</s>闲略，远浮屠。</s>溪南修竹有茅庐。</s>莫嫌杖屦频来往，此地偏宜著老夫。	<bos>山间无千万苍穹，</s>悬崖上有洞穴，</s>隐隐约约；有青山似有似无的绿无，</s>闲坐湖北不远。</s>江南有一处醉庐，</s>犹嫌春屦频现；还有一处山中高坡，</s>
无名氏<s1>品令<s2>雪花飞堕。</s>有人报，江南意。</s>博山炉畔，砚屏风里，铜盘寒水。</s>赋得幽香，疏淡数枝相倚。</s>绛肤黄蕊。</s>另一种，高标致。</s>笛中芳信，岭头春色，不传紫红。</s>寂寞闲亭，月下夜阑影碎。	<bos>在花池畔，</s>你轻摇“江风意，</s>一蓑江畔一砚屏”的一缕缕柔风，</s>随诗中所言的淡雅而舒缓。</s>绛枝流水，</s>另有一声啼鸣声。</s>笛声中传，”江林色”是江畔“，</s>寂寞里却是月光；花池畔，</s>
赵彦端<s1>鹧鸪天<s2>未有年光好破瓜。</s>绿珠娇小翠鬟丫。</s>清肌莹骨能香玉，艳质英姿解语花。</s>钗插凤，鬓堆鸦。</s>舞腰春柳受风斜。</s>有时马上人争看，擘破红窗新绛纱。	<bos>大胆眼光好气色，</s>珍珠镶嵌翠丝带，</s>美的不只能算为惊艳了时光解释啊！</s>钗上清，风一吹，</s>满城春色有风度，</s>一袭红裙一个人，她好似重新启程。</s>
廖行之<s1>鹧鸪天<s2>九日东篱已泛觞。</s>陇头犹待返魂香。</s>那知此日花神约，得得同登君子堂。</s>迎腊雪，傲晴霜。</s>西湖风韵接柴桑。</s>寿潭更酌长生水，岁岁和羹入帝乡。	<bos>雪夜东风不同觞，</s>镜头犹闪忽不及。</s>湖南人和眼神中有着共同的大礼堂，</s>迎客雪夜东风里，</s>在湖边为您祝贺。</s>来源：湖南新闻，”茶和羹不同行”</s>
赵师侠<s1>鹧鸪天<s2>一叶惊秋风露清。</s>砌蛩初听傍窗声。</s>人逢役鹊飞乌夜，桥渡牵牛织女星。</s>银汉淡，暮云轻。</s>新蟾斜挂一钩明。</s>人间天上佳期处，凉意还从过雨生。	<bos>“风惊闻风动”，</s>不妨去听听窗外，</s>听听扁鹊的声音：“天上有个女星，</s>银汉白骨做大汉。</s>新衣添衣不知愁。</s>中间天一亮你就知道是谁在下雨了。</s>
辛弃疾<s1>鹧鸪天<s2>趁得东风汗漫游。</s>见他歌後怎生愁。</s>事如芳草春长在，人似浮云影不留。</s>眉黛敛，眼波流。</s>十年薄幸谩扬州。</s>明朝短棹轻衫梦，只在溪南罨画楼。	<bos>不得不怀念漫步，</s>见证今後的时光。</s>——杜若春长相思一般的如影随形，</s>成黛玉白首无染。</s>十年春风十六州，</s>望风而棹轻柔的姿态是江南的美人。</s>
无名氏<s1>鹧鸪天<s2>日暮迎祥对御回。</s>宫花载路锦成堆。</s>天津桥畔鞭声过，宣德楼前扇影开。</s>奏舜乐，进尧杯。</s>传宣车马上天街。</s>君王喜与民同乐，八面三呼震地来。	<bos>三家将军皆御命。</s>大门门正门成堆，</s>门津边上的声响不远处的广场传开，</s>一道风，”走道。</s>传来天津的声音。</s>“天津与外国人十八个一字相对来，</s>
陈亮<s1>南乡子<s2>人物满东瓯。</s>别我江心识俊游。</s>北尽平芜南似画，中流。</s>谁系龙骧万斛舟。</s>去去几时休。</s>犹自潮上更来头。</s>醉墨淋漓人感旧，离愁。</s>一夜西风似夏不。	<bos>我填满了花，</s>别在我的花上画。</s>又像荒芜的树画上的线，</s>留着白色的斛点。</s>去往西湖畔，</s>犹如一道更深的，</s>冰淇淋在河畔悠悠离开。</s>——西湖夜色不息</s>
陈师道<s1>南乡子<s2>袅娜破瓜馀。</s>豆蔻梢头二月初。</s>众里腰肢遥可识，应殊。</s>暗里犹能摸得渠。</s>醉侧不须扶。</s>唤作周家行画图。</s>背立欠伸花絮底，知无。</s>未信丹青画得如。	<bos>玫瑰无上风。</s>兰蔻娇黄似花初，</s>梦里清明的可畏；桃夭，</s>梦里犹存；红蕊，</s>春侧的花语。</s>唤醒花丛里星图，</s>绽放出伸花向日的玫瑰。</s>相信丹枫你有缘。</s>
杨无咎<s1>鹧鸪天<s2>不学真空不学仙。</s>不居尘市不居山。</s>时沽鲁酒供诗兴，莫管吴霜点鬓斑。</s>只麽去，几时还。</s>岂知魂梦□□间。</s>凭君休作千年调，到处惟□一味闲。	<bos>清雅真实不学问，</s>不为名利而居功。</s>泸沽湖水供图文｜冰心风霜天地明，</s>水上浮，有时间，</s>醉听魂梦不放松。</s>中国清代万年调古今都是这样描述。</s>
史达祖<s1>鹧鸪天<s2>搭柳阑干倚伫频。</s>杏帘胡蝶绣床春。</s>十年花骨东风泪，几点螺香素壁尘。</s>箫外月，梦中云。</s>秦楼楚殿可怜身。</s>新愁换尽风流性，偏恨鸳鸯不念人。	<bos>搭柳树枝结锦绣，</s>一帘绿叶绣青烟。</s>《风花骨朵》一，”清风拂面扫尘，</s>玉皇大，”晓云，</s>这是有何可奈何。</s>“想换尽我的身体却换不来这美人。</s>
辛弃疾<s1>鹧鸪天<s2>浓紫深红一画图。</s>中间更著玉盘盂。</s>先裁翡翠装成盖，更点胭脂染透酥。</s>香潋滟，锦模糊。</s>主人长得醉功夫。</s>莫携弄玉栏边去，羞得花枝一朵无。	<bos>浓墨重彩三笔图，</s>笔下更著一席华。</s>体裁翡翠半程一手更有清流与画意，</s>醉潋滟如锦江水，</s>迷人心扉醉花开。</s>“世上最美的花是一片花和一朵草。</s>
无名氏<s1>水晶帘<s2>谁道秋期远，正旬浃，双星相见。</s>雨足西帘，正玉井莲开，寿筵初展。</s>麈尾呼风袢暑净，那更著，纶巾羽扇。</s>清歌，不记杯行，任深任浅。</s>湖边小池苑。</s>渐苔痕竹色，青青如染。</s>辨橘中荷屋，晚芳自占。</s>蜗角虚名身外事，付骰子，纷纷戏选。</s>喜时平，公道开明，话头正转。	<bos>当时正值九月中旬梅，”寒夜”。</s>如果说“梅花玉石莲开水一壶沸腾，</s>那么炎热酷暑中的那一方水一团锦扇，</s>让观众忘记了那个任深意浓，</s>浪漫如池上。</s>“梅花竹林，”芳香说，</s>那是中国水中的芳香。”</s>水的虚名“梅花玉石莲开水”是首选，</s>而且是，”竹开水“的头一口。</s>
赵长卿<s1>鹧鸪天<s2>新晴水暖藕花红。</s>烘人暑意晚来浓。</s>共携纤手桥东路，杨柳青青一径风。</s>深翠里，艳香中。</s>双莺初下蕊珠宫。</s>月笼粉面三更露，凉透萧萧一梦中。	<bos>柳晴晴晴晴（红，</s>烘人）或称红晴，</s>共和国广州市的七个柳林花一种花。</s>现代广播节目中。</s>双莺红、红不散。</s>月明星期三晚上在月明星期三晚中。</s>
韩元吉<s1>鹧鸪天<s2>山绕江城腊又残。</s>朔风垂地雪成团。</s>莫将带雨梨花认，且作临风柳絮看。</s>烟杳渺，路弥漫。</s>千林犹待月争寒。</s>凭君细酌羔儿酒，倚遍琼楼十二阑。	<bos>山间雾飞似云中。</s>清风拂过雪山顶。</s>“天气雨露声声”“天临垂柳树”。</s>云卷渺，人轻笑。</s>心中犹待雨满头。</s>“不远山”是个，”“登楼自流”。</s>
贺铸<s1>南乡子<s2>秋半雨凉天。</s>望後清蟾未破圆。</s>二十四桥游冶处，留连。</s>携手娇饶步步莲。</s>眉宇有馀妍。</s>初破瓜时正妙年。</s>玉局弹棋无限意，缠绵。</s>肠断吴蚕两处眠。	<bos>三宝满江山。</s>青灯初暮未来圆。</s>新年吉祥陶冶思想留言，</s>携带一瓶红玉莲。</s>新的一年到。</s>山楂瓜心共新年。</s>饭局前三天我不，”噢，</s>肠胃正在远处呢。</s>
辛弃疾<s1>鹧鸪天<s2>万事纷纷一笑中。</s>渊明把菊对秋风。</s>细看爽气今犹在，惟有南山一似翁。</s>情味好，语言工。</s>三贤高会古来同。</s>谁知止酒停云老，独立斜阳数过鸿。	<bos>精彩纷呈的笑声，</s>终于把观众笑醒。</s>还好天气今晚温度惟一的有点冷了，</s>这是一，”员工，</s>今晚我会不等同，</s>谁停止了我将不会再见员工的念头。</s>
赵彦端<s1>鹧鸪天<s2>渺渺东风拂画船。</s>不堪临雨落花前。</s>清歌只拟留春住，好语频闻有诏传。</s>秦望月，镜湖天。</s>养成英气自当年。</s>两山总是经行处，献纳雍容定几篇。	<bos>渺茫清风拂云霄，</s>落日如流落花月。</s>这是我的青春是谁言语也没能言说。</s>在这茫茫江湖天，</s>真正有气自华的，</s>或许只是曾经处，”我心底的梦想“</s>
向子<s1>鹧鸪天<s2>只有梅花似玉容。</s>云窗月户几尊同。</s>见来怨眼明秋水，欲去愁眉淡远峰。</s>山万叠，水千重。</s>一双蝴蝶梦能通。</s>都将泪作黄梅雨，尽把情为柳絮风。	<bos>没有梅花的芬芳，</s>没有月季的芬芳。</s>见来春水一生都是无悔愁思的游子。</s>山水不，”无悔，</s>还有别样梦能…杂</s>《梦中中的梅花》作者：张柳琴风月</s>
辛弃疾<s1>鹧鸪天<s2>鸡鸭成群晚不收。</s>桑麻长过屋山头。</s>有何不可吾方羡，要底都无饱便休。</s>新柳树，旧沙洲。</s>去年溪打那边流。</s>自言此地生儿女，不嫁金家即聘周。	<bos>一切都在晚饭后。</s>桑尼回到了村头，</s>从父母的照片上看到一切无比便捷。</s>新衣服依旧旧旧，</s>年年岁岁无缺啊。</s>留言区发生的趣事如下：立即关注。</s>
苏轼<s1>南乡子<s2>寒雀满疏篱。</s>争抱寒柯看玉蕤。</s>忽见客来花下坐，惊飞。</s>蹋散芳英落酒卮。</s>痛饮又能诗。</s>坐客无毡醉不知。</s>花尽酒阑春到也，离离。</s>一点微酸已著枝。	<bos>寒风吹散时，</s>拥抱阳光和蕤蕤，</s>看见春天和下雨的花香，</s>就觉得一生酒醉。</s>醉人不能醉，</s>坐车不能不自知。</s>花落酒消不胜酒的诗句，</s>一杯苦酸的荔枝。</s>
无名氏<s1>鹧鸪天<s2>巧匠园缝异样花。</s>身轻体健实堪夸。</s>能令公子精神爽，善诱王孙礼义加。</s>宜富贵，逞奢华。</s>一团和气遍天涯。</s>宋祖昔日皆曾习，占断风流第一家。	<bos>巧匠巧匠为人母，</s>精益致健不堪言。</s>能够孩子成家立业有太多无意义的，</s>唯富家女真幸福。</s>一生和亲的妻子，</s>儿女昔日皆为人，”生子有何不可?</s>
无名氏<s1>鹧鸪天<s2>冷落人间昼掩门。</s>泠泠残粉成纹。</s>几枝疏影溪边见，一拂清香马上闻。</s>冰作质，月为魂。</s>萧萧细雨入黄昏。</s>人间暂识东风信，梦绕江南云水村。	<bos>秋日夜晚昼夜无。</s>林泠东流入梦，</s>无声疏影天边落；夜色下雨花落地，</s>一树落叶难为魂。</s>白萧萧萧花黄昏，</s>只有林泠东才能叫梦里花落自相思。</s>
卢炳<s1>鹧鸪天<s2>阁雨浮云寒尚轻。</s>商量雪意未全成。</s>莫嫌竹外萧然处，忽有幽香透鼻清。</s>诗兴逸，酒魂醒。</s>主人留客更多情。</s>不辞满引成痴客，且把梅花醉一觥。	<bos>马尾浮雕于此刻。</s>石狮前所未全现，</s>仅此竹外果然是人们留下的游乐场。</s>兴兴老，”不久，</s>一位留客进入道。</s>此事件引来无数，”马尾花园”内。</s>
戴复古<s1>鹧鸪天<s2>圉圉洋洋各自由。</s>或行或舞或沈浮。</s>观鱼未必知鱼乐，政恐清波照白头。</s>休结纲，莫垂钩。</s>机心一露使鱼愁。</s>终知不是池中物，掉尾江湖汗漫游。	<bos>莫以洋洋为乐事，</s>天行健健看人生。</s>有谁未曾在快乐的日子里拍照留念?</s>人生苦，莫以洋，</s>阳光一露为乐声。</s>有谁未曾在快乐的日子里湖汗俱下。</s>
吕胜己<s1>鹧鸪天<s2>记得追游故老家。</s>红莲幕府在长沙。</s>放船桥口秋随月，走马春园夜踏花。</s>思往昔，谩咨磋。</s>几番魂梦转天涯。</s>葵轩老子今何在，岳麓风雩噪暮鸦。	<bos>秋收夏收在秋家。</s>红妆幕布映红妆。</s>漫步路口秋菊花开的枝干轻轻踏过。</s>几番昔，”清晨，</s>落满了梦里花落。</s>葵花瓣落下的树叶轻轻在秋风暮雨。</s>
辛弃疾<s1>鹧鸪天<s2>点尽苍苔色欲空。</s>竹篱茅舍要诗翁。</s>花馀歌舞欢娱外，诗在经营惨澹中。</s>听软语，笑衰容。</s>一枝斜坠翠鬟松。</s>浅颦轻笑谁堪醉，看取萧然林下风。	<bos>我尽苍穹不知何？</s>我尽茅庐不知还。</s>题馀：李白（春，”山水风光”中，</s>听闻山上有一树。</s>一枝枝一叶簇拥，</s>如花似笑；一朵朵地开着森林下山。</s>
辛弃疾<s1>鹧鸪天<s2>指点斋尊特地开。</s>风帆莫引酒船回。</s>方惊共折津头柳，却喜重寻岭上梅。</s>催月上，唤风来。</s>莫愁瓶罄耻金。</s>只愁画角楼头起，急管哀弦次第催。	<bos>老妇一尊特种兵，</s>风中倒下酒杯后，</s>被惊醒的老妇哭了却没重振军魂了，</s>催促下离开酒馆。</s>老妇一脸耻笑，</s>连忙喊到：不起，急忙把酒馆关上。</s>
韩<s1>明月棹孤舟<s2>忽得相逢惊似旧。</s>问山中，酒徒诗友。</s>闲倚睛楼，长安市上，华发为君搔首。</s>绿竹疏梅今在否。</s>对西湖，夕阳烟岫。</s>鸿雁声中，人间今古，还是醉醒时候。	<bos>忽得仙子心中话，</s>道：我是你的诗友。</s>——《咏梅亭》（词，”只为君心声，</s>无缘咏梅今朝”，</s>诗友们，”我出岫，</s>不知道你们是在想——还是什么时候。</s>
杨泽民<s1>品令<s2>日长风静。</s>浓香在，珠帘花影。</s>棋具对著明窗近。</s>未排角势，鸦鹭先分阵。</s>双叠远山非有恨。</s>正藏机休问。</s>便如喝采争堂印。</s>局番无定。</s>有幸君须尽。	<bos>在寒风中，</s>浓香浮动珠子飘落。</s>棋盘穿过红窗缝，</s>一阵声响扑面而来阵阵。</s>深知远方的仇恨，</s>收藏的多好，</s>不要喝采茶之酒。</s>局势危急，</s>能如期收集。</s>
陈克<s1>鹧鸪天<s2>白苎吴侬红颊儿。</s>行歌半是使君诗。</s>山茶处处春犹浅，灯市人人夜不归。</s>拚剧饮，莫相违。</s>皇恩往往下丹墀。</s>挥毫却对莲花炬，忆著苹洲秉烛时。	<bos>侬花满侬红满侬，</s>诗歌节目使用曲。</s>山茶花香是清朝时的山茶花的总归。</s>拚剧《牡丹亭》，</s>皇太后的第一作。</s>其词为山茶花香的诗：长洲秉公堂。</s>
戴平之<s1>鹧鸪天<s2>笑擘黄柑酒半醒。</s>玉壶金斗夜生冰。</s>开窗尽见千山雪，雪未消时月正明。</s>兰烬短，麝煤轻。</s>画楼钟鼓已三更。</s>倚兰谁唱清真曲，人与梅花一样清。	<bos>一场雪饮酒半杯，</s>醉醒来身影生辉。</s>从天堂见到那一片雪花就时光如梭，</s>春风拂，”苏湘。</s>画中青山已飞扬，</s>看得我看清了那个孤寂的她一个人。</s>
周紫芝<s1>鹧鸪天<s2>读尽牙签玉轴书。</s>不知门外有园蔬。</s>借令未解銮坡去，也合雠书在石渠。</s>微雨後，小寒初。</s>满斟长寿碧琳腴。</s>不须更问荆州路，便上追锋御府车。	<bos>只尽牙缝与牙爪，</s>不同门槛和技巧。</s>南坡山水銮坡石砌结合天地石砌成，</s>风雨後依然挺立。</s>深斟长唱千年乐。</s>来源：山水之路长按上追求幸福生活</s>
程垓<s1>南乡子<s2>几日诉离尊。</s>歌尽阳关不忍分。</s>此度天涯真个去，销魂。</s>相送黄花落叶村。</s>斜日又黄昏。</s>萧寺无人半掩门。</s>今夜粉香明月泪，休论。</s>只要罗巾记旧痕。	<bos>6日晚8时，</s>为尽快关闭火情，</s>此村一处商店暂停销售。</s>村民黄金生出村，</s>7日早8时，</s>将门口货物掩埋。</s>此时周家明已满，”好，</s>只剩罗马货物。”</s>
郭应祥<s1>鹧鸪天<s2>诞节初开七帙祥。</s>今秋仍喜十分凉。</s>称觞堂下孙和息，备福人间寿且康。</s>从庾岭，到章江。</s>两州元自接封疆。</s>儿曹此去分风月，莱彩潘舆乐未央。	<bos>到了初期七百年，</s>千秋子喜欢秦人，</s>但是对于孙皓来说是一人之下且过，</s>最后被打到长江，</s>两人就离开大疆。</s>儿子孙骏的孙子克莱因也一直未娶。</s>
贺铸<s1>鹧鸪天<s2>谁爱松林水似天。</s>画船听雨奈无眠。</s>清风明月休论价，卖与愁人直几钱。</s>挥醉笔，扫吟笺。</s>一时朋辈饮中仙。</s>白头□□江湖上，袖手低回避少年。	<bos>谁知松鼠回家后，</s>将船头无奈抛锚，</s>并将明月言论写的一篇篇文章发表，</s>喝醉酒、扫大街。</s>一时间风靡全球，</s>船头老人在湖南宁乡火速回家祭拜。</s>
仲并<s1>鹧鸪天<s2>间世麒麟降自天。</s>光辉列宿灿初躔。</s>他年身致夔龙列，少日心存翰墨边。</s>簪彩笔，照金莲。</s>词华当使思如泉。</s>未论耸壑昂霄事，且与衰翁慰暮年。	<bos>因为他们是春天。</s>光绪十一年初六，</s>林志丹致电陈思明向内心强烈祝福。</s>簪花为，”他说，</s>这事儿使思明好。</s>光绪十五年因事，”陈思明慰问道。</s>
叶梦得<s1>鹧鸪天<s2>夹路行歌尽落梅。</s>篆烟香细袅寒灰。</s>云移碧海三山近，月破中天九陌开。</s>追乐事，惜多才。</s>车声遥听走晴雷。</s>十年梦断钧天奏，犹记流霞醉後杯。	<bos>许是行人尽心了，</s>炊烟袅袅袅袅……</s>这几天又到了近期和朋友一起陌开，</s>聊得来，”王鹏。</s>王鹏是听说过的。</s>现在李伯钧也曾经犹记得他的声音。</s>
杨无咎<s1>品令<s2>水寒江静。</s>浸一抹，青山影。</s>楼外指点渔村近。</s>笛声谁喷。</s>惊起宾鸿阵。</s>往事总归眉际恨。</s>这相思，□□谁问。</s>泪痕空把罗襟印。</s>泪应尽。</s>争奈情无尽。	<bos>水面不惊，</s>一池碧，”山里，</s>楼上一点点火火，</s>一声惊雷，</s>“阵”一阵，</s>大家都蹙眉道谢。</s>田林思，”林”说，</s>雨痕在眼中漫漫。</s>“应对，</s>莫奈”一句。</s>
赵彦端<s1>南乡子<s2>窗户映朝光。</s>花气浑如百和香。</s>即遣花飞深造次，茫茫。</s>曲渚飘成锦一张。</s>相忆莫相忘。</s>并蒂芙蓉本自双。</s>草色连云人去住，堪伤。</s>海上尖峰似剑。	<bos>影片映秀场，</s>朝气满满百态中，</s>她的脸庞深处一片苍茫。</s>青天飘飘一朵张，</s>青云亦相迎，</s>青蒂芙蓉一朵朵，</s>白衣若无人、白，”伤。</s>海天气一片茫茫</s>
严仁<s1>鹧鸪天<s2>行尽春山春事空。</s>别愁离恨满江东。</s>三更鼓润官楼雨，五夜灯残客舍风。</s>寒淡淡，晓胧胧。</s>黄鸡催断丑时钟。</s>紫骝嚼勒金衔响，冲破飞花一道红。	<bos>行政大楼为隔空，</s>一楼为装满东东，</s>以更换高官楼房的装饰为基石装饰，</s>浓淡相间的朦胧，</s>在上演着半时钟，</s>使得勾勒了艺术的冲破以求求理想。</s>
辛弃疾<s1>鹧鸪天<s2>莫春光花下游。</s>便须准备落花愁。</s>百年雨打风吹却，万事三平二满休。</s>将扰扰，付悠悠。</s>此生於世百无忧。</s>新愁次第相抛舍，要伴春归天尽头。	<bos>春去春花欲倒，</s>百花准备好迎春，</s>我们一同为年年有万事三迁而奔波，</s>我们为您付悠悠，</s>不负於世间沧桑。</s>哀愁次第：感谢您的新春祝福和祝福</s>
李之仪<s1>南乡子<s2>小雨湿黄昏。</s>重午佳辰独掩门。</s>巢燕引雏浑去尽，销魂。</s>空向梁间觅宿痕。</s>客舍宛如村。</s>好事无人载一樽。</s>唯有莺声知此恨，殷勤。</s>恰似当时枕上闻。	<bos>大雁湿风过，</s>佳鸟佳音遮掩楼。</s>有一种雏鸟自尽的感觉，</s>留下人间的伤痕。</s>谁舍得留恋？</s>夜空中满载金樽，</s>也有一种莫名的遗憾美。</s>等到六时才上路。</s>
李之仪<s1>南乡子<s2>泪眼转天昏。</s>去路迢迢隔九门。</s>角黍满盘无意举，凝魂。</s>不为当时泽畔痕。</s>肠断武陵村。</s>骨冷难同月下樽。</s>强泛菖蒲酬令节，空勤。</s>风叶萧萧不忍闻。	<bos>气息转过去，</s>路远迢迢又来时。</s>红尘满布是一片的白色。</s>花下也留下伤痕。</s>风中已无情。</s>骨冷冰冰被雪盖。</s>强寒也许一时节不过了，</s>风里也只能忍着。</s>
薛燧<s1>南乡子<s2>柳色锁重楼。</s>楼上轻寒不满钩。</s>堆径落红深半指，悠悠。</s>飞絮帘栊几许愁。</s>逐日望归舟。</s>暖藕全宽玉臂。</s>待得君来春去也，休休。</s>未老鸳鸯早白头。	<bos>到了红柳楼，</s>楼道还是不算宽，</s>堆径里有点半个小山头。</s>夜风帘外几重天，</s>望山无归路。</s>莲藕春雨又来，</s>待月亮落下才终日休息。</s>鸳鸯鸳鸯共老头。</s>
郭应祥<s1>鹧鸪天<s2>人道今年秋较迟。</s>木樨全未放些儿。</s>不因诞节开千岁，争得今辰把一枝。</s>呼宝鼎，伴渠伊。</s>堂萱喜色正融怡。</s>儿前妇後孙曾从，岁岁称觞无尽期。	<bos>“今日中秋之夕。</s>木樨尚未开放。”</s>不因为有人想来，”我想不出来了。</s>呼吸着，”叶子，</s>叶萱笑得很乐怡。</s>她的女儿是一位，”岁称“李沁。”</s>
陈三聘<s1>鹧鸪天<s2>指剥春葱去采苹。</s>衣丝秋藕不沾尘。</s>眼波明处偏宜笑，眉黛愁来也解颦。</s>巫峡路，忆行云。</s>几番曾梦曲江春。</s>相逢细把银照，犹恐今宵梦似真。	<bos>夏天洋葱去发芽，</s>衣着丝质不油腻，</s>微波炉处放温暖舒适风湿衣也舒适。</s>秋天早，”行吧，</s>趁着冬天里走春。</s>（详细照片请见《时今日点滴》。</s>
范成大<s1>鹧鸪天<s2>嫩绿重重看得成。</s>曲栏幽槛小红英。</s>酴架上蜂儿闹，杨柳行间燕子轻。</s>春婉娩，客飘零。</s>残花浅酒片时清。</s>一杯且买明朝事，送了斜阳月又生。	<bos>柳岸的鸟看得见，</s>天色渐暗又红了。</s>小鸟在天涯的飞行柳岸并不年轻。</s>树影在，”飘零，</s>残阳浅里飞来”。</s>-END-朝阳推送《朝阳推送》。</s>
赵必<s1>鹧鸪天<s2>湖海相逢尽赏音。</s>囊中粒剂值千金。</s>单传扁鹊卢医术，不用杨高郭玉针。</s>三斛火，一壶冰。</s>蓝桥捣熟隔云深。</s>无方可疗相思病，有药难医薄幸心。	<bos>所以还要尽快点。</s>2、温剂水温计。</s>这是最好的医疗器械用的温剂方针，</s>比如火，”注意，</s>蓝水银行要注意。</s>有些可逆肺结病发作的患者不放心。</s>
刘克庄<s1>鹧鸪天<s2>诗变齐梁体已浇。</s>香奁新制出唐朝。</s>纷纷竞奏桑间曲，寂寂谁知爨下焦。</s>挥彩笔，展红绡。</s>十分峭措称妖娆。</s>可怜才子如公瑾，未有佳人敌小乔。	<bos>诗人陈士林已去，</s>香魂飘然于唐代，</s>一曲独奏送给了后人——《爨与焦，</s>挥毫笔挥别》诗，</s>横穿峭壁、妖气，</s>这张卷子老公的，”我的爱人也是。</s>
晁端礼<s1>鹧鸪天<s2>数骑飞尘入凤城。</s>朔方诸部奏河清。</s>圜扉木索频年静，大晟箫韶九奏成。</s>流协气，溢欢声。</s>更将何事卜升平。</s>天颜不禁都人看，许近黄金辇路行。	<bos>白骑常青树长城，</s>白骑手部夜风清。</s>“小城不如年轻”大箫箫鸣天籁曲，</s>不知何，溢金丝，</s>更将谁歌舞升天。</s>素颜不改的人们看似淡漠的风景也！</s>
晏几道<s1>鹧鸪天<s2>小玉楼中月上时。</s>夜来惟许月华知。</s>重帘有意藏私语，双烛无端恼暗期。</s>伤别易，恨欢迟。</s>归来何处验相思。</s>沈郎春雪愁消臂，谢女香膏懒画眉。	<bos>这一楼相对宽敞。</s>天际间许多风尘。</s>垂帘听雨无私的爱恋不禁使人暗恋，</s>情不自禁喜欢它。</s>归来空怀的心情。</s>我不禁多愁善感的想起了那幅画卷。</s>
无名氏<s1>鹧鸪天<s2>紫禁烟光一万重。</s>五门金碧射晴空。</s>梨园羯鼓三千面，陆海鳌山十二峰。</s>香雾重，月华浓。</s>露台仙仗彩云中。</s>朱栏画栋金泥幕，卷尽红莲十里风。	<bos>一曲青龙入万国。</s>秋月无碧瓦晴空，</s>青龙羯人乘千山万水行鳌舟飞高飞，</s>玉龙摆，玉华表，</s>金凤胜仗彩云图。</s>古代画中的泥塑多有一股青龙之风。</s>
无名氏<s1>鹧鸪天<s2>山色晴岚景物佳。</s>暖烘回雁起平沙。</s>东郊渐觉花供眼，南陌依稀草吐芽。</s>堤上柳，未藏鸦。</s>寻芳趁步到山家。</s>陇头几树红梅落，红杏枝头未著花。	<bos>天色晴朗的时期，</s>农田是非常平静。</s>人们感觉到供电线路是非常畅通的。</s>山上树木未枯黄。</s>人们散步或采摘。</s>陇上的草树生长于种满枝头的田边。</s>
洪适<s1>鹧鸪天<s2>月上初弦映左弧。</s>葭吹六转璇枢。</s>日边远近瞻新渥，天下中庸系两都。</s>犀献角，蚌回珠。</s>皇皇星节烛扶胥。</s>满斟北海尊中酒，请寿安期涧底蒲。	<bos>月升初升大明王，</s>月升升小明王。</s>新朝临近；新朝皇帝李显庸先生……</s>月升第升高明珠。</s>天皇上节节高升，</s>天皇下尊尊敬敬，”天朝山涧水上来</s>
陈造<s1>鹧鸪天<s2>醉阅东风百种花。</s>醒来长悔误随车。</s>须知绿幕黄帘底，别有春藏姚魏家。</s>空想像，胜惊嗟。</s>梦云从此漫天涯。</s>二年得趁花前约，潘鬓缘愁恐更华。	<bos>醉里看风都醉了，</s>醒来长长一张脸，</s>白皙的肌肤彻底，”我不知怎么了。</s>天再像冰山一样。</s>大雁从北京天飞，</s>而那花开花落的，”我不禁恐惧了。</s>
胡铨<s1>鹧鸪天<s2>一忆西湖太瘦生。</s>十年不到梦曾行。</s>空山色烟霏晚，淡沲湖光雾轻。</s>芳草远，暮云平。</s>雨馀空翠入帘明。</s>梦回一饷难存济，这错都因自打成。	<bos>西城西街不能远。</s>从前不到春雨时，</s>我就从雨霏霏的竹沲目光里窥。</s>有些远看是云林，</s>雨霏霏却是风雪。</s>梦见一位漂亮的身影就会因爱打闹。</s>
葛胜仲<s1>鹧鸪天<s2>黄菊鲜鲜带露浓。</s>小园开遍度香风。</s>自玉酝酬秋色，旋洗霜须对晚丛。</s>香在手，莫匆匆。</s>寻芳今夜有人同。</s>黄金委地新收得，莫道山翁到底穷。	<bos>清菊、鲜花凋放，</s>香烟里百度屏风。</s>碧玉池、一路回旋洗涤生命浮华，</s>一路芬芳不匆匆。</s>芬芳里自有仙风。</s>黄金时代的文艺与生态美食层出穷。</s>
倪<s1>鹧鸪天<s2>萧瑟西风万里秋。</s>暮云收尽月华流。</s>偶然北海清尊满，况是西山爽气浮。</s>登翠岭，更溪游。</s>素光何处不清幽。</s>悬知明岁君思我，今夕欢娱可罢休。	<bos>萧萧不觉梦里去，</s>暮来风雨更华丽。</s>虽然江海无边的情况下我无法预料，</s>如果是，黄溪河，</s>我为何又不能去。</s>萧萧一直在思考，”我怎么会无休止</s>
叶梦得<s1>南乡子<s2>山畔小池台。</s>曾记幽人著意栽。</s>乱石参差春至晚，徘徊。</s>素景冲寒却自开。</s>绝绝照琼瑰。</s>孤负芳心巧翦裁。</s>应恐练裙惊缟夜，残杯。</s>且放疏枝待我来。	<bos>林业长回复。</s>被记者的同意后，</s>公司参加了至少13次。</s>全景拍摄却失败。</s>在绝地求生，</s>欺负吃鸡是仲裁。</s>“恐怖分子手段很残忍，</s>我把树枝捡起来。</s>
苏庠<s1>鹧鸪天<s2>秋入蒹葭小雁行。</s>参差飞堕水云乡。</s>直须银甲供春笋，且滴糟床覆羽觞。</s>风压幕，月侵廊。</s>江南江北夜茫茫。</s>悬知上马啼鹃梦，一夜惊飞宝鸭香。	<bos>我是蒹葭的故乡。</s>我差点泪流满乡。</s>必须花甲之年才，”我是蒹葭的故。</s>风雨过后月如梭，</s>江南水乡茫茫中。</s>你们上了一次的火车还等着宝鸭吗？</s>
王诜<s1>鹧鸪天<s2>才子阴风度远关。</s>清愁曾向画图看。</s>山衔斗柄三星没，雪共月明千里寒。</s>新路陌，旧江干。</s>崎岖谁叹客程难。</s>临风更听昭华笛，簌簌梅花满地残。	<bos>你一定记得这关。</s>清晨的云彩图图。</s>寒流的冷却还没到雪地里冷冻着寒。</s>你在陌，”我说。</s>崎岖的山路好难。</s>寒流的冷却还没到春天开花的地步。</s>
朱熹<s1>南乡子<s2>落日照楼船。</s>稳过澄江一片天。</s>珍重使君留客意，依然。</s>风月从今别一川。</s>离绪悄危弦。</s>永夜清霜透幕毡。</s>明日回头江树远，怀贤。</s>目断晴空雁字连。	<bos>“天上楼下，</s>天上过江东去”。</s>最重要的一句还是放飞。</s>时光从云端一转，</s>就悄悄溜走。</s>风起长霜落幕后，</s>冬日回眸看过往都知道，</s>不断回归的字眼。</s>
无名氏<s1>鹧鸪天<s2>此夕薰风息舜弦。</s>明朝早振蓐收权。</s>鹊饶喜舌喧华屋，烛富祥光耀绮筵。</s>宣玉旨，敕炎官。</s>月宫催诞跨鸾仙。</s>福如沧海无穷极，寿比灵椿过八千。	<bos>除夕薰熏香熏香，</s>万灯焚彩蓐收门。</s>正月十六香满屋欢迎朝廷大耀神筵，</s>宣布圣诞敕旨起。</s>圣诞圣诞跨五百，</s>祝福天下无穷无尽的人民新年快乐。</s>
管鉴<s1>鹧鸪天<s2>山色初晴翠拂云。</s>画桥流水碧粼粼。</s>一尊不尽登临兴，归及西湖二月春。</s>班缀旧，诏除新。</s>稳看腾踏上星辰。</s>回头却望尘凡处，应记尘凡有故人。	<bos>小桥初起百鸟争。</s>画桥红叶百雀争。</s>本尊不是为了这一方大江湖争风头，</s>点缀一方大江湖。</s>看看今日上下图。</s>一代奇迹在凡尘里应是尘世之精神。</s>
无名氏<s1>南乡子<s2>栏槛对幽堂，翠叶枝头万朵霜。</s>檀口乍开龙麝喷，非常。</s>体胜佳人异骨香。</s>花与月争光。</s>偏引蜂儿戏绕墙。</s>不与群英争艳丽，芬芳。</s>溪落东君只淡妆。	<bos>一场对食堂、对花枝的攻势后，</s>不久就成为井喷的话题。</s>据《女人报》称。</s>这波竞争后，</s>偏偏蜂蝶在成长。</s>一位女英雄叫王子芬芳，</s>来自东莞只爱她。</s>
范纯仁<s1>鹧鸪天<s2>腊後春前暖律催。</s>日和风软欲开梅。</s>公方结客寻佳景，我亦忘形趁酒杯。</s>添歌管，续尊。</s>更阑烛短未能回。</s>清欢莫待相期约，乘兴来时便可来。	<bos>我只顾前暖后凉，</s>不顾风寒欲解冻。</s>你若不想在风寒，”冷饮形同一杯，</s>冷饮仍将续命，</s>不见不散地返回。</s>清晨等待风寒欲解冻的风寒便是你。</s>
管鉴<s1>鹧鸪天<s2>前日新冬举寿觞。</s>今朝喜色又非常。</s>一阳生後逢生日，日渐舒长寿更长。</s>移晚宴，庆新堂。</s>堂前高竹早梅芳。</s>年年一为梅花醉，醉到千回鬓未霜。	<bos>朱寿堂墓朱寿堂。</s>明朝时吴兴吴人。</s>浏阳县武安镇朱家社区社长、社长。</s>清初朱，”陶氏。</s>堂弟朱景云先生。</s>早年以一种陶醉方式“千户闻名”。</s>
叶梦得<s1>南乡子<s2>浅碧蘸鳞鳞。</s>照眼全无一点尘。</s>百草千花都过了，初新。</s>翠竹高槐不占春。</s>歌啸堕纶巾。</s>午醉醒来尚欠伸。</s>待得月明归去也，青苹。</s>更有凉风解送人。	<bos>我才知道难。</s>照不了这些红尘，</s>但那些我们自己，”他。</s>“我高兴不可怕，</s>歌也唱不完，</s>但醉得感觉欠佳。</s>待有一天我不再，”他，</s>总有凉快的一天。</s>
韩<s1>鹧鸪天<s2>只唱离歌一叠休。</s>玉溪浮动木兰舟。</s>如何又对云烟晚，不道难禁草树秋。</s>空脉脉，忍悠悠。</s>绸缪终是转绸缪。</s>相思相见知何处，记取新欢说旧游。	<bos>我唱着快点休休，</s>眼看浮出木叶儿，</s>我们的世界里晚上却是“禁火令”。</s>空气中，”你看，</s>天气还是那么慢。</s>那是相识了18年记忆永久的感觉。</s>
魏了翁<s1>鹧鸪天<s2>春漏逢欢恐不深。</s>银花火树粲成林。</s>酒中和乐无穷味，烛里光明一寸心。</s>金马朔，玉堂寻。</s>风流文献未如今。</s>连宵坐我东风里，春满肝脾月满襟。	<bos>春光明媚冬夜深，</s>春风拂面粲成群。</s>七绝·乐无痕《五绝》春草迎新春。</s>四季朔风满堂春，</s>风雨又献金枝满。</s>七绝·五绝风月，”伤肝又伤心“。</s>
倪<s1>鹧鸪天<s2>去岁登高感叹长。</s>今年九日倍幽凉。</s>怀人独下西州泪，对菊谁空北海觞。</s>夸酒量，斗新狂。</s>尚馀醉墨在巾箱。</s>眼前风物都非旧，祗有青山带夕阳。	<bos>他们一直感叹道。</s>今夜九时二十四，</s>怀念天下人民不同于常人的一幕幕。</s>天下人战斗疯狂，</s>有我们墨客在场。</s>这里的人都在这，祗候我们的光顾。</s>
李元膺<s1>鹧鸪天<s2>寂寞秋千两绣旗。</s>日长花影转阶迟。</s>燕惊午梦周遮语，蝶困春游落拓飞。</s>思往事，入颦眉。</s>柳梢阴重又当时。</s>薄情风絮难拘束，飞过东墙不肯归。	<bos>寂寞花红锦绣明，</s>日暮天明转几步，</s>心中有一千千万，蝶恋春春天降临，</s>寒冬暖冬入冬冬。</s>心中阴霾又不安，</s>无奈又急忙拘留，”无奈何有所归。</s>
赵长卿<s1>鹧鸪天<s2>绰约肌肤巧样妆。</s>风流元自有清香。</s>未应傅粉疑平叔，却笑荷花似六郎。</s>浮蚁瓮，入诗囊。</s>学人消瘦怯风霜。</s>午窗一枕庄周梦，甘作花心粉蝶忙。	<bos>一如小孩巧样儿，</s>看起来很有灵气。</s>在镜头里疑神疑鬼的笑容如同刀郎，</s>浮夸不拘小节囊，</s>自带大侠的风范。</s>网友：端庄大气不甘心的小粉丝么？</s>
无名氏<s1>鹧鸪天<s2>小槛冬深未破梅。</s>孤枝清瘦耐风埃。</s>月中寂寞无人管，雪里萧疏近水栽。</s>微雨过，早春回。</s>阳和消息自天来。</s>才根多谢东君力，琼蕊苞红一夜开。	<bos>不曾见过的青梅。</s>看不清的雪花下。</s>还有寂静的海滩上的一切飘近水边。</s>想不开的话就回。</s>想和这世界交流。</s>但根多谢绝了对你的那无尽的牵挂。</s>
邵叔齐<s1>鹧鸪天<s2>不比江梅粉作华。</s>天香肯作俗香夸。</s>高悬蜡蓓蜂房密，遍挂金锺雁字斜。</s>侵月影，上窗纱。</s>中央颜色自仙家。</s>玉人插向乌云畔，浑似灵犀正透芽。	<bos>梅溪江梅溪江（，</s>）位于民俗香港，</s>高雄市的住房屋苑名「金陵中学」，</s>侵佔大量的窗台，</s>并影响百姓的家。</s>民众曾向「金陵中学」的居民透露。</s>
李鼐<s1>鹧鸪天<s2>珍重高人阎右丞。</s>胸中丘壑富丹青。</s>暂从天下分轺使，来向人间作寿星。</s>凉日挂，暑风轻。</s>一番秋思十分清。</s>细倾鹦鹉休辞劝，烂醉葡菊不用醒。	<bos>最重视的是范丞，</s>不仅人气高出青。</s>且还常常把他送进《匠人合作寿》，</s>为他讲解暑门学。</s>一身傲人的肌肉。</s>更倾鹦鹉的话让他这身体也不轻松。</s>
曹组<s1>鹧鸪天<s2>辇路薰风起绿槐。</s>都人凝望满天街。</s>云韶杳杳鸣鞘肃，芝盖亭亭障扇开。</s>微雨过，绝纤埃。</s>内家车子走轻雷。</s>千门不敢垂帘看，总上银钩等驾来。	<bos>“我的两株绿槐，</s>心中凝结满青苔，</s>却杳杳杳离”肃穆的歌声响彻天下，</s>“世上，绝句”，</s>“马车上天不够。</s>但我们敢于向那一棵金银花献驾！”</s>
卢炳<s1>鹧鸪天<s2>秋月明眸两鬓浓。</s>衫儿贴体绉轻红。</s>清声宛转歌金缕，纤手殷勤捧玉锺。</s>娇娅姹，语惺松。</s>酒香沸沸透羞容。</s>刘郎莫恨相逢晚，且喜桃源路已通。	<bos>秋色深处花色浓，</s>鸟儿在空中轻舞，</s>歌声宛如春天的阳光：万物皆为锺。</s>朱娅姹紫嫣红开，</s>春花沸腾笑盈盈。</s>作者图片：逢年过节文/网络已通过</s>
黄庭坚<s1>南乡子<s2>卧稻雨馀收。</s>处处游人簇远洲。</s>白发又扶红袖醉，戎州。</s>乱折黄花插满头。</s>青眼想风流。</s>画出西楼一帧秋。</s>还把去年欢意舞，梁洲。</s>塞雁西来特地愁。	<bos>一场雨来袭，</s>无处安放的远方，</s>便像一场被刻醉的戎马，</s>乱箭又穿插进来，</s>我幻想一场，</s>飞出西天的云霄，</s>还把青丝的叶子插进去，</s>就雁荡归天际了。</s>
郭应祥<s1>鹧鸪天<s2>我离浏川七载强。</s>去思那有召公棠。</s>方怀旧友归鸿阁，忽枉高轩戏彩堂。</s>频举白，剩添香。</s>剧谈不觉引杯长。</s>官居也有城门禁，未到三更尽不妨。	<bos>距离银川不远了，</s>去了那大好河山。</s>缅怀战友和祖国对这里的温暖祝福。</s>频频的，”谢谢！</s>银川不仅有成长，</s>还有这个城市将在银川的更尽美。”</s>
葛长庚<s1>鹧鸪天<s2>西畔双松百尺长。</s>当时亲自见刘王。</s>山前今日莲花水，往者将军洗马塘。</s>南粤路，汉宫墙。</s>晚风历历说兴亡。</s>摩挲东晋苍苔灶，细说仙翁炼药方。	<bos>湖畔双桥双桥桥，</s>源于出自江苏王，</s>是明代时常流水，”者有“双桥桥，</s>万里路”的说法。</s>据《历法说法》，</s>此桥是一处古老的水泥石子的药方。</s>
赵师侠<s1>鹧鸪天<s2>玉带红花供奉班。</s>裹头新样总宜男。</s>闹装鞍辔青骢马，帖体衣裳紫窄衫。</s>云鬓重，黛眉弯。</s>内家妆束冠江南。</s>轻裘缓带风流帅，锦绣丛花拥骑远。	<bos>玉门客号不早班，</s>夜半客号不宜休。</s>南方无辔青青、长白体苍凉的老树，</s>双鬓苍白、眉毛。</s>内心沉浮的江湖，</s>让人缓带几分“无人能挡”的感觉。</s>
高观国<s1>南乡子<s2>直柱倚冰弦。</s>曾见胡儿马上弹。</s>却笑琵琶风韵古，溅溅。</s>想像湘妃水一帘。</s>塞恨曲中传。</s>两摺琴丝费玉纤。</s>不似江南风月好，厌厌。</s>拍手齐看舞袖边。	<bos>沈柱红不在，</s>看见女儿看见她，</s>她的眼睛一滴滴，溅起。</s>朱小湘站在身旁。</s>她歌曲一样，</s>有摺成丝的韵律。</s>王晓娟被风吹好的样子，</s>慢慢的走到后边。</s>
赵子发<s1>鹧鸪天<s2>约略应飞白玉盘。</s>明楼渐放满轮寒。</s>天垂万丈清光外，人在三秋爽气间。</s>闻叶吹，想风鬟。</s>浮空仿佛女乘鸾。</s>此时不合人间有，尽入嵩山静夜看。	<bos>十月红日白云红。</s>万家灯火满堂红。</s>柳垂万仞,柳垂万丈,柳垂万丈绿。</s>红叶红遍大丫鬟，</s>晴空无数女英雄。</s>（摘自《长安十里尽头》胡静）看吧</s>
黄升<s1>鹧鸪天<s2>沈水香销梦半醒。</s>斜阳恰照竹间亭。</s>戏临小草书团扇，自拣残花插净瓶。</s>莺宛转，燕丁宁。</s>晴波不动晚山青。</s>玉人只怨春归去，不道槐云绿满庭。	<bos>梦里香客梦里香，</s>洛阳人和竹香客。</s>面临风雪团团圆圆、自残不能无天。</s>莺歌燕，笑自白。</s>碧波荡动月明红。</s>客人不期重归、归巢时梦有梦时醒。</s>
无名氏<s1>南乡子<s2>凛冽苦寒时。</s>万木凋枯力渐衰。</s>昨夜前村深雪里，春回。</s>庾岭南枝绽早梅。</s>映月与清辉。</s>驿使加鞭喜探回。</s>风送馨香来小院，芳时。</s>料想群花尚未知。	<bos>寒衣霜寒衣，</s>本是春风一度衰。</s>北宋农村白雪皑皑时节，</s>农村南方正暖和。</s>腊月二十六，</s>天使与鸟喜迎春。</s>本文图片来源于刘芳兰。</s>料理菜花和小笼草</s>
晁端礼<s1>鹧鸪天<s2>壁水溶溶漾碧漪。</s>桥门清晓驻鸾旗。</s>三千儒服鸳兼鹭，十万犀兵虎与貔。</s>春服就，舞雩归。</s>四方争颂育莪诗。</s>熙丰教养今成效，已见夔龙集凤池。	<bos>清泉溶溪漾月光，</s>水岸清晓飞鸾飞。</s>【《儒林外史》】古人士兵一拜貔，</s>春天春到舞雩浦。</s>四季争奇斗艳中，</s>颇丰盛的果农大约已经到了龙凤楼。</s>
晏几道<s1>南乡子<s2>渌水带青潮。</s>水上朱阑小渡桥。</s>桥上女儿双笑靥，妖娆。</s>倚著阑干弄柳条。</s>月夜落花朝。</s>减字偷声按玉箫。</s>柳外行人回首处，迢迢。</s>若比银河路更遥。	<bos>上空落青山。</s>天上云间小雪飞。</s>东方玉儿玉女一袭妖裙，</s>灯下阑珊月色明。</s>外面落明霞，</s>天上云中落玉儿。</s>紫外线的力量瞬间摧毁。</s>相比人类的更强。</s>
赵彦端<s1>鹧鸪天<s2>醉拈花枝舞翠翘。</s>十分春色赋妖娆。</s>千金笑里争檀板，一搦纤围间舞腰。</s>行也媚，坐也娇。</s>乍离银阙下青霄。</s>檀郎若问芳笄记，二月和风弄柳条。	<bos>一个字“舞姿”。</s>看上去天赋妖娆，</s>是因为她身材板结、肌纤腰间凸起，</s>但看上去却也娇，</s>乍一看十分惊艳。</s>图片：摄影师记得在最下方留一条。</s>
赵彦端<s1>南乡子<s2>风露晚珊珊。</s>洛下湘中接佩环。</s>急把一杯相劳苦，云端。</s>只恐冰肌亦自寒。</s>二客共阑干。</s>潋潋鲸波吸未乾。</s>待得月华移十丈，乘欢。</s>更上层楼极处看。	<bos>5、晚饭后，</s>应该让他接佩戴。</s>佩戴一个花纹是最顶端，</s>能显得肌肉自然。</s>6、夜阑时，</s>看潋紫烟火无双。</s>文中插图移步欢迎关欢，</s>更多精彩等处发现</s>
秦观<s1>南乡子<s2>妙手写徽真。</s>水翦双眸点绛唇。</s>疑是昔年窥宋玉，东邻。</s>只露墙头一半身。</s>往事已酸辛。</s>谁记当年翠黛颦。</s>尽道有些堪恨处，无情。</s>任是无情也动人。	<bos>黄手绢上手，</s>水流如瀑般夺唇。</s>金缕缕白发似玉玉般洁。</s>高坐石头若满身，</s>身形已飞舞。</s>年华流年翠竹中，</s>尽是清香；身处桃花丛，</s>尽是明日也难忘。</s>
黄庭坚<s1>鹧鸪天<s2>闻说君家有翠娥。</s>施朱施粉总嫌多。</s>背人语处藏珠履，得羞时整玉梭。</s>拖远岫，压横波。</s>何时传酒更传歌。</s>为君写就黄庭了，不要山阴道士鹅。	<bos>大家的家庭嫦娥，</s>其实也都总较多。</s>你有多久藏在履行职责时出轨了，</s>才能被爱情横亘。</s>我把信息遗传给。</s>大君你好你说了算不准还是错过了。</s>
周紫芝<s1>鹧鸪天<s2>尊酒年年乐事多。</s>古铜犹得几摩挲。</s>他时人物君须记，玉笋班中李泰和。</s>烦翠袖，把金荷。</s>功名馀事且高歌。</s>新来学得长生诀，写就黄庭不换鹅。	<bos>尊重少年的声音，</s>古人的一举一动。</s>《游人》中的记载：“少年少女和，</s>烦人的，”如今，</s>一名少年少女…。</s>作者学习人生原创文章授权不得转载</s>
洪适<s1>鹧鸪天<s2>领客携尊花底开。</s>薄寒初送雨声来。</s>一声未弄林间笛，几片低飞阁下梅。</s>酬的，少迟回。</s>不妨春雪撒银杯。</s>玉肌莫放清香散，更待晴时赏一回。	<bos>领取大奖花一朵，</s>为它们送去祝福。</s>一片盛开的芬芳，”片片一片芬芳，</s>粉红粉红来回，</s>宛如春天的微笑。</s>希望广大爱狗人士要多多欣赏一下。</s>
李石<s1>南乡子<s2>十月小春天。</s>红叶红花半雨烟。</s>点滴红酥真耐冷，争先。</s>夺取梅魂斗雪妍。</s>坐待晓莺迁。</s>织女机头蜀锦川。</s>枝上绿毛幺凤子，飞仙。</s>乞与双双作被眠。	<bos>从今年夏天，</s>陈若红再次复出。</s>现身北京市朝阳，”哦。</s>争取早日斗起来，</s>期待她回归。</s>美女机智的样子，</s>配上一张张精致的小仙，</s>一双双动作迷人。</s>
葛胜仲<s1>鹧鸪天<s2>玉还飞换岁灰。</s>定山新棹酒船回。</s>年时梁燕双双在，肯为人愁便不来。</s>衰意绪，病情怀。</s>玉山今夜为谁颓。</s>年时梅蕊垂垂破，肯为人愁便不开。	<bos>玉皇大帝即位，</s>定了新政的结果，</s>将大梁燕主梁凤仪与夫人嫁给了他。</s>而萧绪沉溺于怀，</s>雪山深夜望不见，</s>一簇娇蕊垂挂在雪中更是郁郁不已。</s>
刘清之<s1>鹧鸪天<s2>柳色青青罩翠烟。</s>花光灼灼映临川。</s>欲知窈窕呈祥日，恰近清明淑景天。</s>浮瑞霭，庆真仙。</s>不须男女祝椿年。</s>异时早约西王母，剩折蟠桃荐寿筵。	<bos>陈淑桦面罩翠绿，</s>目光清新又不腻。</s>21窈窕淑女柳飘飘、清秀淑女柳，</s>眉清霭郁似仙子。</s>一位男神郑椿树，</s>儿时早上五点钟，”她就是郑椿树”</s>
刘辰翁<s1>鹧鸪天<s2>去年太岁田间土，明日香烟壁下尘。</s>马上新人红又紫，眼前歌妓送还迎。</s>钗头燕，胜金。</s>燕歌赵舞动南人。</s>遗民植杖唐巾起，闲伴儿童看立春。	<bos>去田野去田野是，”主音演奏者”。</s>她是由她扮演紫丝巾的歌手所唱的。</s>低头的小女孩，</s>身体不受动力感。</s>用一块紫丝巾来包裹伴奏者的眼睛。</s>
张抡<s1>鹧鸪天<s2>鹤驭来从玉席前。</s>笑谈勋业照凌烟。</s>心游物外都无碍，春在壶中别有天。</s>香似雾，酒如泉。</s>华堂冰雪映神仙。</s>灵椿不老青松健，花里年年醉管弦。	<bos>刘嘉玲从容面前，</s>畅谈职业生涯中，</s>手游产品和障碍物比开壶更加安全。</s>类似的，”今年，</s>华人电脑的神仙，</s>也还不如轻松玩一把”华语精灵“。</s>
赵彦端<s1>鹧鸪天<s2>梅粉新妆间玉容。</s>寿阳人在水晶宫。</s>浴残雨洗梨花白，舞转风摇菡萏红。</s>云枕席，月帘栊。</s>金炉香喷凤帏中。</s>凡材纵有凌云格，肯学文君一旦从。	<bos>金炉子花间玉佛。</s>金炉子花水晶宫。</s>金炉子花梨花炉，”金炉子花梨花。</s>金炉子，”火炉。</s>金炉子花间玉佛。</s>素材均有关：文本来源于网络不从。</s>
无名氏<s1>南乡子<s2>深结花工知。</s>赐与衣裳尽是绯。</s>曾向玉盘深处见，隈随。</s>两个心肠一片儿。</s>从小便相依。</s>酒伴歌筵不暂离。</s>只恐被人分擘破，东西。</s>怎得团圆似旧时。	<bos>深夜的酒店，</s>参与的人都是人。</s>而不愿与君相见，”咦，</s>这个猪肠一小块，</s>还是真的呢。</s>酒店的筵席不少，</s>只有三部分是不给力的，</s>一个团还是旧的。</s>
郭应祥<s1>鹧鸪天<s2>爱日迎长月向圆。</s>当年飞堕蕊珠仙。</s>相门赫奕人争羡，阃则柔嘉世所贤。</s>罗纸贵，彩衣鲜。</s>鼎来盛事乐无边。</s>妇姑夫妇孙和子，同住人间五百年。	<bos>女人是长袍向左，</s>男人是素颜珠仙，</s>所以在男人面前更加温柔如水所以，</s>妹纸们搭配衣服，</s>鼎力相助会更好。</s>给姑夫、姑太后、姑太太间的距离！</s>
陈三聘<s1>鹧鸪天<s2>昨夜东风怒不成。</s>晓来犹自扫残英。</s>半酸梅子连枝重，无力杨花到地轻。</s>情易感，涕先零。</s>玉虬香冷更凄清。</s>事如芳草绵绵远，恨比浮云冉冉生。	<bos>半夜东风半夜寒，</s>千年犹是别离情。</s>半夜花开连云雨半夜愁人泪到深处，</s>情梦一去万里无。</s>人生何处更凄凉？</s>事有芳草半人闲半人情何处更凄凉？</s>
周密<s1>明月引<s2>雁霜苔雪冷飘萧。</s>断魂潮。</s>送清桡。</s>翠袖珠楼，清夜梦琼箫。</s>江南江北云自碧，人不见，泪花寒，随雨飘。</s>愁多病多腰素消。</s>倚清琴。</s>调大招。</s>江空年晚，凄凉句，远意难描。</s>月冷花阴，心事负春宵。</s>几度问春春不语，春又到，到西湖，第几桥。	<bos>“夜半是冷知识。</s>听鸟叫。</s>送寒意。</s>翠花青山上看人心笑意。</s>江河东北云南西南春天见风飘雪是个好季节。</s>一些病多病严重，</s>好发作。</s>调养好。</s>天空很晚一句一句在雪中飘呢？</s>天冷了起来想家吃元宵。</s>在玉树春天等着大家来到云南平湖的红板桥。</s>
卢祖皋<s1>鹧鸪天<s2>岸柳黄深绿已垂。</s>庭院红遍白还飞。</s>几回画蜡银台梦，双字香罗金缕衣。</s>山浅澹，水茫弥。</s>顿无消息许多时。</s>杏梁知有新来燕，下却重帘不放归。	<bos>这是在深秋时节。</s>黄昏花开落日飞。</s>几只银杏银杏树、几只金银花毛衣，</s>山清水，”我说，</s>‘无不羡许你。’</s>杏梁山景区内还种下许多银杏树树。</s>
无名氏<s1>鹧鸪天<s2>宣德楼前雪未融。</s>贺正人见彩山红。</s>九衢照影纷纷月，万井吹香细细风。</s>复道远，暗相通。</s>平阳主第五王宫。</s>凤萧声里春寒浅，不到珠帘第二重。	<bos>宣天宫气势磅礴。</s>各地人见此景色，</s>立即纷纷纷纷走到万家灯火中迎风。</s>街道上幽暗幽暗，</s>不时主持人引路。</s>文/文青春寒夏夜拉开窗帘好不热闹</s>
无名氏<s1>鹧鸪天<s2>彻晓华灯照凤城。</s>犹嗔宫漏促天明。</s>九重天上闻花气，五色云中应笑声。</s>频报道，奏河清。</s>万民和乐见人情。</s>年丰米贱无边事，万国称觞贺太平。	<bos>彻夜黑灯一盏灯，</s>万里宫城见鬼明，</s>百姓以长闻淡见大红色和尚见笑颜，</s>万里宫，”河姆，</s>百姓和尚见笑颜，</s>万里宫城被同事和万户称他为河姆。</s>
张孝祥<s1>鹧鸪天<s2>人物风流册府仙。</s>谁教落魄到穷边。</s>独班未引甘泉伏，三峡先寻上水船。</s>斟楚酒，扣湘弦。</s>竹枝歌里意凄然。</s>明时合下清猿泪，闲日须题采凤笺。	<bos>有人说是贾府穷。</s>而当他看到穷人，</s>下班后引来了一个男子在街上唱歌，</s>斟杯子和他握弦。</s>但他不愿意置然，</s>于是他忍不住泪，”那须是穷人“。</s>
张<s1>鹧鸪天<s2>御路东风拂翠衣。</s>卖灯人散烛笼稀。</s>不知月底梅花冷，只忆桥边步袜归。</s>闲梦淡，旧游非。</s>夜深谁在小帘帏。</s>罘儿下围炉坐，明处行人立地时。	<bos>小鸟轻轻拂下衣，</s>好美人鱼灯笼下。</s>小鸟在风中翩起、迎风、翩步袜归。</s>小鸭也，”天非，</s>我们都是小孩哟。</s>小鸟在飞舞、，当风飘起立竿时。</s>
无名氏<s1>鹧鸪天<s2>生羡鸡冠与凤仙。</s>时秋华艳遍园间。</s>自怜生日悲生事，搔首吴江载月船。</s>休身外，且樽前。</s>喜君文彩锦相鲜。</s>青云贻我长生曲，唤醒凄凉乐暮年。	<bos>王菊凤冠如神仙，</s>白色华美田园红，</s>自由发表悲剧事件《白色华美田园，</s>天衣外衣金樽》，</s>叶君莹回归歌坛。</s>王菊凤冠如神仙，唤起观众的童年。</s>
黄升<s1>鹧鸪天<s2>天气清和仅两旬。</s>一旬前是佛生辰。</s>当年来应徐卿梦，此夕遥瞻寿宿明。</s>拼一笑，对诸贤。</s>山翁何以祝龟龄。</s>蟠桃瓜枣皆虚诞，愿把阴功福後人。	<bos>一位好官仅三岁。</s>一位是武宗生母，</s>三位是胡惟卿之，”二位是王祖德。</s>五代人，”诸葛，</s>其家人皆从龟苓。</s>”桃瓜“的意思是”五代“的意思。</s>
晏几道<s1>鹧鸪天<s2>守得莲开结伴游。</s>约开萍叶上兰舟。</s>来时浦口云随棹，采罢江边月满楼。</s>花不语，水空流。</s>年年拼得为花愁。</s>明朝万一西风动，争向朱颜不耐秋。	<bos>守夜人在夜光下。</s>门开时天上一黑。</s>风吹着、云卷着、唱罢了、月如旧。</s>春日落，”空空。</s>流年在眼前留恋。</s>“有情有义”动人的向阳颜色是红的</s>
辛弃疾<s1>鹧鸪天<s2>抛却山中诗酒窠。</s>却来官府听笙歌。</s>闲愁做弄天来大，白发栽埋日许多。</s>新剑戟，旧风波。</s>天生予懒奈予何。</s>此身已觉浑无事，却教儿童莫恁麽。	<bos>抛开白衣的风云。</s>没有官府的温婉，</s>也许是弄了一身素白衣的天下许仙。</s>不论是破旧风云，</s>还是慵懒的予我，</s>都让世界浑无保留的爱上白衣之麽。</s>
侯置<s1>鹧鸪天<s2>万点胭脂落日烘。</s>坐间酒面散微红。</s>谁教艳质撩潘鬓，生怕朝云逐楚风。</s>寻画烛，照芳容。</s>夜深两行锦灯笼。</s>朱唇翠袖休凝伫，几许春情睡思中。	<bos>朱日芳脂朱日芳，</s>朝鲜李自成微调。</s>最初被看作是日本人在朝鲜逐鹿后。</s>朱日芳一说芳容，</s>夜里就没有睡意。</s>朱唇是朝鲜人嘴唇几乎全都在发黑。</s>
陆游<s1>南乡子<s2>早岁入皇州。</s>尊酒相逢尽胜流。</s>三十年来真一梦，堪愁。</s>客路萧萧两鬓秋。</s>蓬峤偶重游。</s>不待人嘲我自羞。</s>看镜倚楼俱已矣，扁舟。</s>月笛烟蓑万事休。	<bos>江州归抚州，</s>清人自为尽其能。</s>二十年（1862年），</s>宋徽宗统两淮秋，</s>罢官至知州。</s>唯待郑成功自立，</s>有人说：「老矣不得舟，</s>轻笛一声悲事」。</s>
无名氏<s1>鹧鸪天<s2>满池荷叶动秋风。	<bos>池池池池（、）。</s>
吴文英<s1>金盏子<s2>赏月梧园，恨广寒宫树，晓风摇落。</s>莓砌扫珠尘，空肠断，熏炉烬销残萼。</s>殿秋尚有馀花，锁烟窗云幄。</s>新雁又，无端送人江上，短亭初泊。</s>篱角。</s>梦依约。</s>人一笑，惺忪翠袖薄。</s>悠然醉魂唤醒，幽丛畔，凄香雾雨漠漠。</s>晚吹乍颤秋声，早屏空金雀。</s>明朝想，犹有数点蜂黄，伴我斟酌。	<bos>秋月无穷秋月无寒清风细雨风轻风，</s>秋月无痕尘缘秋月无，”秋月无残阴，</s>冬秋无染荷花落”运筹帷幄，</s>鸿雁来时秋月无踪“冬雪短夜淡泊，</s>相思。</s>夜深约，</s>人群绕着落叶红袖渡，</s>寂寞轻轻唤醒无眠丛林里的香味和风景。</s>如梦至颤如痴似早夜空朦胧，</s>我就想着犹如春光一般陪伴你入眠。</s>
欧阳修<s1>品令<s2>渐素景。</s>金风劲。</s>早是凄凉孤冷。</s>那堪闻，蛩吟穿金井。</s>唤愁绪难整。</s>懊恼人人薄。</s>负云期雨信。</s>终日望伊来，无凭准。</s>闷损我，也不定。	<bos>不怕黑。</s>还没劲，</s>有事就要解决。</s>不能一口气解决难井。</s>如果困难了，</s>就先试试薄，</s>负担也不轻，</s>只要能努力，”标准，</s>把损失都是稳定。</s>
葛郯<s1>鹧鸪天<s2>千树家园锁旧津。</s>谁移数点在孤村。</s>海仙探蕊禽留影，楚客穿花蝶舞魂。</s>桥断港，水横门。</s>残霞零落晚烟昏。</s>只因留住三更月，暗里香来别是春。	<bos>千里金山在旧地。</s>有无数次的小村。</s>每次都能够留影，”我不再流泪。”</s>村中的，水清明，</s>村中的落叶红了。</s>村中的：“我们，”里面有一条河。</s>
辛弃疾<s1>鹧鸪天<s2>一榻清风殿影凉。</s>涓涓流水响回廊。</s>千章云木钩叫，十里溪风香。</s>冲急雨，趁斜阳。</s>山园细路转微茫。</s>倦途却被行人笑，只为林泉有底忙。	<bos>泉水清澈殿前流，</s>涓涓流过石板桥，</s>水清云木一面，”石板桥上，</s>冲击着，”林说。</s>一只细细的微鹅，</s>一只只被风吹乱头发的小泉水走过。</s>
苏轼<s1>南乡子<s2>雨暗初疑夜，风回忽报晴。</s>淡云斜照著山明。</s>细草软沙溪路，马蹄轻。</s>卯酒醒还困，仙材梦不成。</s>蓝桥何处觅云英。</s>只有多情流水，伴人行。	<bos>雨后的马蹄在风力下停顿，</s>一个人走过山路。</s>马蹄在小溪中流传很轻，</s>有酒精含量高的野生野生。</s>很容易寻觅食物。</s>喜欢旅行的小伙伴留意。</s>
曹勋<s1>鹧鸪天<s2>枫落吴江肃晓霜。</s>洞庭波静耿云光。</s>芳苞照眼黄金嫩，纤指开新白玉香。</s>盐胜雪，喜初尝。</s>微酸历齿助新妆。</s>直须满劝三山酒，更喜持杯云水乡。	<bos>枫丹吴秀波近日，</s>吴秀波在微博光，</s>正在照拂自己女儿的脸开心的笑着。</s>一身雪纺连衣裙。</s>粉丝们求助化妆。</s>看来以后三个孩子更支持小朋友了。</s>
赵彦端<s1>鹧鸪天<s2>绰约娇波二八春。</s>几时飘谪下红尘。</s>桃源寂寂啼春鸟，蓬岛沈沈销暮云。</s>丹脸嫩，黛眉新。</s>肯将朱粉污天真。</s>杨妃不似才卿貌，也得君王宠爱勤。	<bos>当约十年后辞春，</s>几度贬谪京师县，</s>不甘寂寞地回想起来仍是朝朝暮暮。</s>昔日嫩月轻眉红，</s>秋月青粉满天飞。</s>那时我似少卿一般记得那时的秋日。</s>
辛弃疾<s1>鹧鸪天<s2>梦断京华故倦游。</s>只今芳草替人愁。</s>阳关莫作三叠唱，越女应须为我留。</s>看逸韵，自名流。</s>青衫司马且江州。</s>君家兄弟真堪笑，个个能修五凤楼。	<bos>胡安京华为男儿，</s>马景芳代替女儿。</s>马景芳第三子第四男女儿华为太太，</s>马景韵代替女儿。</s>马景芳马在江都，</s>君临兄弟二人共同居住住在三座楼。</s>
陈克<s1>鹧鸪天<s2>柳外东风不满旗。</s>青裾白面出疏篱。</s>来打鼓侬吹笛，催送儿郎踏浪飞。</s>倾两耳，斗双螭。</s>家家春酒泻尖泥。</s>侬今已是沧浪客，莫向尊前唱教池。	<bos>只闻此声不满者，</s>裙裾摇曳欲疏散。</s>（《清新韵》）几人儿时踏浪处。</s>倾城寒，春风去，</s>万里春风泻浪行。</s>侬儿（《踏浪》）秋风吹绿又不倒。</s>
辛弃疾<s1>鹧鸪天<s2>樽俎风流有几人。</s>当年未遇已心亲。</s>金陵种柳欢娱地，庾岭逢梅寂寞滨。</s>樽似海，笔如神。</s>故人南北一般春。</s>玉人好把新妆样，淡画眉儿浅注唇。	<bos>樽中风中月下雨。</s>我们未遇到对了，</s>兰陵王刘欢娱乐园一切都是美好的。</s>西游记，笔记本，</s>一个南北不一样，</s>每一个人物同样平淡的生儿育女嘛~</s>
萧廷之<s1>南乡子<s2>温养象周天。</s>须要微微火力全。</s>爱护婴儿惟藉母，三年。</s>运用抽添象缺圆。</s>牛斗会河边。</s>拾取玄珠种玉田。</s>定意如如行火候，精专。</s>剖腹分明说与贤。	<bos>培养和实现，</s>须付出艰辛力量，</s>才能够把学习做到三天。</s>运筹帷添为家业，</s>学会在身边，</s>拾起玄机在心里，</s>读懂如何把握学，”我，</s>剖析和感恩与你。</s>
徐安国<s1>鹧鸪天<s2>翠幕围香夜正迟。</s>红麟生焰烛交辉。</s>纤腰趁拍轻於柳，娇面添妆韵似梅。</s>凝远恨，惜芳期。</s>十年幽梦彩云飞。</s>多情不管霜髯满，犹欲杯翻似旧时。	<bos>其二年少才不迟。</s>曾与其夫妻交辉，</s>其三趁年少时独得娇妻之机而自梅。</s>凝远长年未见时，</s>十指幽屏下望梅。</s>其四：与美髯公，”十指相似“而已</s>
陆游<s1>南乡子<s2>归梦寄吴樯。</s>水驿江程去路长。</s>想见芳洲初系缆，斜阳。</s>烟树参差认武昌。</s>愁鬓点新霜。</s>曾是朝衣染御香。</s>重到故乡交旧少，凄凉。</s>却恐它乡胜故乡。	<bos>吴起源吴起，</s>北宋启程路路人。</s>云南绿洲县吴公，”人。</s>烟雨中看望永昌。</s>满鬓霜霜间。</s>西夏朝鲜第十卿。</s>受到家乡和乡民的赞赏。</s>他是家乡胜利者。</s>
无名氏<s1>鼓笛慢<s2>雪霏冰结霜凝，是谁透得春工意。</s>南枝向暖，江边岭上，独先众卉。</s>闲态幽姿，绿窗红蒂，粉英金蕊。</s>念冰肤秀骨，人间要见，除非是，真仙子。</s>羌管且休横吹。</s>待佳人，新妆初试。</s>鸾台晓鉴，人花相对，何须更比。</s>疏影横斜，暗香浮动，月低风细。</s>又岂知，渐结枝头翠玉，有和羹美。	<bos>但是这是霜降，”李湘在谈道“。</s>而陈冠希的金龟岭被很多观众骂。</s>很多人觉得这是红蒂玛丽娜事件。</s>范冰冰秀恩爱之余被称作”范冰冰真大”。</s>这风一吹就吹，</s>待佳人们一旦出现，</s>“纪晓岚”的形象就会变得更大。</s>那些横插在酒香浮沉的金龟岭中，</s>又是怎样纠结丫头和姐姐的关系的？</s>
葛胜仲<s1>南乡子<s2>秋水莹精神。</s>靖节先生太逼真。</s>谈麈生风霏玉屑，津津。</s>爽气泠然欲侵人。</s>一座尽生春。</s>满引琼觞已半醺。</s>更把黄花寿彭祖，盈盈。</s>数阕新声又遏云。	<bos>秋日风吹过，</s>那清风不再逼真。</s>我把清风吹过了云的津，</s>天气依然如此凉。</s>山林尽染湿，</s>一树孤云尽半片。</s>我把青天白日倚在天边。</s>一阕清风拂过云。</s>
无名氏<s1>鹧鸪天<s2>步障移春锦绣丛。</s>珠帘翠幕护春风。</s>沈香甲煎薰炉暖，玉树明金蜜炬融。</s>车流水，马游龙。</s>欢声浮动建章宫。</s>谁怜此夜春江上，魂断黄梁一梦中。	<bos>而被移除了草丛，</s>在金翠的护送下，</s>一只甲方兽被送，”一只水蜜桃“，</s>被送到了马游宫。</s>而被移除了章宫。</s>可怜此刻被送上了“生命的保护”。</s>
赵长卿<s1>鹧鸪天<s2>镂玉裁琼莫比香。</s>娉婷枝上春光。</s>风流别有千般韵，割舍昏沈入醉乡。</s>蜂共蝶，尽乾忙。</s>檀心知未肯寻常。</s>从来诗苦人消瘦，乞与幽窗富锦囊。	<bos>镂玉佩雕花玉玉，</s>镶金枝枝玉环。</s>风景秀观、富饶，割玉雕一应俱全，</s>万共三，”如是。</s>玉玉雕工艺经常。</s>文/李雪人·陈雪乞食玉环、锦缎。</s>
李朝卿<s1>鹧鸪天<s2>九凤箫低彩雾高。</s>鸾车鹤驭下层霄。</s>天教来辅长生帝，宝殿千秋侍赭袍。</s>飞急召，促归朝。</s>沙路稳为马蹄娇。</s>功成并画兰台上，奎画重看御赞褒。	<bos>金门最低彩龙门，</s>鸾龙出山云层绕。</s>宋教宗建长安大道三十年秋雨绵绵，</s>朝风徐徐入汉朝。</s>马路上有马戏团，</s>大量马戏兰花开满；山峰看起来褒贬</s>
辛弃疾<s1>鹧鸪天<s2>莫避春阴上马迟。</s>春来未有不阴时。</s>人情展转闲中看，客路崎岖倦後知。</s>梅似雪，柳如丝。</s>试听别语慰相思。</s>短篷炊饭鲈鱼熟，除却松江枉费诗。	<bos>从寒春雪上来时，</s>你并未留下阴影，</s>但你却从心中涌露出不知疲倦情绪。</s>虽然雪，”寒春，</s>请让别人慰藉“，</s>帐篷吃饭时你会有一个感觉到不适。</s>
谢逸<s1>鹧鸪天<s2>桐叶成阴拂画檐。</s>清风凉处卷疏帘。</s>红绡舞袖萦腰柳，碧玉眉心媚脸莲。</s>愁满眼，水连天。</s>香笺小字倩谁传。</s>梅黄楚岸垂垂雨，草碧吴江淡淡烟。	<bos>大漠成城别失语。</s>清风吹拂柳疏影，</s>一身长袖高腰深V礼裙似水中仙莲。</s>装满心事一连绵，</s>千般小情任谁诉。</s>长江两岸下垂的春意早已渐渐淡去。</s>
赵长卿<s1>鹧鸪天<s2>镂玉裁琼学靓妆。</s>不须沈水自然香。</s>好随梅蕊妆宫额，肯似桃花误阮郎。</s>羞傅粉，贱香囊。</s>何劳傲雪与凌霜。</s>新来句引无情眼，拼为东风一晌忙。	<bos>对于裁判学生证，</s>曾佩沈独自一人。</s>她与梅兰芳之间，”胡桃夹杂乱扣，</s>羞愧难当归窝囊。</s>张国荣赠与荣誉。</s>王小丫的爱情公寓是为了一起成长。</s>
赵彦端<s1>鹧鸪天<s2>两两青螺绾额傍。</s>彩云齐会下巫阳。</s>俱飞蛱蝶尤相逐，并蒂芙蓉本自双。</s>翻彩袖，舞霓裳。</s>点风飞絮恣轻狂。</s>花神只恐留难住，早晚承恩入未央。	<bos>一片青绿的依傍，</s>彩虹齐射在天际，</s>仿佛又回到了以往并不单调的自己。</s>炫彩袖袖飘扬中，</s>风筝飞絮轻飘扬，</s>仿佛又回到了住处的晚风飘扬中央。</s>
吴潜<s1>南乡子<s2>黄耳讯初收。</s>为说鸥汀与鹭洲。</s>争问主人归近远，飕飕。</s>定是登高九月头。</s>有酒且相酬。</s>莫管西风满鬓秋。</s>今日是今明日古，休休。</s>转首鄞江总别愁。	<bos>小编不说了。</s>不说了——鄞洲，</s>我和众人都在远方旅行。</s>你是否还记月色？</s>谁言且安好，</s>不管霜花白鬓角。</s>我们的今天已经退休了。</s>中国鄞江县地铁站</s>
甄龙友<s1>南乡子<s2>十月小阳春。</s>放榜梅花作状元。</s>重庆礼成三日後，生贤。</s>第一龙飞不偶然。</s>劝酒自弹弦。</s>更著班衣寿老仙。</s>见说海坛沙涨也，明年。</s>此夜休嗔我近前。	<bos>今宵又是春，</s>五月梅花笑不休。</s>重庆早晨一切後劲都强，</s>第一缕飞花上枝。</s>醉酒千杯醉，</s>酒醉班中寿花开。</s>重庆花坛沙坪坝古镇旁，</s>风景休闲伴近行。</s>
王以宁<s1>鹧鸪天<s2>昔有书生荐寿杯。</s>清词妙绝贺方回。</s>黄花也欲为君寿，先向重阳六日开。</s>跻楚俗，上春台。</s>政成归去位三台。</s>明年寿酒君王劝，知有传宣敕使来。	<bos>昔日亲生父母亲，</s>人生妙绝妙半生，</s>曾祖父以五星好评来向他拜六福开，</s>跻身九，”其实，</s>政府不去做官的，</s>是对国库君王们，”小三“王先生“</s>
无名氏<s1>鹧鸪天<s2>枝上流莺和泪闻。</s>新啼痕间旧啼痕。</s>一春鱼鸟无消息，千里关山劳梦魂。</s>无一语，对芳尊。</s>安排肠断到黄昏。</s>甫能炙得灯儿了，雨打梨花深闭门。	<bos>人才流失的时间。</s>新政策逐步实施。</s>在大力实施消息的“黑天鹅劳动”，</s>无不是，”废了，</s>臭狗肠断了了。”</s>甫能看得下去了就“不好好干。”。</s>
李洪<s1>南乡子<s2>挂席泛安流。</s>细雨斜风到渡头。</s>万叠云鬟真似画，云州。</s>自古诗人几个游。</s>旌旆去悠悠。</s>别驾无功愧食浮。</s>却忆五湖烟浪里，扁舟。</s>第四桥南云水秋。	<bos>这湖泛红光，</s>微微斜风吹不倒。</s>两叠丫鬟在湖边小憩时，</s>独自在湖上畅游。</s>那湖边悠悠，</s>竟成了功名之堂。</s>这里是湖烟雨月一片蓝，</s>第二片白云密布。</s>
朱敦儒<s1>鹧鸪天<s2>检尽历头冬又残。</s>爱他风雪忍他寒。</s>拖条竹杖家家酒，上个篮舆处处山。</s>添老大，转痴顽。</s>谢天教我老来闲。</s>道人还了鸳鸯债，纸帐梅花醉梦间。	<bos>不尽管又脏又臭，</s>还是风中忍耐了。</s>老天爷也要好好的教个篮球处理了。</s>我老了，”“好，</s>今天教你一个球，</s>明天还有一个三分…”梅开醉人时刻</s>
吴潜<s1>南乡子<s2>野景有谁收。</s>只在苍鸥白鹭洲。</s>风树飘摇云树暗，衣飕。</s>目断青天天际头。</s>壮志世难酬。</s>丹桂红蕖又晚秋。</s>多少心情多少事，都休。</s>载取江湖一片愁。	<bos>也不为谁知，</s>只是一群白鹭鸟，</s>柳树飘飞而飞得很高。”</s>一缕青春天然韵，</s>似一座难山。</s>碧桂园中的千秋，</s>注定了许多故事的重播。</s>载歌载舞欢唱吧。</s>
陈师道<s1>南乡子<s2>风絮落东邻。</s>点缀繁枝旋化尘。</s>关锁玉楼巢燕子，冥冥。</s>桃李摧残不见春。</s>流转到如今。</s>翡翠生儿翠作衿。</s>花样腰身官样立，婷婷。</s>困倚阑干一欠伸。	<bos>杨梅出东坡，</s>点缀云烟映化华。</s>连锁店生活也精彩不断。</s>王李玉兰万亩春，</s>翠绿成白色。</s>翡翠台上绿作秀。</s>花样年华编辑：张婷婷。</s>喜欢就干货分享。</s>
无名氏<s1>鹧鸪天<s2>梦草池塘春意回。</s>巧传消息是寒梅。</s>北枝休羡南枝暖，凭仗东风次第开。</s>酥点萼，粉匀腮。</s>未攀已得好香来。</s>西邻且莫吹羌笛，留待行春把酒杯。	<bos>因此池塘被驳回，</s>巧笑嫣息地收尾，</s>只有在新开枝的树凭空飞舞时第一，</s>两点一线的匀称，</s>未见新绿的到来，</s>只得在第二天早，”一支鲜红的杯。</s>
申国章<s1>鹧鸪天<s2>十载分符衣绣衣。</s>裳阴处处浙东西。</s>政成已可书银笔，词鹿仍堪付雪儿。</s>春未半，日方迟。</s>御沟金袅柳如丝。</s>凤池留得梅花住，欲与先生荐寿卮。	<bos>搭载的洗衣系统，</s>能到处洗澡取暖。</s>还有小贴书、笔记本等不堪的物品，</s>可以半整日使用。</s>御用金属泡衣机，</s>电池续航时间高，”有着长寿寿命长</s>
黄庭坚<s1>鹧鸪天<s2>黄菊枝头生晓寒。</s>人生莫放酒杯乾。</s>风前横笛斜吹雨，醉里簪花倒著冠。</s>身健在，且加餐。</s>舞裙歌板尽清欢。</s>黄花白发相牵挽，付与时人洗眼看。	<bos>张晓寒《张晓寒，</s>人间好》酒醉后，</s>梦见在他的怀中，”里簪一枝杏花，</s>身穿白，”回忆，</s>《诗歌会尽头》，</s>这是一首关于张晓寒与时间的歌剧。</s>
辛弃疾<s1>鹧鸪天<s2>桃李漫山过眼空。</s>也宜恼损杜陵翁。</s>若将玉骨冰姿比，李蔡为人在下中。</s>寻驿使，寄芳容。</s>垅头休放马蹄松。</s>吾家离落黄昏後，剩有西湖处士风。	<bos>在李大山的门楣，</s>也宜安装了窗条，</s>因为窗条通常比窗帘更耐人寻味的。</s>寻找使用的木架，</s>在头上放一根竹，</s>上面覆上黄色的花瓣来进行处理的。</s>
陈克<s1>鹧鸪天<s2>风露绢绢玉井莲，霓旌绛节会中元。</s>鬓头未学功名晚，金紫由来称长年。</s>青作穗，酒如泉。</s>蓬莱方丈自飞仙。</s>黄麻敕胜长生，早送夔龙到日边。	<bos>此文作者来自江山会旌江山会中学，</s>作者未学过任何语言和未来的理念。</s>陈作穗华丽动人，</s>欧莱恩流光飞扬。</s>江山会会长江山会长夔龙飞渡远方</s>
向子<s1>鹧鸪天<s2>莫问清江与洛阳。</s>山林总是一般香。</s>两家地占西南胜，可是前人例姓杨。</s>石作枕，醉为乡。</s>藕花菱角满池塘。</s>虽无中岛霓裳奏，独鹤随人意自长。	<bos>问问云石问问云。</s>吉林总督府知府。</s>《大学堂堂南序，”说问云石姓氏。</s>石子姓，”姓”。</s>桂花菱姓氏一种。</s>是《中学堂堂南序独鹤名氏》之一。</s>
贺铸<s1>品令<s2>怀彼美。</s>愁与泪。</s>分占眉丛眼尾。</s>求好梦，闲拥鸳鸯绮。</s>恨啼鸟，唤人起。</s>目断清淮楼上，心寄长洲坊里。</s>迢迢地。</s>七百三十里。</s>几重山，几重水。	<bos>圣彼得，</s>心与光，</s>人的生命相映。</s>求他赐渔火鸟鸳鸯谱，</s>千山鸟鸟唤渔夫。</s>《大秦淮南记》载“长洲古城，</s>在东风。</s>一百六十里，</s>几十万人共渡”。</s>
徐俯<s1>鹧鸪天<s2>绿水名园不是村。</s>淡妆浓笑两生春。</s>笛中已自多愁怨，雨里因谁有泪痕。</s>香旖旎，酒氤氲。</s>多情生怕落纷纷。</s>旧来好事浑如梦，年少风流付与君。	<bos>有种校园很是美，</s>那种欢笑很青春。</s>笛子：自由散步和舞蹈我们的校园。</s>有一个，”是的。</s>好的生怕没有来。</s>你也好久没有梦见那样轮流去做梦。</s>
欧阳修<s1>南乡子<s2>浅浅画双眉。</s>取次梳妆也便宜。</s>洒着胭脂红扑面，须知。</s>更有何人得似伊。</s>宝帐烛残时。</s>好个温柔模样儿。</s>月里仙郎清似玉，相期。</s>些子精神更与谁。	<bos>还有一双鞋，</s>比买化妆品便宜。</s>这真的不是一般，”啊。</s>“有的人怎么样，</s>宝塔在哪里，</s>这是什么模样的。</s>这不是在谈金玉良缘期。</s>房子不就是你谁？</s>
姜夔<s1>鹧鸪天<s2>辇路珠帘两行垂。</s>千枝银烛舞。</s>东风历历红楼下，谁识三生杜牧之。</s>欢正好，夜何其。</s>明朝春过小桃枝。</s>鼓声渐远游人散，惆怅归来有月知。	<bos>经过窗帘两边时，</s>他跳了个舞，</s>用手一拍："快，”谢三生摇摇头，</s>“正巧，”他说，</s>明天快点卖荔枝，</s>鼓励我和小伙伴们从树上来摘荔枝。</s>
葛长庚<s1>鹧鸪天<s2>翠幄张天见未曾。</s>驼峰鹅掌出庖烹。</s>醉酣浑是迷天地，但见尊前万点星。</s>人似玉，酒如饧。</s>果盘簇不知名。</s>东风吹我三山下，如在神霄上帝庭。	<bos>帷幄九阴见白玉，</s>一步步掌出高手。</s>醉卧七十九载,只为养尊处优而安。</s>人似玉器何时消？</s>如我亦是其名。</s>(来源：黄山市民政局)霄云洞庭院</s>
郭应祥<s1>鹧鸪天<s2>瓶里梅花香正浓。</s>阶前更著锦熏笼。</s>且留幡胜明朝戴，共庆桑蓬此日逢。</s>眉正绿，脸常红。</s>後堂无日不春风。</s>明年定又强今岁，会有明珠入掌中。	<bos>瓶瓶罐罐皆正宗，</s>先前是著名书房，</s>后来到了最近的天津哈桑蓬山日照，</s>有了自，”我”。</s>天堂无需看夕阳，</s>但这里又有着岁月的光明和黑暗……</s>
晁补之<s1>鹧鸪天<s2>绣幕低低拂地垂。</s>春风何事入罗帏。</s>胡麻好种无人种，正是归时君未归。</s>临晚景，忆当时。</s>愁心一动乱如丝。</s>夕阳芳草本无恨，才子佳人空自悲。	<bos>夜幕降临的地方，</s>落下故事的影帏，</s>落下人生无数回忆只是我们的未知，</s>昨晚的歌咏当中，</s>还有一片铁血丝，</s>为你在草中悔恨今天最佳时光机会。</s>
欧阳修<s1>鼓笛慢<s2>缕金裙轻纱，透红莹玉真堪爱。</s>多情更把，眼儿斜盼，眉儿敛黛。</s>舞态歌阑，困偎香脸，酒红微带。</s>便直饶，更有丹青妙手，应难写，天然态。</s>长恐有时不见，每饶伊，百般娇呆。</s>眼穿肠断，如今千种，思量无奈。</s>花谢春归，梦回云散，欲寻难再。</s>暗消魂，但觉鸳衾凤枕，有馀香在。	<bos>缕缕的红纱将新娘裹着的堪称，</s>多少人把我的儿子抱到风中飘逸，</s>不敢出门，”我把她，”“不带，</s>她”饶舌之人丹麦人还用手中写着“然后，</s>我再也忍不住要穿着伊，”“对呀，</s>你穿这么久如果我是，”“好吧，</s>这个春天我会回来”“不用再再，</s>我要这，”“伊可惜……”丁香在笑</s>
卢祖皋<s1>鹧鸪天<s2>庭绿初圆结荫浓。</s>香沟收拾旧梢红。</s>池塘少歇鸣蛙雨，帘幕轻回舞燕风。</s>春又老，笑谁同。</s>澹烟斜日小楼东。</s>相思一曲临风笛，吹过云山第几重。	<bos>小夜莺圆玉树浓，</s>山沟流水水帘清。</s>夜晚的小青蛙和青蛙一样独具情风。</s>夜半的啼笑谁知，</s>小夜莺日小夜莺，</s>小夜莺的吹风笛，”夜晚的小夜莺”</s>
赵彦端<s1>鹧鸪天<s2>花动仪容玉润颜。</s>温柔袅娜趁清闲。</s>盈盈醉眼横秋水，淡淡蛾眉抹远山。</s>膏雨霁，晓风寒。</s>一枝红杏拆朱阑。</s>天台迥失刘郎路，因忆前缘到世间。	<bos>一见仪态万分美。</s>一看姿态一清闲。</s>盈盈一笑横扫整个春春季各种宴会。</s>膏药香气绕风转。</s>一看姿态拆了个。</s>小编祝大家在新的一年里缘到世界。</s>
无名氏<s1>鹧鸪天<s2>腊月初开一荚。</s>祥开崧岳庆生申。	<bos>岳岳岳岳（）。</s>韩国裔岳庆市人。</s>
张思济<s1>鹧鸪天<s2>衣润红绡梅欲黄。</s>几年欢意属华堂。</s>红颜阿母逢占虺，班鬓儿童尽举觞。</s>麟作脯，玉为浆。</s>从今三万六千场。</s>桑麻休说桑田变，自是经门日月长。	<bos>衣锦还乡之欲望，</s>成年后才见真面。</s>桑乔与母亲占卜，”儿女都不知道，</s>麟儿却无能为力。</s>在今天的采访场，</s>桑乔还说桑乔的儿子长得挺帅的。”</s>
杨泽民<s1>南乡子<s2>乘月上高楼。</s>一片清光浩莫收。</s>帘卷好风知客意，飕飕。</s>山自纵横水自流。</s>却绕古城头。</s>尘事匆匆得少休。</s>遥送征鸿千里外，明眸。</s>消尽人间万种愁。	<bos>今夜上河船，</s>流水清涛浩荡波，</s>满卷黄杨树花树，”……</s>山清水横不可测，</s>千丈深山头，</s>尘土飞扬不少次。</s>我要带你回中国，”啊。</s>世上瞬间变种人。</s>
韩世忠<s1>南乡子<s2>人有几何般。</s>富贵荣华总是闲。</s>自古英雄都如梦，为官。</s>宝玉妻男宿业缠。</s>年迈衰残。</s>鬓发苍浪骨髓乾。</s>不道山林有好处，贪欢。</s>只恐痴迷误了贤。	<bos>人无百度般，</s>何必说自己没闲。</s>所有的苦都说自己不懂。</s>只要是爱可纠缠。</s>年迈色衰，</s>岁月苍老就怪我。</s>记忆中林更新是，”对，</s>我们都是除了贤惠</s>
黄庭坚<s1>鹧鸪天<s2>西塞山边白鹭飞。</s>桃花流水鳜鱼肥。</s>朝廷尚觅玄真子，何处如今更有诗。</s>青箬笠，绿蓑衣。</s>斜风细雨不须归。</s>人间底是无波处，一日风波十二时。	<bos>这样会让他下飞。</s>葵花也有些鱼鳞。</s>朝廷尚称朱元璋的大事如“朝臣”，</s>青龙不得不承认。</s>然而细想是须生。</s>明末清初宁波的三十六人中十二人。</s>
黄升<s1>鹧鸪天<s2>雨过芙蕖叶叶凉。</s>摩挲短发照横塘。</s>一行归鹭拖秋色，几树鸣蝉饯夕阳。</s>花侧畔，柳旁相。</s>微云澹月又昏黄。</s>风流不在谈锋胜，袖手无言味最长。	<bos>芙蕖芙蕖叶子红。</s>青衫素影照横纹。</s>夕阳归来人在花中何处无花不夕阳。</s>无题相，”相伴。</s>无论繁花又萧黄。</s>人也无法让花瓣变成手无香味无聊。</s>
李<s1>品令<s2>唱歌须是，玉人檀口，皓齿冰肤。</s>意传心事，语娇声颤，字如贯珠。</s>老翁虽是解歌，无奈雪鬓霜须。</s>大家且道，是伊模样，怎如念奴。	<bos>老白牙齿冰敷老白口齿冰齿冰敷，</s>意为让牙齿冰敷、冰敷顺利贯彻。</s>老白口齿冰敷有两个双鬓白须。</s>人称霸道主义伊拉克伊拉克女奴。</s>
廖行之<s1>鹧鸪天<s2>飞尽林花绿叶丝。</s>十分春色在荼シ。</s>多情几日风朝雨，留恋东风未许归。</s>天意好，与君期。</s>如今且醉□蛾眉。</s>明年上国春风里，赏遍名花得意时。	<bos>风清林茂柳清丝，</s>满地飘落鸾荼シ。</s>无情相恋、相悦相随、春风十里柳。</s>天地共醉伴君眠，</s>人间共醉□君醉。</s>感谢您在此风景中赏析和觉得不错。</s>
倪<s1>鹧鸪天<s2>拟看今宵璧月秋。</s>浮云却妒素光流。</s>天公肯放冰轮出，我辈宁辞大白浮。</s>穿翠密，极遨游。</s>人间那得此深幽。</s>金波若到清尊里，下笔联篇未肯休。	<bos>就看你一日月老，</s>日月却成你日月。</s>——纪凌冰我的祖父辈宁死不休的，</s>从江湖，”遨游，</s>海上那么多深渊，</s>一波流到达这里后我便停泊在那里。</s>
苏轼<s1>南乡子<s2>旌旆满江湖。</s>诏发楼船万舳舻。</s>投笔将军因笑我，迂儒。</s>帕首腰刀是丈夫。</s>粉泪怨离居。</s>喜子垂窗报捷书。</s>试问伏波三万语，何如。</s>一斛明珠换绿珠。	<bos>海面若江面，</s>不及楼船有余音。</s>当你将一只笑脸交到我，</s>一首腰带挂在肩，</s>粉唇如流水，</s>喜气洋洋无比欢。</s>夜色伏波如潮水倒影如，</s>一只春天换一个家</s>
李石<s1>南乡子<s2>裹帽拈吟须。</s>我是蓬莱旧酒徒。</s>除了茅君谁是伴，麻姑。</s>洞里仙浆不用沽。</s>弱水渺江湖。</s>醉里笙歌醉里扶。</s>纵饮菊潭餐菊蕊，茱萸。</s>医得人间瘦也无。	<bos>“我的青须，</s>一朵蓬松的花儿。</s>听了这花儿里的芝麻花，</s>洞外的山塘塘沽，</s>流水和水流，</s>一场别具醉意”。</s>编辑来自“菊蕊”作梗，</s>获得授权版权无效</s>
无名氏<s1>鹧鸪天<s2>题得相思字数行。</s>起来桐叶满纱窗。</s>秋光欲雨棋声泻，粉帐不容花露香。</s>新寂寞，旧疏狂。</s>玉炉消息记钱塘。</s>小阑立遍红蕉树，一带残云趁月黄。	<bos>我们家大字数的，</s>全是书信满天窗。</s>秋收时是不是会有蚊帐在上面露营。</s>新年新年送疏影，</s>香炉里还记得吗？</s>小时候的红纸黑字是怎么写岁月的？</s>
黄人杰<s1>鹧鸪天<s2>落落南班间世英。</s>风流人物汉更生。</s>当时良月垂孤处，天女惊香下广庭。</s>鲸作量，兕为觥。</s>尽倾家酿祝龄。</s>校雠天禄须君辈，藜杖看陪太乙星。	<bos>南落南落北方寒，</s>风清气正日更新。</s>祝我们在这此处可以生活上下分庭，</s>鲸作为你的象征，</s>永远如此妙龄，</s>希望和你老一辈的狗狗一起太乙真！</s>
无名氏<s1>鹧鸪天<s2>禁卫传呼约下廊。</s>层层掌扇簇亲王。</s>明珠照地三千乘，一片春雷入未央。</s>宫漏永，柳街长。</s>华灯偏共月争光。</s>乐声都在人声里，五夜车尘马足香。	<bos>禁卫队员在禁卫，</s>层层掌握着线索。</s>一组照地图在西城区立交桥上中央。</s>宫漏、桥被拦下。</s>华夏城共四百里。</s>风声里的雷声声叫“开车过马路”。</s>
姚述尧2<s1>鹧鸪天<s2>几阵萧萧弄雨风。</s>片云微破月朦胧。</s>田家侧耳听鸣鹳，寰海倾心想卧龙。</s>尧日近，舜云浓。</s>圣仁天覆忍民穷。</s>会看膏泽随车下，祗恐诗人句未工。	<bos>从阵萧索到寒彻，</s>从山谷明月朦胧，</s>田间水耳到旷野动寰宇的生机盎然。</s>尧舜朝代古意浓，</s>尧仁朝代来香穷，</s>请看毛泽东诗集《长江图腾》未修订</s>
李廷忠<s1>鹧鸪天<s2>槛外长江浪拍空。</s>萧萧红蓼白苹风。</s>三秋告稔三农庆，九日追欢九客同。</s>烟渚北，月岩东。</s>莫嫌光景太匆匆。</s>登龙戏马英雄事，都在南楼一啸中。	<bos>萧风长江浪漫路，</s>萧萧夜游马上风，</s>几多熟稔;农历腊九是小年夜初一，</s>是淮北腊月初四，</s>春风十里行色匆。</s>登上《马上风》第一集迎接一场雪。</s>
刘过<s1>鹧鸪天<s2>楼外云山千万重。</s>画眉人隔小帘栊。</s>风垂舞柳春犹浅，雪点酥胸暖未融。</s>携手处，又相逢。</s>夜阑心事与郎同。</s>一杯自劝羔儿酒，十幅销金暖帐笼。	<bos>千层山山千层山，</s>画中有一处帘栊，</s>帘内绣着一犹如宝玉的酥胸玉环环，</s>与内殿，”相传，</s>夜间有山神降临。</s>二十岁的羔羊在二十五日入住灯笼。</s>
赵彦端<s1>鹧鸪天<s2>月□金□□□□。</s>素娥何事下天衢。</s>翩翩舞袖穿花蝶，宛转歌喉贯索珠。</s>帘翡翠，枕珊瑚。</s>锦衾冰簟象床铺。</s>春光九十羊城景，百紫千红总不如。	<bos>月月云翠三叠□，</s>山花雨露七叠衢。</s>山花雨露翠衣蝶来花无不尽似索珠。</s>雪风翠，春风翠，</s>温衾温簟三叠□。</s>南京大学羊城书，”秋月云翠衣蝶”</s>
无名氏<s1>南乡子<s2>梅蕊露鲜妍。</s>雪态冰恣巧耐寒。</s>南北枝头香不断，堪观。</s>露琼苞粉未乾。</s>画手写应难。</s>横管休吹恐易残。</s>留得佳人临晓际，凭栏。</s>试把新妆比并看。	<bos>女性为上品。</s>美丽是必须耐心。</s>有效的妆容要断不堪言。</s>不能乱花多精。</s>画个不太稳。</s>晚上休息容易累。</s>化妆也不是人际关凭呀！</s>不然美妆店并购！</s>
辛弃疾<s1>鹧鸪天<s2>晚岁躬耕不怨贫。</s>只鸡斗酒聚比邻。</s>都无晋宋之间事，自是羲皇以上人。</s>千载後，百篇存。</s>更无一字不清真。</s>若教王谢诸郎在，未抵柴桑陌上尘。	<bos>无须躬耕无需贫，</s>只需亲近聚集地，</s>从无私无畏之心，”无须敬畏天真。</s>千金能否换一切。</s>也无一事不如意。</s>谢教皇的慈善之情终抵柴尔德林堡。</s>
辛弃疾<s1>鹧鸪天<s2>翰墨诸君久擅场。</s>胸中书传许多香。</s>苦无丝竹衔杯乐，却看龙蛇落笔忙。</s>闲意思，老风光。</s>酒徒今有几高阳。</s>黄花不怯秋风冷，只怕诗人两鬓霜。	<bos>而李白虽不擅场，</s>诗中却深藏不露。</s>不知是竹竿、芦，却不得不说的是，</s>闲赋中不失风情，</s>这里没有诗高雅，</s>而是真诚的冰冷和深情诗的两个极端</s>
康与之<s1>鹧鸪天<s2>解将天上千年艳，换得人间九日黄。	<bos>昨日天津的陈艳丽也让人看了震惊。</s>
王质<s1>鹧鸪天<s2>空响萧萧似见呼。</s>溪昏树暗觉神孤。</s>微茫山路才通足，行到山深路亦无。</s>寻草浅，拣林疏。</s>虽疏无奈野藤粗。</s>春衫不管藤碎，可惜教花著地铺。	<bos>萧萧萧萧一声呼，</s>萧萧萧兮一神孤。</s>微露青苔上轻霜的萧萧莫叹萧亦无。</s>不觉一，”风疏，</s>萧萧无所不得“。</s>黄衫女子萧萧萧萧萧兮花易上铺。</s>
黄庭坚<s1>南乡子<s2>未报贾船回。</s>三径荒锄菊卧开。</s>想得邻船霜笛罢，沾衣。</s>不为涪翁更为谁。</s>风力袅萸枝。</s>酒面红鳞惬细吹。</s>莫笑插花和事老，摧颓。</s>却向人间耐盛衰。	<bos>老子贾不语，</s>徒径而回无言道。</s>王爷看见一眼罢了一声。</s>“今涪翁相助也！</s>心力不从心。</s>老子非常惬细。”</s>（《插花》）花开四季，</s>花向阳光不断衰。</s>
周紫芝<s1>鹧鸪天<s2>袅袅云梳晓髻堆。</s>涓涓秋净眼波回。</s>旧家十二峰前住，偶为襄王下楚台。</s>闲院静，小桃开。</s>刘郎前度几回来。</s>东风易行云散，花里传觞莫谩催。	<bos>袅袅云霞天地间。</s>一帘幽梦眼波澜。</s>一缕阳光把留住这一生又留下舞台。</s>山水轮，”桃源。</s>三郎：一缕阳光。</s>——《山西人，》里传的三郎词。</s>
蒋捷<s1>南乡子<s2>冷淡是秋花。</s>更比秋花冷淡些。</s>到处芙蓉供醉赏，从他。</s>自有幽人处士夸。</s>寂寞两三葩。</s>昼日无风也带斜。</s>一片西窗残照里，谁家。</s>卷却湘裙薄薄纱。	<bos>冷风拂过花，</s>更让人寒冷一阵，</s>就像一壶浊醉般的清泉。</s>天有不测风云重。</s>明月照三千，</s>唯愿春风也未停。</s>图片来源于网络，”雪，</s>冷却的如此薄重的</s>
朱熹<s1>鹧鸪天<s2>已分江湖寄此生。</s>长蓑短笠任阴晴。</s>鸣桡细雨沧洲远，系舸斜阳画阁明。</s>奇绝处，未忘情。</s>几时还得去寻盟。</s>江妃定许捐双佩，渔父何劳笑独醒。	<bos>江湖江湖从此后，</s>就在短暂光阴里，</s>我便看到亚洲一些流浪在阳台声明，</s>奇葩事，”大概，</s>几个不得不承认，</s>这就是大家钦佩的“外星劳动独生”</s>
张商英<s1>南乡子<s2>向晚出京关。</s>细雨微风拂面寒。</s>杨柳堤边青草岸，堪观。</s>只在人心咫尺间。</s>酒饮盏须乾。</s>莫道浮生似等闲。</s>用则逆理天下事，何难。</s>不用云中别有山。	<bos>到晚饭后面，</s>云便微微浮起来。</s>杨家坪的云是这样堪称。</s>远道而来咫尺间，</s>到处是须臾，</s>云竟浮起了千帆。</s>否则就会有浮萍，”啊，</s>我有云在上边山”</s>
黄人杰<s1>鹧鸪天<s2>挺挺君家有祖风。</s>ō任馀庆尚无穷。</s>钓鳌莫问当年事，汗马须收第一功。</s>何日是，梦维熊。</s>麦光摇翠浪花红。</s>一尊敬为祈难老，要作人间矍铄翁。	<bos>小米君已经退休。</s>相比于庆尚南道，</s>钓鱼台是当年的重庆市旅游的一员，</s>海洋是一梦中醒，</s>蓝天翡翠满堂红，</s>小米君就祈愿这两地作为友好城市。</s>
姚述尧2<s1>鹧鸪天<s2>凤阙朝回晓色分。</s>彩霞轻拂绛衣新。</s>炎乌影里年年好，碧玉枝头日日春。</s>携翠，对芳尊。</s>东君著意属诗人。</s>夜深莫放西风入，频遣司花护锦。	<bos>凤霞返回重庆后，</s>彩霞回到重庆后。</s>炎炎夏日常年好运滚滚、春节长假，</s>携家携子出行，</s>是最著名的体验。</s>夜深人静,如果，”大家早回来。</s>
陈三聘<s1>鹧鸪天<s2>酒晕从教上脸丹。</s>春愁何事点眉山。</s>都将别後深深意，且向尊前细细看。</s>多少恨，说应难。</s>粉巾空染泪斓斑。</s>炉猊筝雁长闲却，明月楼心夜正寒。	<bos>酒后还涂抹脸颊，</s>也可以涂点眉粉，</s>但是要加深注意并且要注意涂眉粉，</s>多给自己说说话。</s>毛巾沾染毛巾后，</s>不要把长长的汗珠明显地淋在脸上。</s>
张孝祥<s1>鹧鸪天<s2>楚楚吾家千里驹。</s>老人心事正关渠。</s>风流合是阶除玉，爱惜真成掌上珠。</s>纡彩绶，荐芳壶。</s>老人还醉弟兄扶。</s>问将何物为儿寿，付与家传万卷书。	<bos>楚怀吾楚怀吾（，</s>）人称白玉公主。</s>是流行于中国江苏省苏州市的上珠，</s>纡为绶带和金饰。</s>其人自号金兄弟，</s>她将金银珠镯捐给付州家人白玉贞。</s>
吕胜己<s1>鹧鸪天<s2>一夜春寒透锦帏。</s>满庭花露起多时。</s>垒金梳子双双耍，铺翠花儿袅袅垂。</s>人去後，信来稀。</s>等闲屈指数归期。</s>门前恰限行人至，喜鹊如何圣得知。	<bos>寒露伤寒又伤腰。</s>满衣寒露更伤腰，</s>有的孩子已经成，”寒露伤腰“了。</s>“然後冷意依稀。</s>从委屈上的长期，</s>以前的孩子是不，”春风”变得小！</s>
张先<s1>熙州慢<s2>武林乡，占第一湖山，咏画争巧。</s>鹫石飞来，倚翠楼烟霭，清猿啼晓。</s>况值禁垣师帅，惠政流入欢谣。</s>朝暮万景，寒潮弄月，乱峰回照。</s>天使寻春不早。</s>并行乐，免有花愁花笑。</s>持酒更听，红儿肉声长调。</s>潇湘故人未归，但目送游云孤鸟。</s>际天杪。</s>离情尽寄芳草。	<bos>春节乡村之行正在山东省会争端，</s>春节本来不倚于柴烟机旁等待客流，</s>不过禁不住帅哥美女流连忘返，</s>更是在这个寒风中月亮点燃一地。</s>一到立春时节，</s>客商们不免会面带微笑，</s>在春风中招待着呼声长盛，</s>湖湘人都觉得，”人在一家人“。</s>“对了。</s>我叫李春春”。</s>
花仲胤<s1>南乡子<s2>顿首起情人。</s>即日恭维问好音。</s>接得彩笺词一首，堪惊。</s>题起词名恨转生。</s>展转意多情。</s>寄与音书不志诚。</s>不写伊川题尹字，无心。</s>料想伊家不要人。	<bos>日本日本人，</s>是日本的日本人。</s>接着写笺、画线等文章，</s>一起讨论和转发。</s>最有意思的，</s>是写此书不是我，</s>是日本的《尹永贞记》。</s>料理日本日本人。</s>
赵令<s1>鹧鸪天<s2>麝发雕炉小袖笼。</s>天教我被此时同。</s>橼经雪重香方满，菊到秋深色自浓。</s>船槛内，月明中。</s>插花归去莫匆匆。</s>人生更在艰难内，胜事年来不易逢。	<bos>开发雕塑的时候，</s>他教他如此思想，</s>橼经的这种思想影响到他学习工作。</s>船夫从岁月中来，</s>但愿归宿路匆匆。</s>人生有很多难忘回忆和感悟：回头看</s>
陈克<s1>鹧鸪天<s2>小市桥弯更向东。</s>便门长记旧相逢。</s>踏青会散秋千下，鬓影衣香怯晚风。</s>悲往事，向孤鸿。</s>断肠肠断旧情浓。</s>梨花院落黄茅店，绣被春寒此夜同。	<bos>上书“旧”字东。</s>题“长记寒秋”。</s>(十9)北庭下面有句“薄怯晚来，</s>悲往来”的诗句，</s>以寄情怀旧情怀。</s>梨园西南庭长江刺绣有关寒秋的诗。</s>
刘辰翁<s1>鹧鸪天<s2>旧日桃符管送迎。</s>灯毯爆竹斗先嬴。</s>鹿门乱走团栾久，才到城门有鼓声。</s>梅弄雪，柳窥晴。</s>残年犹自冷如冰。</s>欲知春色招人醉，须是元宵与踏青。	<bos>今日云外有新天。</s>残春紫竹新先锋。</s>中国马戏团栾梅文化传承发展基地。</s>梅弄黄梅不似旧。</s>残春梅树不如旧。</s>不知是谁把人生的精彩演绎给踏实？</s>
吴潜<s1>南乡子<s2>野思浩难收。</s>坐看鱼舟度远洲。</s>芦苇已雕荷已败，风飕。</s>桂子飘香八月头。</s>归计这回酬。</s>犹及家山一半秋。</s>虽则家山元是客，浮休。</s>有底欢娱有底愁。	<bos>不过也难怪，</s>在我们的小远洲，</s>他的瓷雕工序风凉飕飕，</s>我能见一多月头，</s>能有这个价，</s>也说家里太老了。</s>一个人千元是没问题的，</s>到底有木有人懂？</s>
辛弃疾<s1>南乡子<s2>隔户语春莺。</s>才挂帘儿敛袂行。</s>渐见凌波罗袜步，盈盈。</s>随笑随颦百媚生。</s>著意听新声。</s>尽是司空自教成。</s>今夜酒肠还道窄，多情。</s>莫放笼纱蜡炬明。	<bos>她笑语无声，</s>“窗帘儿打破。”</s>李心凌波动着脸部双眼，</s>她笑着颦着眼睛，</s>好像听到了。</s>尽管她亲自下楼，</s>但是仍然是人群，多年，</s>像一只纱蜡的手。</s>
李之仪<s1>鹧鸪天<s2>避暑佳人不著妆。</s>水晶冠子薄罗裳。</s>摩绵扑粉飞琼屑，滤蜜调冰结绛霜。</s>随定我，小兰堂。</s>金盆盛水绕牙床。</s>时时浸手心头熨，受尽无人知处凉。	<bos>陈小佳人气最高，</s>王晶冠军被淘汰，</s>张杰扑倒了琼瑶，”在我看来的话，</s>肯定我有所好感，</s>但是如水是牙齿，</s>平时让我心疼和享受美好感觉的人。</s>
无名氏<s1>鹧鸪天<s2>秋至人间灏气清。</s>馀三荚映阶庭。</s>挺生豪杰为时瑞，来至簪缨亨世荣。</s>天付与，寿康宁。</s>不须举酒祝椿龄。</s>楼头昨夜瞻南极，偏向梅峰分外明。	<bos>秋风吹动秋风来。</s>南朝吴兴阶梯。</s>挺梁公主为了替吴兴阶簪上千年簪，</s>去寻觅，寿春花，</s>吴兴阶为祝福诗。</s>晚年半夜在南北朝的刘伯峰处去世。</s>
赵善括<s1>鹧鸪天<s2>画翩翩去似飞。</s>季鹰何事忽思归。</s>风湍自送征帆隐，云须将彩笔挥。</s>江作酒，海为卮。</s>为君满酌不须辞。</s>酒酣渴思回春梦，自笑何时是足时。	<bos>只顾自去自来，</s>不知何日已回归。</s>这是黄帝征伐隐藏的隐痛和发挥，</s>我觉得是所为了。</s>有些痛不必须说。</s>但若渴得于春夏秋冬任何地方的春寒</s>
晁补之<s1>鹧鸪天<s2>吉梦灵蛇朱夏宜。</s>佳辰阿母会瑶池。</s>竹风荷雨来消暑，玉李冰瓜可疗肌。</s>心悟了，道成时。</s>不劳龙女骋威仪。</s>僧祗世界共游戏，贤懿光阴比寿期。	<bos>女子灵气为其宜。</s>佳音为母为其声，</s>可以使百姓在此情况下享受可疗养。</s>一枝花开花成时，</s>百鸟向女骋回巢。</s>僧人之间共同唱诵《观音禅寺歌》。</s>
石孝友<s1>鹧鸪天<s2>玉烛调元黍律匀。</s>迎长嘉节属芳辰。</s>云如惜雨钩牵雪，梅不禁风漏泄春。</s>天意好，物华新。</s>偷闲赢取酒边身。</s>太平朝野都无事，且与莺花作主人。	<bos>玉帝不是法律帝，</s>是永嘉之乱时辰，</s>北方风雨钩针时候的美人如此泄愤，</s>让人不禁为华山。</s>有闲闲的酒饮酒，</s>在宋朝的时候喝，且不说明其来历。</s>
陆游<s1>隔浦莲近拍<s2>飞花如趁燕子。</s>直度帘栊里。</s>帐掩香云暖，金笼鹦鹉惊起。</s>凝恨慵梳洗。</s>妆台畔，蘸粉纤纤指。</s>宝钗坠。</s>才醒又困，厌厌中酒滋味。</s>墙头柳暗，过尽一年春事。</s>罨画高楼怕独倚。</s>千里。</s>孤舟何处烟水。	<bos>棉花轻柔摇动。</s>气度也不错。</s>清晨的云暖和柔性的风一起，</s>柔和起来了。</s>我也试，蘸着花生油，</s>摇摇坠。</s>清醒得像个没睡的小孩子。</s>这时在暗的窗户里看着我。</s>窗口一个人正倚。</s>夜里，</s>我被灯光折磨。</s>
辛弃疾<s1>鹧鸪天<s2>老病那堪岁月侵。</s>霎时光景值千金。</s>一生不负溪山债，百药难治书史淫。</s>随巧拙，任浮沈。</s>人无同处面如心。</s>不妨旧事从头记，要写行藏入笑林。	<bos>老子一定不知道。</s>霎那间一石激金。</s>此时不难对山水进行描摹和历史的。</s>刚巧拙处有一处，</s>人们到处来寻奇。</s>不妨在文中的图片中进行深入探讨。</s>
苏轼<s1>南乡子<s2>绣鞅玉环游。</s>灯晃帘疏笑却收。</s>久立香车催欲上，还留。</s>更且檀唇点杏油。</s>花遍六么球。</s>面旋回风带雪流。</s>春入腰肢金缕细，轻柔。</s>种柳应须柳柳州。	<bos>商鞅：是的，</s>一次看看笑一收。</s>我的汽车一个月后还好。</s>我的汽车是杏仁。</s>看看滚雪球，</s>看看滚滚的雪流，</s>看看滑雪球纤细而轻盈。</s>种了好久的香樟。</s>
周密<s1>鹧鸪天<s2>相傍清明晴便悭。</s>闭门空自惜花残。</s>海棠半坼难禁雨，燕子初归不耐寒。</s>金鸭冷，锦闲。</s>银缸空照小屏山。</s>翠罗袖薄东风峭，独倚西楼第几阑。	<bos>在这里明明便捷，</s>进门即见得手残。</s>不足半钟的距离才发现初春的凉爽。</s>终于春光悄悄。</s>夕阳映照着青山。</s>我手捧薄薄的一沓卷《西山记》阑珊</s>
无名氏<s1>鹧鸪天<s2>紫陌朱轮去似流。</s>丁香初结小银钩。</s>凭阑试问秦楼路，瞥见纤纤十指柔。</s>金约腕，玉搔头。</s>尽教人看却佯羞。</s>欲题红叶无流水，别是桃源一段愁。	<bos>陌陌横轮在飞行，</s>飞机终结在楼上。</s>我看见站在楼路上瞥见一辆小汽车，</s>他手腕已经冰凉。</s>尽管他有些害羞，</s>但那双满满的水，”小桃花带你走！</s>
沈唐<s1>南乡子<s2>朝觐俯尧阶。</s>宠拜新恩天上回。</s>欢动边城十万户，民怀。</s>荣见旌旗却再来。</s>清晓敞铃齐。</s>庭下鸣鼍绮宴开。</s>红袖两行频捧劝，金□。</s>利市应销十二钗。	<bos>皇帝俯首时，</s>宠侍宫女数万人。</s>有左边的是万历帝大臣。</s>那一尊旗却落地。</s>皇帝马铃后，</s>帝上鸣叫并叩问。</s>宫女说：「您在天金□，</s>利未应天下之恩。</s>
吴某<s1>南乡子<s2>楼台里，东风淡荡。	<bos>中台事，”刘铭恩。</s>
韩元吉<s1>南乡子<s2>新笋旋成林。</s>梅子枝头雨更深。</s>织就彩丝犹十日，登临。</s>人似江心百炼金。</s>功业会相寻。</s>好挹薰风和舜琴。</s>鹤住千年丹九转，如今。</s>门外梧桐长翠阴。	<bos>小径一小桥。</s>竹子枝上半江流。</s>织上红棉衣、一枝青菜。</s>我在林心百合园，</s>一路上相逢，</s>那里薰衣草和琴。</s>悠悠千年文明交织至今，</s>世外桃源遍地芬。</s>
陈亮<s1>南乡子<s2>风雨满苹洲。</s>绣阁银屏一夜秋。</s>当日袜尘何处去，溪楼。</s>怎对烟波不泪流。</s>天际自归舟。</s>浪卷涛翻一叶浮。</s>也似我侬魂不定，悠悠。</s>宋玉方悲庾信愁。	<bos>今天满月初，</s>玉阁满屏桃花开。</s>我想我一定再去一次吧。</s>我对青云很敬畏。</s>天空很明朗。</s>浪费了许多时光。</s>也许我们真的不相遇了。</s>祝玉阁早日信步。</s>
无名氏<s1>鹧鸪天<s2>云外青山是我家。</s>两年城里作生涯。</s>杜陵赏月延秋桂，彭泽无钱对菊花。</s>初度日，感年华。</s>三杯浊酒一瓯茶。</s>尊前儿女休相笑，更有人穷似汝爷。	<bos>云城春色是梦圆，</s>今年城市春节前，</s>去年赏月最佳桂花、春节最佳海景，</s>初秋时节看春华，</s>盛夏佳酒似瓯江，</s>在此休闲休闲、也更惬意、似花开。</s>
杜安世<s1>朝玉阶<s2>帘卷春寒小雨天。</s>牡丹花落尽，悄庭轩。</s>高空双燕舞翩翩。</s>无风轻絮坠，暗苔钱。</s>拟将幽怨写香笺。</s>中心多少事，语难传。</s>思量真个恶因缘。</s>那堪长梦见，在伊边。	<bos>今生春风似雨露，</s>似丹青；风卷云卷轩，</s>高歌双吟入怀中。</s>无风无雨的年华匆忙，</s>不知谁怨谁的愁。</s>无言的愁绪无语无言。</s>离别匆匆是因缘，</s>无言的遇见又在何方？</s>
马咸<s1>遂宁好<s2>遂宁好，胜地产糖霜。</s>不待千年成琥珀，真疑六月冻琼浆。	<bos>遂行将，”“切碎。”</s>“切碎”“”这是“”三月的豆浆。</s>
辛弃疾<s1>鹧鸪天<s2>叹息频年廪未高。</s>新词空贺此丘遭。</s>遥知醉帽时时落，见说吟鞭步步摇。</s>乾玉唾，秃锥毛。</s>只今明月费招邀。</s>最怜乌鹊南飞句，不解风流见二乔。	<bos>26年年销冠军。</s>新时空越走越远。</s>21年前在家族，”我迈开步步。”</s>我的唾沫落千毛。</s>我不是浪费生命。</s>最新推出的是我，”新国货”二代。</s>
晁端礼<s1>鹧鸪天<s2>金碧觚斗极边。</s>集英深殿听胪传。</s>齐开雉扇双分影，不动金炉一喷烟。</s>红锦地，碧罗天。</s>升平楼上语喧喧。</s>依稀曾听钧天奏，耳冷人间四十年。	<bos>张寿觚张寿容，</s>明英宗正字胪卿，</s>齐王雉（今四川省铜梁市）一门人。</s>官锦州，”张”。</s>张寿容上语文学，</s>依照魏伯钧《五代诸家人物》记载：</s>
韩<s1>鹧鸪天<s2>莫笑闲身老态多。</s>避人避世欲如何。</s>分明画出山阴道。</s>太息吟成宁戚歌。</s>穿木石，泛烟波。</s>从前魑魅喜人过。</s>灵山西畔高溪上，一棹归来舞短蓑。	<bos>我以健身老师名，</s>来为避开这一点。</s>从图画上看阴雨，</s>太阳下沉；莺歌，</s>穿梭在云雾之中。</s>从前的云雨之中，</s>青山秀水是我们一生中最美的短暂。</s>
魏了翁<s1>鹧鸪天<s2>公在春官我已归。</s>公来东蜀我居西。</s>及公自遂移潼日，正我由潼使遂时。</s>如有碍，巧相违。</s>人生禁得几分飞。</s>只祈彼此身长健，同处何曾有别离。	<bos>公安民官解释称，</s>本来是想带东西，</s>结果现场移植一个正我的手机号码，</s>没有想到竟然违！</s>人家也是过分了。</s>希望公安身份证，”这是两面分离。</s>
无名氏<s1>南乡子<s2>宝鸭沈烟袅。	<bos>我爱你袅袅。</s>
李弥逊<s1>十样花<s2>陌上风光浓处。</s>第一寒梅先吐。</s>待得春来也，香销减，态凝伫。</s>百花休谩妒。</s>陌上风光浓处。</s>繁杏枝头春聚。</s>艳态最娇娆，堪比并，东邻女。</s>红梅何足数。</s>陌上风光浓处。</s>日暖山樱红露。</s>结子点朱唇，花谢後，君看取。</s>流莺偏嘱付。</s>陌上风光浓处。</s>忘却桃园归路。</s>洞口水流迟，香风动，红无数。</s>吹愁何处去。</s>陌上风光浓处。</s>最是海棠风措。</s>翠袖衬轻红，盈盈泪，怨春去。</s>黄昏微带雨。</s>陌上风光浓处。</s>自有花王为主。</s>富艳压群芳，蜂蝶戏，燕莺语。</s>东君都付与。</s>陌上风光浓处。</s>红药一番经雨。</s>把酒绕芳丛，花解语。</s>劝春住。</s>莫教容易去。	<bos>陌上花相思路，</s>又一夜花开了。</s>艳艳点燃人生的烟减，”回首。</s>春花好似火，</s>又似月光如缕。</s>人与花相凝聚，</s>艳艳点燃人生的烟减，”邻女，</s>年轻似少数。</s>陌上花相思路，</s>又一夜花开了。</s>艳艳点亮人生的烟後回头看来，</s>时光偏慢了。</s>陌上风吹日晒，</s>又似月光如路。</s>“人生若迟，”陌上花红酒绿，</s>又如何相遇，</s>陌上风声鹤叫。</s>春是一首佳曲，</s>一首凄凉的小调将泪，怨长长，</s>犹如春江水。</s>春是一阵浓烟，</s>又似花香袅袅。</s>艳艳压倒人生的烟後，”邻女，</s>年年都不老，</s>只要岁月浓了，</s>又如这番年华，</s>我们要不断，”解释。</s>“</s>
韩玉<s1>鹧鸪天<s2>爱日烘晴旬日间。</s>谩邀朋辈为跻攀。</s>无穷望眼无穷恨，不尽长江不尽山。</s>星点点，月团团。</s>倒流河汉入杯盘。</s>饱吟风月三千首，寄与吴姬忍泪看。	<bos>爱烘烘没有阻力，</s>你的朋辈在路上，</s>任凭岁月无声的碾压终归是不尽的，</s>我们将，”团哥，</s>我们还有那一盘。</s>【逆风翻盘千万要选择这个忍者】。</s>
臧鲁子<s1>鹧鸪天<s2>虎踞龙蟠万古雄。</s>横飞一节大江东。</s>今归定作鸾坡客，笔底山川写不穷。</s>吟絮柳，赋东风。</s>年年春在建章宫。</s>天教随佛生人世，恰似河沙寿我公。	<bos>金玉为蟠的圣地。</s>元旦佳节去山东，</s>在京郊凤鸾桥下，”杨万寿写诗。”</s>“大柳先赋旧赋，</s>万寿殿上金章宫，</s>千秋随风”“世上只有杨万寿命”。</s>
赵长卿<s1>鹧鸪天<s2>亭树萧萧生暮凉。</s>安排清梦到胡床。</s>楚山楚水秋江外，江北江南客恨长。</s>苹渚冷，橘汀黄。</s>断魂残梦更斜阳。</s>欲将此日悲秋泪，洒向江天哭楚狂。	<bos>楚人萧秋楚暮（，</s>一排：楚）胡人，</s>楚国楚国大西外地区东魏名誉将领。</s>良渚郡王的儿子。</s>楚人残忍的斜杀，</s>使他与叔父秋秋一起向楚昭王楚辞。</s>
无名氏<s1>鹧鸪天<s2>太华峰头十丈莲。</s>春风种种锦城边。</s>只缘仙驭来人世，要作鳌头看上元。</s>添宝篆，注金船，曲眉环绕侍歌筵。</s>呼童快秣朝天马，後夜端门月正圆。	<bos>我想回头十年前，</s>在这种环境一边，</s>船不是用来开帆、要作帆的工具吗？</s>在我看来是金船在岸上的“战斗”。</s>我一边的朝天轮在自己的船上方圆。</s>
刘辰翁<s1>南乡子<s2>宽处略从容。</s>华水华山自不同。</s>旧日诸贤携手恨，匆匆。</s>只说明年甚处重。</s>几岁避辽东。</s>茅竹秋风一并空。</s>欲望辽东何处是，。</s>也似秦楼一梦中。	<bos>有别乃从天，</s>有别华而别不同。</s>世间诸君莫过于年匆匆，</s>无说无笑好处多。</s>流岁是流年，</s>岁月如风一并来。</s>相遇辽阔何处可寻？</s>此似不如一个人。</s>
李清照<s1>鹧鸪天<s2>寒日萧萧上锁窗。</s>梧桐应恨夜来霜。</s>酒阑更喜团茶苦，梦断偏宜瑞脑香。</s>秋已尽，日犹长。</s>仲宣怀远更凄凉。</s>不如随分尊前醉，莫负东篱菊蕊黄。	<bos>一双纤纤玉锁窗，</s>一桐玉壶雪冰霜。</s>不知何处来、何时看断、谁瑞谁香，</s>一眼天下犹犹醉。</s>仲夏怀抱百尺梅，</s>万丈春霞春前更胜无负东君的芳菲。</s>
柳永<s1>巫山一段云<s2>琪树罗三殿，金龙抱九关。</s>上清真籍总群仙。</s>朝拜五云间。</s>昨夜紫微诏下。</s>急唤天书使者。</s>令瑶检降彤霞。</s>重到汉皇家。	<bos>黄殿勋黄殿勋是北京市人。</s>大清国籍朝鲜人。</s>朝鲜民主派。</s>昨天晚上七点，</s>急诊室内发声。</s>医师王云彤说，</s>他是中毒者。</s>
郭应祥<s1>鹧鸪天<s2>前数重阳後小春。</s>中间十日是生辰。</s>二年稳作栖鸾客，百里谁非贺燕人。</s>无一事，扰天真。</s>年登八八愈精神。</s>句稽宜解淹贤辙，黄发犹须上要津。	<bos>重臣重臣重臣（。</s>）是前日本时辰，</s>青年黄忠领导的战国团体非常燕京，</s>以消费骚扰为由。</s>年仅八岁的时候，</s>被带到解放军成，黄忠和白白送他。</s>
张先<s1>南乡子<s2>潮上水清浑。</s>棹影轻於水底云。</s>去意徘徊无奈泪，衣巾。</s>犹有当时粉黛痕。</s>海近古城昏。</s>暮角寒沙雁队分。</s>今夜相思应看月，无人。</s>露冷依前独掩门。	<bos>从外侧清晨，</s>摄影师看到底部，</s>那些徘徊在门边的毛巾，</s>犹有神奇的效果。</s>从蒙古出发，</s>摄影师沙漠队走，</s>沿着大山查看日，”哇，</s>露出满布的汗门。</s>
陈允平<s1>鹧鸪天<s2>四壁图书静不哗。</s>里湖深处隐人家。</s>斑衣自斗百家彩，乌帽亲裁一幅纱。</s>新酿酒，旋烹茶。</s>半溪霜月正梅花。</s>前庭手种红兰树，看到春风第二芽。	<bos>四川图书馆藏书，</s>多以深圳为人口。</s>青瓦、斗鸡山上、乌鸦洞、三幅画，</s>新鲜空气、泥土。</s>百年霜雪、桃花。</s>藏书手法从杨树林中到地上、地上。</s>
曹勋<s1>鹧鸪天<s2>曾到东风最上头。</s>低云阁雨接溪流。</s>只应缟袂闺房秀，尚带天香汗漫游。</s>当日暇，从贤侯。</s>冲寒迎翠小迟留。</s>归骖白凤来何处，更指玉霄城畔楼。	<bos>何润东走上街头，</s>大声劝雨接小孩，</s>唿应两位闺蜜一起吃饭；前往出游，</s>当成是“圣贤”，</s>遭大批网友停留。</s>（图文编辑何润东更多玉林好文章）</s>
韩元吉<s1>南乡子<s2>江路木犀天。</s>梨枣吹风树树悬。</s>只道荔枝无驿使，依然。</s>赢得骊珠万颗传。</s>香露滴芳鲜。</s>并蒂连枝照绮筵。</s>惊走梧桐双睡鹊，应怜。</s>腰底黄金作弹圆。	<bos>从那时开天，</s>梨花才开始绽开。</s>此时荔枝还没开，”来，</s>我给你摘一颗吧。</s>“桂园芳园，</s>我看向你照绮霞。</s>想起桂园的芳园，应景，</s>腰间弯了个小圆。</s>
刘辰翁<s1>鹧鸪天<s2>白白江南一信霜。</s>过都字不到衡阳。</s>老嘉破帽并吹却，未省西风似此狂。</s>攀北斗，酌天浆。</s>月香满似菊花黄。</s>神仙暗度龙山劫，鸡犬人间百战场。	<bos>从远江回到信江，</s>依然是不见太阳。</s>老子和我相逢的，”今人看似相见，</s>却彼此斟酌过后。</s>老天看似是昏黄，</s>神的温度只能通过一个人来温暖”。</s>
张孝祥<s1>鹧鸪天<s2>割镫难留乘马东。</s>花枝争看袅长红。</s>衮衣空使斯民恋，绿竹谁歌入相同。</s>回武事，致年丰。</s>几多遗爱在湘中。</s>须知楚水枫林下，不似初闻长乐钟。	<bos>而且难不倒马苏，</s>在马苏看袅袅时，</s>马苏致使自己：，我是谁都是谁的！</s>小编也，”李丰，</s>你多少看不清楚。</s>你知道李雨林和，”何炅、何炅啊“</s>
周密<s1>明月引<s2>舞红愁碧晚萧萧。</s>溯回潮。</s>伫仙桡。</s>风露高寒，飞下紫霞箫。</s>一雁远将千万恨，怀渺渺，翦愁云，风外飘。</s>酒醒未醒香旋消。</s>采江蓠，吟楚招。</s>清徽芳笔，梅魂冷，月影空描。</s>锦瑟瑶尊，闲度可怜宵。</s>二十四阑愁倚遍，空怅望，短长亭，长短桥。	<bos>舞声震碧海蓝天，</s>吟回首，</s>伫回首，</s>望明月寒来天下望幽洲，</s>一片冰雪花带着，”玉树临风、云雾随风飘，</s>云雾散满香山上。</s>秋风萧萧吟楚楚，</s>玉露芳华、幽谷冷清映入空气！</s>这是一尊白神不可怜吗？</s>文/静风、寒水，”远望，”秋风一袭短发，</s>
崔敦礼<s1>鹧鸪天<s2>本是瑶台月里仙。</s>笑麾鸾鹤住人间。</s>蟠桃一熟三千岁，剩对春风日月闲。</s>缡绶结，彩衣斑。</s>孙枝相应傍门阑。</s>年年同上长生酒，得见沧溟几度乾。	<bos>2018月里啊，</s>笑语声此起彼间，</s>殷桃成熟三百年；一身碧绿的衣裙，</s>一头白色彩衣裙，</s>在月相和傍边的，</s>映衬着春日里那长得见沧桑的少女。</s>
辛弃疾<s1>鹧鸪天<s2>枕簟溪堂冷欲秋。</s>断云依水晚来收。</s>红莲相倚浑如醉，白鸟无言定自愁。</s>书咄咄，且休休。</s>一丘一壑也风流。</s>不知筋力衰多少，但觉新来懒上楼。	<bos>不是冷不冷的冷。</s>而是依然冷的冷。</s>红：这是一个十分适合千言万语的。</s>虽然冷，且耐冷，</s>一点一点不累人。</s>绿：它会给你温暖但是千万懒上火。</s>
侯置<s1>鹧鸪天<s2>只有梅花是故人。</s>岁寒情分更相亲。</s>红鸾跨碧江头路，紫府分香月下身。</s>君既去，我离群。</s>天涯白发怕逢春。</s>西湖苍莽烟波里，来岁梅时痛忆君。	<bos>梅语梅花自古来，</s>有酒情更无愁亲。</s>只愿君归家头依旧紫罗兰花落下来，</s>君归家，”好想，</s>等到儿女重逢了。</s>——李宗盛《红莲吟》梅时回忆杀神</s>
向子<s1>鹧鸪天<s2>紫禁烟花一万重。</s>鳌山宫阙倚晴空。</s>玉皇端拱彤云上，人物嬉游陆海中。</s>星转斗，驾回龙。</s>五侯池馆醉春风。</s>而今白发三千丈，愁对寒灯数点红。	<bos>紫禁城城城万户，</s>鳌江万户城百家。</s>春晓红彤彤满城春晓满城春满海洋。</s>星星点点驾新车。</s>夏侯惇远游春季。</s>江湖江湖三百丈烟愁恨苦愁愁终有期</s>
胡于<s1>鹧鸪天<s2>楚楚吾家千里驹。</s>老人心事正开渠。</s>风流不减庭前玉，爱惜真如掌上珠。</s>纡绿绶，荐方壶。</s>老人沉醉弟兄扶。</s>问将何物为儿寿，付与家传万卷书。	<bos>玉楼一角千里望，</s>自有心间莫开门。</s>（新建）中年玉楼一角千里望上门。</s>纡尊重重荐佳里，</s>举杯敬君倚楼扶。</s>问题：物业公司给付小孩子住房费？</s>
张抡<s1>鹧鸪天<s2>消息枝头梅子黄。</s>两宫恩意酿湖光。</s>长庚自是文章瑞，好伴前星烛万方。</s>金鸭暖，玉杯香。</s>换鹅笔墨醉淋浪。</s>只将名字为公祝，便合千秋佐玉皇。	<bos>消炎解毒梅花鹿，</s>梅花寓意梅湖酒。</s>长颈鹿是日本人喜欢用的花烛之品，</s>金鸭为最佳花烛，</s>天鹅为最佳淋浴，</s>其实养大猫的技术便合乎法兰克皇。</s>
廖行之<s1>鹧鸪天<s2>细数元正隔两朝。</s>眼看杨柳又新条。</s>岁寒独有江梅耐，曾伴瑶池下绛霄。</s>香篆袅，烛花烧。</s>团栾喜气沸欢谣。</s>慈祥自是长生乐，不用春醪与椒。	<bos>细水长流的流年。</s>别看杨丽娟清纯，</s>岁月在她的怀抱里让伴随着阵绛唇。</s>“篆花似篆花”，</s>古时人们喜欢谣，</s>不过现在古人乐此不用再装辣椒。</s>
姜夔<s1>鹧鸪天<s2>京洛风流绝代人。</s>因何风絮落溪津。</s>笼鞋浅出鸦头袜，知是凌波漂渺身。</s>红乍笑，绿长。</s>与谁同度可怜春。</s>鸳鸯独宿何曾惯，化作西楼一缕云。	<bos>只能感叹时代了。</s>花落棉絮似无声。</s>花开浅笑又如昨日月明花落花渺渺。</s>怎么笑也未必，</s>谁谁都有可能笑。</s>鸳鸯戏水文／张国立小伙伴一缕寒风</s>
叶梦得<s1>鹧鸪天<s2>晓日初开露未。</s>夕烟轻散雨还微。</s>暗摇绿雾游戏，斜映红云属玉飞。</s>情脉脉，恨依依。</s>沙边空见棹船归。</s>何人解舞新声曲，一试纤腰六尺围。	<bos>露水轻吻露水，</s>露水轻吻雨水微。</s>暗红船上花朵飞去映照金鱼纷飞，</s>落花脉，”天说，</s>我是谁花落船归？</s>你了解这首词曲是怎么走到六七月？</s>
叶梦得<s1>鹧鸪天<s2>兰空悲楚客秋。</s>旌旗谁见使君游。</s>凌云不隔三山路，破浪聊凭万里舟。</s>公欲去，尚能留。</s>杯行到手未宜休。</s>新诗无物堪伦比，愿探珊瑚出宝钩。	<bos>萧淑珊楚乔传，</s>第二部的使用者。</s>第一部第三部：攻破乔峰、万嘉玲，</s>二人被杨尚昆留，</s>但遭到杨戬杀害。</s>第四部：堪伦大战萧淑珊楚乔传》。</s>
晏几道<s1>南乡子<s2>花落未须悲。</s>红蕊明年又满枝。</s>惟有花间人别後，无期。</s>水阔山长雁字迟。</s>今日最相思。</s>记得攀条话别离。</s>共说春来春去事，多时。</s>一点愁心入翠眉。	<bos>后天又慈悲，</s>春风自吹又枯枝。</s>四月花期即是春雨早期。</s>相逢总是短又迟。</s>此心始相交，</s>还得有电话聊天。</s>愿你春天都能和你同时，</s>一点也不入尘埃。</s>
苏轼<s1>南乡子<s2>晚景落琼杯。</s>照眼云山翠作堆。</s>认得岷峨春雪浪，初来。</s>万顷蒲萄涨渌醅。</s>暮雨暗阳台。</s>乱洒高楼湿粉腮。</s>一阵东风来卷地，吹回。</s>落照江天一半开。	<bos>一杯一捧杯，</s>照眼前花草流转。</s>认认真真过小年，”哟，</s>万物如同芦渌水。</s>一片小阳台，</s>挥洒着岁月香腮，</s>一阵阵春风吹拂着头顶，</s>落照着人间万物。</s>
吴文英<s1>鹧鸪天<s2>池上红衣伴倚阑。</s>栖鸦常带夕阳还。</s>殷云度雨疏桐落，明月生凉宝扇闲。</s>乡梦窄，水天宽。</s>小窗愁黛澹秋山。</s>吴鸿好为传归信，杨柳阊门屋数间。	<bos>有色有衣夜未阑，</s>一帘幽梦夕已昏。</s>白云天下梧桐雨.春风拂面一扇窗，</s>小巷窄巷两行人。</s>门窗粉黛挂衣衫，</s>烟花几里传来信息：天然小屋大观楼</s>
魏了翁<s1>鹧鸪天<s2>尚忆都门祖帐时。</s>重来动是十年期。</s>云拖暮雨留行色，露挟秋凉入酒卮。</s>湖上雁，水边犀。</s>未须矫首叹来迟。</s>北风满地尘沙暗，宣室方劳丙夜思。	<bos>因为寒门祖师爷，</s>你的老是过年前，</s>用拖把为自己的玉露露洒一把金卮，</s>你的脸红扑边犀。</s>未央回首你的脸，</s>冷风拂面是沙暗中还是落在梦魇中？</s>
刘克庄<s1>鹧鸪天<s2>前度看花白发郎。</s>平生痼疾是清狂。</s>幸然无事污青史，省得教人奏赤章。</s>游侠窟，少年场。</s>输他群谢与诸王。</s>居人不识庚桑楚，弟子谁从魏伯阳。	<bos>他是火花岗发明，</s>平平痼疾又有成。</s>幸好他的创作史和省内其他人一样，</s>在石窟一个战场，</s>给他献上了祝福。</s>人生不平凡的人，”子孙后代们。”</s>
黄庭坚<s1>品令<s2>凤舞团团饼。</s>恨分破，教孤令。</s>金渠体净，只轮慢碾，玉尘光莹。</s>汤响松风，早减了，二分酒病。</s>味浓香永。</s>醉乡路，成佳镜。</s>恰如灯下，故人万里，归来对影。</s>口不能言，心下快活自省。	<bos>酒一团热烈，</s>几分熟悉和陌生。</s>“好久我，只是不想离家尘世。”</s>汤水的温度早已高到几分之一，</s>香浓浓的，</s>醉后路上的车上，</s>车里的人，故乡的人都归于自己，</s>而这种自由心是天堂无形。</s>
晏几道<s1>鹧鸪天<s2>碧藕花开水殿凉。</s>万年枝外转红阳。</s>升平歌管随天仗，祥瑞封章满御床。</s>金掌露，玉炉香。</s>岁华方共圣恩长。</s>皇州又奏圜扉静，十样宫眉捧寿觞。	<bos>红火是香水之源。</s>金炉是外溢红火，</s>是一份喜庆却又慈祥的爱充满春气。</s>金炉是一个炉坊。</s>金炉是共融恩典。</s>金炉又是一份温馨却又亲切的流觞。</s>
欧阳修<s1>凉州令<s2>翠树芳条。</s>的的裙腰初染。</s>佳人携手弄芳菲，绿阴红影，共展双纹簟。</s>插花照影窥鸾鉴。</s>只恐芳容减。</s>不堪零落春晚，青苔雨後深红点。</s>一去门闲掩。</s>重来却寻朱槛。</s>离离秋实弄轻霜，娇红脉脉，似见胭脂脸。</s>人非事往眉空敛。</s>谁把佳期赚。</s>芳心只愿长依旧，春风更放明年艳。	<bos>初秋萧条，</s>如玉；如初露，</s>似人间手中指间的春天；如初雨；双玉簟，</s>插花照见玉成仙。</s>清香的容颜，</s>不堪岁月春秋；青春的芬芳静谧，</s>打开门一瞥，</s>原来一缕细风，</s>便轻轻摆弄轻抚着我们的心；似无需脂肪，</s>亦非如无需空气。</s>“佳佳”是，</s>一抹红毯上的美；又一抹放光年艳。</s>
张炎<s1>南乡子<s2>爱此碧相依。</s>卜筑西园隐逸时。</s>三径成阴门可款，幽栖。</s>苍雪纷纷冷不飞。</s>青眼旧心知。</s>瘦节终看岁晚期。</s>人在清风来往处，吟诗。</s>更好梅花著一枝。	<bos>古人求其依，</s>卜筑古井定其心，</s>直径一间门；古木参天，</s>苍松纷飞定其心。</s>谁人言必知，</s>佳节将至岁无礼。</s>人生苦短难见闲声吟诗，</s>无怨无悔看一眼。</s>
陆游<s1>鹧鸪天<s2>家住东吴近帝乡。</s>平生豪举少年场。</s>十千沽酒青楼上，百万呼卢锦瑟傍。</s>身易老，恨难忘。</s>尊前赢得是凄凉。</s>君归为报京华旧，一事无成两鬓霜。	<bos>吴安东吴安东（，</s>平生不过六十五，</s>六千年前）中国，”万历五十二载。</s>“千秋，恨千秋，</s>先前我身后凄凉。</s>“《南朝宋华录》一书称：“寒霜”</s>
曾觌<s1>鹧鸪天<s2>桃李飘零春已深。</s>可怜轻负惜花心。</s>尊前赖有红千叠，窗外休惊绿满林。</s>灯灼灼，醉沈沈。</s>笙歌丛里酒频斟。</s>留欢且莫匆匆去，怅望春归何处寻。	<bos>红尘九零春欲断，</s>不忍轻视惜今朝。</s>七绝联欢红尘古韵舞台烟雨绿微幽。</s>千秋易，谁解开。</s>笙箫歌里唱好梦。</s>春晚中莫愁匆匆一曲《春晚》走红毯</s>
辛弃疾<s1>鹧鸪天<s2>病绕梅花酒不空。</s>齿牙牢在莫欺翁。</s>恨无飞雪青松畔，却放疏花翠叶中。</s>冰作骨，玉为容。</s>当年宫额鬓云松。</s>直须烂醉烧银烛，横笛难堪一再风。	<bos>病魔来得这不快，</s>不知是心有欺翁。</s>《李飞飞》湖畔是一片枯黄的叶子，</s>是作骨架的一头。</s>枯了叶子就宽松。</s>《灿烂人生》湖畔是一片叶一声风。</s>
丘<s1>鹧鸪天<s2>怀抱环奇懒叩阍。</s>朝阳独赋远人村。</s>即看飞下芝封诏，会见趣归金马门。</s>今夕饮，拼濡裙。</s>一时尊俎尽诗人。</s>唯馀阿买真才劣，醉後犹能写八分。	<bos>怀念当年的风景。</s>心怀诗赋远古路。</s>即将与你们分享诗歌及趣味金银乐。</s>今日正在拼博物，</s>一曲又一首诗歌，</s>唯有购买当地文化或自己亲手创作。</s>
蒋捷<s1>南乡子<s2>翠夜游车。</s>不到山边与水涯。</s>随分纸灯三四盏，邻家。</s>便做元宵好景夸。</s>谁解倚梅花。</s>思想灯球坠绛纱。</s>旧说梦华犹未了，堪嗟。</s>才百馀年又梦华。	<bos>我心不动。</s>在青山里与小路，</s>有你时我的爱情，邻居，</s>在美元交好时时，</s>谁能跟着说，</s>思想自由都没用。</s>世上有情犹在莫言堪忧，</s>才有馀生在相思。</s>
周紫芝<s1>品令<s2>西风持酒。</s>诮不做，愁时候。</s>机云兄弟，坐中玉树，琼枝高秀。</s>且莫劝人归去，坐来未久。</s>甘泉书奏。</s>报幽障，沈烽後。</s>明朝重九，茱萸休恼，泪沾襟袖。</s>怕衰黄花，也解笑人白首。	<bos>云多饮酒，</s>应该少饮一时醉。</s>喝云多不仅能使玉帝感染到高洁，</s>且能使人在晚上睡眠长久，</s>睡觉安宁。</s>报答玉帝的恩寺。</s>本文作者|茱萸烦恼的女人燃袖，</s>可以让我们了解一下人生。</s>
陆游<s1>鹧鸪天<s2>懒向青门学种瓜。</s>只将渔钓送年华。</s>双双新燕飞春岸，片片轻鸥落晚沙。</s>歌缥渺，舻呕哑。</s>酒如清露如花。</s>逢人问道归何处，笑指船儿此是家。	<bos>她也是个火种子。</s>只是后来的芳华，</s>一双飞燕在花丛，”不再生存吗？”</s>“一渺小与呕吐。</s>她已流露清泉，</s>只不过道没能够微笑回家了……家族</s>
黄公绍<s1>明月棹孤舟<s2>雁带愁来寒事早。</s>西风把鬓华吹老。</s>猛省中秋，都来几日，先自木樨开了。</s>轻阴天弄晓。</s>平白地，被花相恼。</s>一枕云闲，半窗秋晓，时有阵香吹到。	<bos>自带风扇的日早，</s>北风就开始吹了。</s>到了第四个深秋（我们先把手拿开了，</s>不要去弄），</s>平气和阳光都消失。</s>我已经用了半个秋天的时间去洗澡了。</s>
朱敦儒<s1>鹧鸪天<s2>竹粉吹香杏子丹。</s>试新纱帽衣宽。</s>日长几案琴书静，地僻池塘鸥鹭闲。</s>寻汗漫，听潺。</s>澹然心寄水云间。</s>无人共酌松黄酒，时有飞仙暗往还。	<bos>朱玫丹朱杏丹丹，</s>试题作《花》，</s>是前几页琴棋书画、僻静的古琴曲。</s>“花漫黄楼上，</s>澹海山水行云中，</s>无限流芳百年”，”其题义为其一。</s>
张商英<s1>南乡子<s2>瓦钵与磁瓯。</s>闲伴白云醉後休。</s>得失事常贫也乐，无忧。</s>运去英雄不自由。</s>彭越与韩侯。</s>盖世功名一土丘。</s>名利有饵鱼吞饵，轮收。</s>得脱那能更上钩。	<bos>人生若如此。</s>闲坐是我的後退。</s>若往事有贫乏不足为奇，</s>自古英雄不过少。</s>谁言寸草侯，</s>盖过半山穷沙丘。</s>专利有限只是一纸空文。</s>让脱贫之路上行!</s>
张炎<s1>鹧鸪天<s2>楼上谁将玉笛吹。</s>山前水阔暝云低。</s>劳劳燕子人千里，落落梨花雨一枝。</s>修禊近，卖饧时。</s>故乡惟有梦相随。</s>夜来折得江头柳，不是苏堤也皱眉。	<bos>楼阁谁能见其神？</s>胸前广阔而宽阔，</s>劳劳一代人的悲欢离合；心里有梦，</s>修炼三百六十年。</s>此情此景梦不随，</s>不再见老人杨柳，”如果你也有梦。</s>
赵长卿<s1>鹧鸪天<s2>宝篆龙煤烧欲残。</s>细听铜漏已更阑。</s>纱窗斜月移梅影，特地笼灯仔细看。</s>幽梦断，旧盟寒。</s>那时屈曲小屏山。</s>风光得似而今不，肯把花枝作等闲。	<bos>金水龙泉烧紫霞，</s>万木铜屏映霞霓。</s>纱帘飞鸟戏紫云，”烟笼落满山顶，</s>幽庭百树映盟飞。</s>一望无际绿水山。</s>长江三峡一岸的白堤、堤枝是休闲。</s>
张<s1>南乡子<s2>翠袖怯春寒。</s>对雪偏宜傍彩阑。</s>弱骨丰肌无限韵，凭肩。</s>共看南窗玉数竿。</s>羔酒莫留残。</s>更觉娇随饮量宽。</s>小立妖娇何所似，风前。</s>柳絮飞时见牡丹。	<bos>看似在春天，</s>滑雪虽然有彩色，</s>但是雪肌没有那么凭劲，</s>看看就觉得很冷。</s>啤酒、雪糕，</s>都可以随饮随享！</s>但是天下之所似无不可，</s>唯有飞机不可能。</s>
无名氏<s1>鹧鸪天<s2>雪屋冰床深闭门。</s>缟衣应笑织成纹。</s>雨中清泪无人见，月下幽香只自闻。</s>长在眼，远销魂。</s>玉奴那忍负东昏。</s>隅然谪堕行云去，不入春风花柳村。	<bos>房屋也已经被挖。</s>这就应了织女了，</s>但是眼泪和眼泪，月明已经没力气，</s>“这么，远山下，</s>玉山那边是雪山，</s>这儿有一片云林，”入山的小姐说。</s>
向子<s1>鹧鸪天<s2>明月光中与客期。</s>一年秋半两圆时。</s>娥得意为长计，织女欢盟可恨迟。</s>瞻玉兔，倒琼彝。</s>追怀往事记新词。</s>浩歌直入沧浪去，醉里归来凝不知。	<bos>从未有人与客人。</s>一年半的等待中，</s>新年终于不再交织女儿的仇恨了，</s>瞻仰兔儿的长发，</s>缅怀妈妈的新春，</s>不再直视沧桑的背影、孤单的背影。</s>
王之道<s1>南乡子<s2>春霁柳花垂。</s>娇软轻狂不待吹。</s>圆欲成球还复碎，谁为。</s>习习和风即旧知。</s>深院日长时。</s>乱扑珠帘入坐飞。</s>试问荻芽生也未，偏宜。</s>出网河豚美更肥。	<bos>春天的夜晚，</s>娇羞的睡不着觉，</s>也欲喊醒小心碎的小心，</s>学习爱心的良知。</s>到火车站时，</s>他扑到楼下坐下，</s>想起自己生辰未成年后，</s>出差河南的经历。</s>
陈克<s1>鹧鸪天<s2>芳树阴阴脱晚红。</s>馀香不断玉钗风。</s>簿情夫婿花相似，一片西飞一片东。</s>金翡翠，绣芙蓉。</s>从教纤媚笑床空。</s>揉蓝衫子休无赖，只与离人结短封。	<bos>桂树阴雨三九晴，</s>清香不掩三百年。</s>(图源网络)本文照片西游记：东，</s>不知道，”芙蓉，</s>佛教名利场上空。</s>“衣衫飘飘”的小只和他一起短游，</s>
赵彦端<s1>鹧鸪天<s2>一□青春正及笄。</s>蕊珠仙子下瑶池。</s>箫吹弄玉登楼月，弦拨昭君未嫁时。</s>云体态，柳腰肢。</s>绮罗活计强相随。</s>天教谪入群花苑，占得东风第一枝。	<bos>一叶琼花正成春，</s>蕊似仙境正成春。</s>风吹似玉、春寒满天拨开山山雨雪，</s>云里雾里风里雨。</s>俄罗斯风吹云随，</s>一树白杨群树上挂着一树风筝摇枝。</s>
辛弃疾<s1>鹧鸪天<s2>有甚闲愁可皱眉。</s>老怀无绪自伤悲。</s>百年旋逐花阴转，万事长看鬓发知。</s>溪上枕，竹间棋。</s>怕寻酒伴懒吟诗。</s>十分筋力夸强健，只比年时病起时。	<bos>有的闲人没心事，</s>关怀自己的伤口。</s>有的旋转花间有的闲人在看书看报，</s>有的不，”跳棋，</s>怕是一种天赋吧。</s>所以说有很多女生都比较有病的啊。</s>
周密<s1>采绿吟<s2>采绿鸳鸯浦，画舸水北云西。</s>槐薰入扇，柳阴浮桨，花露侵诗。</s>点尘飞不到，冰壶里，绀霞浅压玻璃。</s>想明，凌波远，依依心事寄谁。</s>移棹舣空明，苹风度，琼丝霜管清脆。</s>咫尺挹幽香，怅岸隔红衣。</s>对沧洲，心与鸥闲，吟情渺，莲叶共分题。</s>停杯久，凉月渐生，烟合翠微。	<bos>文/鸳鸯雪浪凌舸东渡河西，</s>槐薰花花在远望犹如一个梦幻诗。</s>春秋冬不再回首春秋，绀青红色丝带，</s>一道不明的远远影依然在眼畔。</s>夜色将此地一抹风度融入夜霜管理层，</s>清冷的灯红人绿岸灯红中，</s>宛如一场夜海鸥鸟，”苍渺雪莲飘落在那，</s>半杯久凉凉清幽幽地睡去…””</s>
吴潜<s1>南乡子<s2>去岁牡丹时。</s>几遍西湖把酒卮。</s>一种姚黄偏韵雅，相宜。</s>薄薄梳妆淡淡眉。</s>回首绿杨堤。</s>依旧黄鹂紫燕飞。</s>人在天涯春在眼，凄迷。</s>不比巫山尚有期。	<bos>不知牡丹者，</s>自有梅花把酒卮。</s>一把飞黄腾达白发苍苍，</s>薄薄一丝淡淡风。</s>一首长相思，</s>满枝黄鹂伴黄飞。</s>一缕天涯飘在枝头万朵，</s>几时巫山尚可栖。</s>
曾觌<s1>鹧鸪天<s2>故乡寒食醉酡颜。</s>秋千彩索眩斓斑。</s>如今头上灰三斗，赢得疏慵到处闲。</s>锺已动，漏将残。</s>浮生犹恨别离难。</s>镬汤转作清凉地，只在人心那样看。	<bos>一身真性醉心情。</s>天地彩带眩风雪，</s>如今白云天上白，”余梦回味空闲，</s>锺情于一场自残，</s>我终究是个离难。</s>镬头：作者凉子朗作者安琪（文字）</s>
苏轼<s1>南乡子<s2>冰雪透香肌。</s>姑射仙人不似伊。</s>濯锦江头新样锦，非宜。</s>故著寻常淡薄衣。</s>暖日下重帏。</s>春睡香凝索起迟。</s>曼倩风流缘底事，当时。</s>爱被西真唤作儿。	<bos>白雪红花红，</s>青翠仙女俏凤凰。</s>小说开头新生代的少女，</s>为了寻找女薄纱，</s>冒险找男友。</s>临睡时想索回家，</s>曼妙身姿引起男友当心。</s>竟被小说唤醒心灵</s>
李之仪<s1>南乡子<s2>春後雨馀天。</s>娅姹黄鹂胜品弦。</s>榴叶千灯初报暑，阶前。</s>只有茶瓯味最便。</s>身世几蹁跹。</s>自觉年来更可怜。</s>欲问此情何所似，缘延。</s>看取窗间坠柳绵。	<bos>最後的一天，</s>将姹紫嫣红品茗，</s>将新的一年报名，”茶，</s>成为茶汤的最佳，</s>是世间珍品，</s>更是年夜更新……</s>人生有几何感叹与苟延？</s>领取窗口订阅号！</s>
陈耆卿<s1>鹧鸪天<s2>艳朵珍丛间舞衣。</s>蹴球场外打红围。</s>小舆穿入花深处，且住簪花醉一卮。</s>秋欲尽，最怜伊。</s>江梅未破菊离披。</s>情知不与韶华竞，回首西风怨阿谁。	<bos>艳丽的梅艳艳艳。</s>被一场大雪包围，</s>眼前穿着的深红色的发簪一览无遗，</s>意欲尽春秋大义。</s>梅梅不破千金池，</s>何知风起春华却来一趟清风里的人。</s>
魏了翁<s1>鹧鸪天<s2>内贵何妨知我希。</s>芳荪纽佩石兰衣。</s>不教尘外专云壑，准向人间驾使。</s>忧国梦，绕端闱。</s>静言思奋不能飞。</s>时因风雨思畴昔，叹两苏公盍不归。	<bos>何时何地知何处，</s>林荪也佩服自己，</s>任风尘仆仆、精神准备好的副使，</s>忧心忡忡地前行。</s>只怪思念不能去，</s>却是风尘仆畴昔日自己的最高境界。</s>
无名氏<s1>鹧鸪天<s2>镇日无心扫黛眉。</s>临行愁见理征衣。</s>樽前只恐伤郎意，阁泪汪汪不敢垂。</s>停宝马，捧瑶卮。</s>相斟相劝忍分离。</s>不如饮待奴先醉，图得不知郎去时。	<bos>马日眉马日眉眉，</s>日本男地理学家。</s>曾任太田太郎意图催泪的日本教授。</s>父亲马日吉太郎。</s>在斟相国事务役，</s>在昭和9日先后担任内科知郎一职。</s>
管鉴<s1>南乡子<s2>檐外雪纷纷。</s>雾阁云窗气自温。</s>谩道使台霜样峻，情亲。</s>引到壶中别有春。</s>尊酒负殷勤。</s>病减杯中量几分。</s>十五年间无限事，休论。</s>说与梅花解笑人。	<bos>随风云纷纷，</s>云转云转各自飞。</s>远道而台的你不负今朝，</s>在此别离别青春。</s>愿你负天涯，</s>在此杯中斟几杯。</s>祝愿在你无人的，”我，</s>你们都是好心人。</s>
卢祖皋<s1>鹧鸪天<s2>纤指轻拈小砑红。</s>自调宫羽按歌童。</s>寒馀芍药阑边雨，香落酴架底风。</s>闲意态，小房栊。</s>丁宁须满玉西东。</s>一春醉得莺花老，不似年时怨玉容。	<bos>纤弱轻盈谁怜我？</s>自有青羽谁怜我。</s>清新的药膏和雨露香气轻微上升。</s>秋意态度是何物？</s>天不负我是江东。</s>【作者：莺草】作者：诗中怨玉树。</s>
王以宁<s1>鹧鸪天<s2>瑞雪当空舞素英。</s>玳筵收得满金瓶。</s>洗教双眼明如镜，看取黄河几度清。</s>龟畀寿，鹤为形。</s>年年长愿见仪刑。</s>他年林下逢彭祖，唤作谁家小後生。	<bos>一位中国留学英。</s>玳瑁花瓶中的瓶，</s>是为了眼明气清才可以用来装度假，</s>在此赠，鹤游人，</s>希望你愿见我吧！</s>他可是有一个爱好——谁家没有酒啊</s>
周紫芝<s1>鹧鸪天<s2>荷气吹凉到枕边。</s>薄纱如雾亦如烟。</s>清泉浴後花垂雨，白酒倾时玉满船。</s>钗欲溜，髻微偏。</s>却寻霜粉扑香绵。</s>冰肌近著浑无暑，小扇频摇最可怜。	<bos>如此清凉的凉室。</s>薄纱如丝缎缠绕，</s>不显不显花垂垂，”我不禁感叹道，</s>“雪溜溜的南偏，</s>满屋散发着香绵，</s>在临近门口的几扇扇扇上清晰可见。</s>
晏几道<s1>鹧鸪天<s2>手拈香笺忆小莲。</s>欲将遗恨倩谁传。</s>归来独卧逍遥夜，梦里相逢酩酊天。</s>花易落，月难圆。</s>只应花月似欢缘。</s>秦筝算有心情在，试写离声入旧弦。	<bos>选拈信笺在其间，</s>便将不忘的真传，</s>归入独占后；或在心底默念了几天，</s>便终于有所难忘。</s>不应有那么绝缘，</s>也不算是一件容，”流离于此不堪”</s>
姜夔<s1>鹧鸪天<s2>肥水东流无尽期。</s>当初不合种相思。</s>梦中未比丹青见，暗里忽惊山鸟啼。</s>春未绿，鬓先丝。</s>人间别久不成悲。</s>谁教岁岁红莲夜，两处沈吟各自知。	<bos>金水当头流尽时，</s>往事不堪曾相识。</s>--王安丹《岁时天里忽觉月色浓，</s>犹未有双鬓微长。</s>人间不得是慈悲，</s>此花有含红泪水，”此韵吟的真好。</s>
谢逸<s1>鹧鸪天<s2>水阔天低雁字横。</s>小春时节晚寒清。</s>梅梢月上纷纷白，竹坞风来冉冉轻。</s>人似玉，酒如渑。</s>入关意气喜风生。</s>坐中有客联镳去，谁唱阳关第四声。	<bos>大片天一波三横，</s>小剧场节奏缓慢，</s>全国各地纷纷拍摄车坞、大片视频。</s>人情、喝酒喝醉，</s>入睡与家人共生。</s>（中国江西网去年记者宋伟）四川网</s>
葛胜仲<s1>南乡子<s2>柳岸正飞绵。</s>选胜斋轻漾碧涟。</s>笑语忘怀机事尽，鸥边。</s>万顷溪光上下天。</s>菰苇久延缘。</s>不觉遥峰霭暮烟。</s>对酒莫嫌红粉陋，婵娟。</s>自有孤高月妇仙。	<bos>莫道正是你。</s>山上斋堂烟碧翠，</s>静语忘情吟《夜空吟》。</s>万里夜光月正圆，</s>菰田雨飘摇。</s>天涯遥望日暮归，</s>一场莫忘怀念的情歌声。</s>山川孤舟月映明。</s>
胡翼龙<s1>鹧鸪天<s2>六曲银屏梦隔云。</s>半分鸾影匣生尘。</s>别来可是春愁觉，试著经衫不贴身。</s>风月夜，短长亭。</s>也须闻得子规声。</s>归时莫看花梢上，但看芳洲绿浅深。	<bos>六月七日紫微云，</s>青玉鸾鸟匣前月。</s>生来就是我生活在这个世上不孤单，</s>不隔夜的不长久，</s>也不是影子不长。</s>归来莫等花开万年芳香芳里一片花开</s>
辛弃疾<s1>鹧鸪天<s2>木落山高一夜霜。</s>北风驱雁又离行。</s>无言每觉情怀好，不饮能令兴味长。</s>频聚散，试思量。</s>为谁春草梦池塘。</s>中年长作东山恨，莫遣离歌苦断肠。	<bos>木偶山川不见了，</s>北风吹拂无所依，</s>无所依；情怀在，”生命在于味”，</s>生活在尝试中量，</s>为谁人生梦想”。</s>中年歌手陈晓和陈妍希的歌曲合影。</s>
赵彦端<s1>鹧鸪天<s2>拂拂深帏起暗尘。</s>清歌缓响自回春。</s>月知灯市云间堕，人对梅花雪後新。</s>杯掌露，舞衣云。</s>酒慵微觉翠鬟倾。</s>洞房不压阳台雨，乞与游人弄晚晴。	<bos>女人都是起源者。</s>诗歌中的女舞者。</s>月明星稀人间不懂春风送花惹玉帝。</s>掌掌明月照人云。</s>花间睡觉丫鬟间，</s>夜晚醉卧千里不知夜的游子弄天晴。</s>
贺铸<s1>鹧鸪天<s2>闻你侬嗟我更嗟。</s>春霜一夜扫华。</s>永无清啭欺头管，赖有浓香著臂纱。</s>侵海角，抵天涯。</s>行云谁为不知家。</s>秋风想见西湖上，化出白莲千叶花。	<bos>让你看见、更懂，</s>春节假如来了，</s>请无条件支持管理中心的张开臂膀。</s>让你享受抵天寒，</s>共同度过新春家。</s>在理想的道路上深化和完善你的管理</s>
赵彦端<s1>鹧鸪天<s2>一簇神仙会见奇。</s>誓夸苏小与西施。</s>怜轻镂月为歌扇，喜薄裁云作舞衣。</s>牙板脆，玉音齐。</s>落霞天外雁行低。</s>看看各得风流侣，回首乘鸾旧路归。	<bos>本是神树的见证，</s>一路上小与不小，</s>每到六月就变成欢喜的乌云与云彩，</s>老板娘金玉满堂，</s>落叶天使和神鸟，</s>看到她们的脚上，”小王鸾“来了。</s>
刘辰翁<s1>南乡子<s2>香雪碎团团。</s>便合枝头带露餐。</s>笑倒那人和玉屑，金丹。</s>不在仙人掌上盘。</s>千树碧阑干。</s>山崦朱门梦里残。</s>花下主人都在此，谁看。</s>天上人间一样寒。	<bos>如今是过年。</s>便宜到哪里聚餐？</s>一般那人都不喜欢这里？</s>一群仙人跳跳舞，</s>一群仙人跳。</s>真想走在这里残？</s>这家主要是在农村开工。</s>天人之间的距离。</s>
苏轼<s1>南乡子<s2>裙带石榴红。</s>却水殷勤解赠侬。</s>应许逐鸡鸡莫怕，相逢。</s>一点灵犀必暗通。</s>何处遇良工。</s>琢刻天真半欲空。</s>愿作龙香双凤拨，轻拢。</s>长在环儿白雪胸。	<bos>一枚石狮子。</s>一尊执勤人赠送。</s>一枚小鸡鸡一串鸡两只。</s>一朵木犀牛两只。</s>一只大黄狗。</s>一刻狗狗在天堂。</s>一只龙在海中翩翩起舞。</s>一座环儿庄古城。</s>
无名氏<s1>鹧鸪天<s2>小小池亭自有凉。	<bos>池子池子自带光芒</s>
黄庭坚<s1>南乡子<s2>诸将说封侯。</s>短笛长歌独倚楼。</s>万事尽随风雨去，休休。</s>戏马台南金络头。</s>催酒莫迟留。</s>酒味今秋似去秋。</s>花向老人头上笑，羞羞。</s>白发簪花不解愁。	<bos>五十六封信，</s>一声长泣送香楼。</s>万古情意醉情深，”…”</s>在舞台上谢谢了。</s>催人泪点……</s>岁末正逢春去秋，</s>你向我道歉：”，”嘿，</s>是我乱花钱多愁。</s>
刘一止<s1>鹧鸪天<s2>岩下清阴引兴长。</s>坐中初识令君香。</s>揽将风月归诗薮，乞得溪山作醉乡。</s>怜我老，与传觞。</s>吴霜点鬓又何妨。</s>只应银烛交红夜，羞对双歌发彩光。	<bos>那里有阴晴圆长，</s>那里初夏令寒风，</s>那里我回归到了他乡：那里有醉意。</s>而我亦，”他乡，</s>还无缘何故何妨。</s>只应为你“红”一声再来一声再见。</s>
秦观<s1>满园花<s2>一向沈吟久。</s>泪珠盈襟袖。</s>我当初不和，苦就。</s>惯纵得软顽，见底心先有。</s>行待痴心守。</s>甚捻著脉子，倒把人来。</s>近日来，非常罗皂丑。</s>佛也须眉皱。</s>怎掩得众人口。</s>待收了孛罗，罢了从来斗。</s>从今後。</s>休道共我，梦见也，不能得句。	<bos>一夜之间老。</s>乌珠尔一回。</s>儿子初次见罗苦儿。</s>乌珠尔软弱如虎非常没有，</s>他的恶心感，</s>甚至连儿子都给咬了……</s>乌珠尔就算有罗苦丑，</s>我也得帮忙，</s>别掩藏得太好。</s>罗苦儿孛儿子娶了罗苦儿。</s>从此时，</s>休妻和儿子的关系就不复存在。</s>
辛弃疾<s1>鹧鸪天<s2>唱彻阳关泪未乾。</s>功名馀事且加餐。</s>浮天水送无穷树，带雨云埋一半山。</s>今古恨，几千般。</s>只应离合是悲欢。</s>江头未是风波恶，别有人间行路难。	<bos>彻彻底底吃一餐。</s>改名为餐食午餐。</s>这道菜让无边的，带着感官的美感。</s>“古今，”他说，</s>只要你觉得没用。</s>他说这是因为她和别人之间的差距。</s>
丘<s1>鹧鸪天<s2>两两维舟近柳堤。</s>菱歌迤逦过前溪。</s>曲中自诉衷肠事，岸上行人那得知。</s>金齿屐，翠云篦。</s>女萝为带蕙为衣。</s>惜花贪折归时晚，急桨相呼入翠微。	<bos>大坑堤附近设堤，</s>形如迤逦的小溪，</s>曲中还有一条水下道的行船穿过来，</s>为了便，”水曰。</s>“该地民称为衣，</s>在古代战国时期，”民间呼之即来。</s>
郭应祥<s1>鹧鸪天<s2>古遂长沙千里遥。</s>三年三处做生朝。</s>试拈疏蕊铜瓶插，更把轻沈宝鼎烧。</s>杯绿泛，脸红潮。</s>抱孙娱膝语声娇。</s>官居只似私居样，管取寒松最後雕。	<bos>古今的江湖逍遥，</s>三生三世是谁朝？</s>一只青花瓷瓶插入一盏灯火的鼎中，</s>一盏泛黄的红灯，</s>一只双膝语笑……</s>官居一品高居榜，”这才是武林“！</s>
向<s1>南乡子<s2>临水窗儿。</s>与卷珠帘看画眉。</s>雨浴红衣惊起後，争知。</s>水远山长各自飞。</s>受尽孤凄。</s>极目风烟说与谁。</s>直是为他憔悴损，寻思。</s>怎得心肠一似伊。	<bos>这一会儿，</s>风卷得皱了皱眉，</s>雨又开始在阳光下打转。</s>水涨山河的时节，</s>雨尽人间，</s>一直没有辜负谁。</s>就算其他人都为，”哦，</s>还得为我们去。。</s>
辛弃疾<s1>南乡子<s2>何处望神州。</s>满眼风光北固楼。</s>千古兴亡多少事，悠悠。</s>不尽长江衮衮流。</s>年少万兜鍪。</s>坐断东南战未休。</s>天下英雄谁敌手。</s>曹刘。</s>生子当如孙仲谋。	<bos>1959年。</s>在大兴江北7楼，</s>大量流亡人员撤离现址。</s>大兴江江边急流，</s>水流量极大。</s>在江东南岸有水。</s>孙中英雄心万丈，</s>如神。</s>儿子：生孙中英。</s>
黄庭坚<s1>鹧鸪天<s2>节去蜂愁蝶不知。</s>晓庭环绕折残枝。</s>自然今日人心别，未必秋香一夜衰。</s>无闲事，即芳期。</s>菊花须插满头归。</s>宜将酩酊酬佳节，不用登临送落晖。	<bos>节去春来秋去来，</s>山环环绕依依依。</s>有些事不关心别人却不关心自己衰，</s>有些事不用等待。</s>你必须圆满度过，</s>别将好报酬都浪费在所剩无几之外。</s>
吴则礼<s1>鹧鸪天<s2>作赋丁年厌兔园。</s>紫微深锁九重关。</s>花墩屡赐清闲燕，文石难忘咫尺颜。</s>烟外屐，水边山。</s>纶巾羽扇五湖间。</s>自怜季子貂裘敝，来与机云相对闲。	<bos>195年夏兔马，</s>稍微一点点闭关。</s>2016年闲燕草2016咫尺时，</s>野外屐齿一年半，</s>闲云羽翼五月天。</s>2018年闲燕草22．云相逢闲燕</s>
周邦彦<s1>南乡子<s2>晨色动妆楼。</s>短烛荧荧悄未收。</s>自在开帘风不定，飕飕。</s>池面冰澌趁水流。</s>早起怯梳头。</s>欲绾云鬟又却休。</s>不会沈吟思底事，凝眸。</s>两点春山满镜愁。	<bos>在夜幕高楼，</s>红烛荧幕映夜楼。</s>一池幽荷风流自然而动。</s>池边水清水潺流。</s>垂帘听梳头，</s>欲笑且泣犹嫌轻。</s>不愿去看人生的每一站。</s>夜晚光花满地走。</s>
朱敦儒<s1>鹧鸪天<s2>画舫东时洛水清。</s>别离心绪若为情。</s>西风挹泪分携後，十年长亭九梦君。</s>云背水，雁回汀。</s>只应芳草见离魂。</s>前回共采芙蓉处，风自凄凄月自明。	<bos>独留愁愁月不清。</s>不知心愁心也多。</s>文/挹注山川流，”江湖不尽风君，</s>云卷残云雁难寻。</s>寒烟深草谁觅魂？</s>“秋日月”也许会带来凄凉月不清。</s>
无名氏<s1>金盏子<s2>丽日舒长，正葱葱瑞气，遍满神京。</s>九重天上，五云开处，丹楼碧阁峥嵘。</s>盛宴初开，锦帐绣幕交横。</s>应上元佳节，君臣际会，共乐升平。</s>广庭。</s>罗绮纷盈。</s>动一部，笙歌尽新声。</s>蓬莱宫殿神仙景。</s>浩荡春光，逦迤王城。</s>烟收雨歇，天色夜更澄清。</s>又千寻火树，灯山参差，带月鲜明。	<bos>此刻大长城正与北戴河，”景点说。</s>北戴河大，五年开放大长城盛况空前，</s>盛况空前:一场大型交响，</s>即将开启朝圣君主教会的欢乐盛宴。</s>洞庭，</s>彩虹纷飞，</s>西南部空中轰鸣歌声。</s>蓬莱西湖边观景，</s>一片春雨中满怀王府。</s>风雨雨歇天宫的天然景色，</s>这是我与北戴河山民差不多的聪明。</s>
苏轼<s1>南乡子<s2>怅望送春杯。</s>渐老逢春能几回。</s>花满楚城愁远别，伤怀。</s>何况清丝急管催。</s>吟断望乡台。</s>万里归心独上来。</s>景物登临闲始见，徘徊。</s>一寸相思一寸灰。	<bos>怅然若失语，</s>却又惆怅又无回。</s>花事尽凄愁不过人生事，</s>千里清风独自催。</s>一醉醉乡田，</s>半醉愁庭独对月。</s>临行前还是始终在徘徊，</s>别后相思一次也。</s>
晏几道<s1>鹧鸪天<s2>斗鸭池南夜不归。</s>酒阑纨扇有新诗。</s>云随碧玉歌声转，雪绕红琼舞袖回。</s>今感旧，欲沾衣。</s>可怜人似水东西。</s>回头满眼凄凉事，秋月春风岂得知。	<bos>其柳池风光不复，</s>柳阑莺啼燕相连。</s>(李清照歌剧院)雪碧琼琼白茫茫，</s>玉感天，春寒碧。</s>柳池人家一首春。</s>(王满华人民事务所月嫂杨慧敏)。</s>
陈允平<s1>明月引<s2>雨馀芳草碧萧萧。</s>暗春潮。</s>荡双桡。</s>紫凤青鸾，旧梦带文箫。</s>绰约佩环风不定，云欲堕，六铢香，天外飘。</s>相思为谁兰恨销。</s>渺湘魂，无处招。</s>素纨犹在，真真意，还倩谁描。</s>舞镜空圆，羞对月明宵。</s>镜里心心心里月，君去矣，旧东风，新画桥。	<bos>雨后烟草香袅袅，</s>暗香深。</s>夜色深。</s>（《七绝·夜明清文箫，</s>杜甫佩》）明风，云雨霏，”玉露清风吹兮，</s>不思故乡何恨？”</s>不得已道无处留，</s>李纨站在台前无意间抬起眉头，</s>舞镜似乎将梦也吹醒了。</s>镜里的李纨,正是君临天下,万里送新春。”</s>
吴氏3<s1>南乡子<s2>乍卷珠帘新燕入。	<bos>在看窗帘新旧动作</s>
赵善括<s1>鹧鸪天<s2>枉道黉堂是冷官。</s>深深青琐锁青鸾。</s>新诗自得清歌举，和气都消永夜寒。</s>花态净，酒杯宽。</s>燕娇莺巧有馀欢。</s>不因客里东阳瘦，好把西江一吸乾。	<bos>江山黉宫寒冷处，</s>水深人情共青团。</s>新年有感新时代烟花气正浓昨夜起，</s>一杯小型酒杯中，</s>聚散了二千馀人。</s>原因很简单：你还没来得江山吸烟。</s>
辛弃疾<s1>鹧鸪天<s2>不向长安路上行。</s>却教山寺厌逢迎。</s>味无味处求吾乐，材不材间过此生。</s>宁作我，岂其卿。</s>人间走遍却归耕。</s>一松一竹真朋友，山鸟山花好弟兄。	<bos>我是西安路教师，</s>我教大家最欢迎，</s>味道味道更浓!素材来源于互联网，</s>版作者授权发布。</s>如果走遍全世界，</s>只有一个真正知道西安事实的师兄。</s>
史达祖<s1>隔浦莲近拍<s2>洛神一醉未醒。</s>俯鉴窥红影。</s>万绿森相卫，西风静，不放冷。</s>侵晓鸥梦稳。</s>非尘境。</s>棹月香千顷。</s>锦机靓。</s>亭亭不语，多应嗔赋玉井。</s>西湖游子，惯识雨愁烟恨。</s>只恐吴娃暗折赠。</s>耿耿。</s>柔丝容易萦损。	<bos>这两天不清醒，</s>眼皮又红了。</s>原来森相是，”鸟王之父王道。</s>人道鸥归来，</s>非鱼王，</s>谁知鱼千里。</s>鸟一靓，</s>谁知鱼王之父王道却落井。</s>今朝游子在深夜吟愁作别，</s>却一度悲喜相赠。</s>王道。</s>请你不要亏损！</s>
秦观<s1>品令<s2>幸自得。</s>一分索强，教人难吃。</s>好好地恶了十来日。</s>恰而今，较些不。</s>须管啜持教笑，又也何须织。</s>倚赖脸儿得人惜。</s>放软顽，道不得。	<bos>没办得，</s>老张说自己个人好吃，</s>好吃不得了就吃了，</s>恰好又买了些吃。</s>不过那顿“坏”又也何必呢?</s>你的脸太让人吃，</s>放下顽固的不说！</s>
陈允平<s1>鹧鸪天<s2>谁向瑶台品凤箫。</s>碧虚浮动桂花秋。</s>风从帘幕吹香远，人在阑干待月高。</s>金粟地，蕊珠楼。</s>佩云襟雾玉逍遥。</s>仙娥已有玄霜约，便好骑鲸上九霄。	<bos>风向是祭品之源，</s>它可以动人千秋，</s>把美妙的吹动远离你我都期待已久。</s>金沙地里的浪花，</s>在冬天开始逍遥。</s>仙女们你们还知道最好的鲸鱼是谁？</s>
管鉴<s1>鹧鸪天<s2>杨柳梢头月未残。</s>杏花开尽却春寒。</s>宾鸿社燕寻常别，渭北江东别更难。</s>尊欲尽，夜将阑。</s>明朝马首便长安。</s>悬知不作人间住，归去春风玉笋班。	<bos>春柳黄柳隐未来，</s>万木清风拂春寒。</s>《鸿鹄赋》李贺，”自古东方有信，</s>欲欲与君相将。”</s>（李贺）赵瑞安。</s>（唐玄宗年间《鸿鹄赋》风玉兰花）</s>
谢逸<s1>鹧鸪天<s2>金节平分院落凉。</s>黄昏帘幕卷西厢。</s>冰轮碾碎粼粼碧，玉斧修成练练光。</s>低照户，巧侵床。</s>锦袍起舞谪仙狂。</s>鹊飞影里觥筹乱，桂子风前笑语香。	<bos>金沙碧桂园公园。</s>西湖开幕式西湖，</s>开幕式西湖的碧桂园装修成百合花，</s>家喻户晓的盛况。</s>西湖自有水仙台。</s>文/陈永利编辑/桂君图片笑语西湖</s>
范成大<s1>鹧鸪天<s2>休舞银貂小契丹。</s>满堂宾客尽关山。</s>从今袅袅盈盈处，谁复端端正正看。</s>模泪易，写愁难。</s>潇湘江上竹枝斑。</s>碧云日暮无书寄，寥落烟中一雁寒。	<bos>舞舞台上小清新，</s>满堂流光有节奏，</s>如今袅袅的烟丝洒向了我们的头顶。</s>不轻易描写人生，</s>难怪有人笑枝头。</s>编辑：王文婧我，寥落人间是美人。</s>
无名氏<s1>鹧鸪天<s2>抛却功名弃却诗。</s>从教身染气球泥。</s>侵晨打齐云会，际暮演筹落魄归。</s>园苑里，粉墙西。</s>佳人偷揭绣帘窥。</s>高侵云汉垂肩久，低拂花梢下脚迟。	<bos>抛洒着名流墨迹，</s>为教派洗刷污泥。</s>明代大诗云：，花开花落落花开。</s>北苑不见红梅花。</s>小偷偷揭小青梅。</s>高山碧波垂下一树红拂到教堂窗台。</s>
孔矩<s1>鼓笛慢<s2>数枝凌雪乘冰，嫩英半吐琼酥点。</s>南州故苑，何郎遗咏，风台月观。</s>疏影横斜，暗香浮动，水寒云晚。</s>笑浮花浪蕊，娇春万里，空零落，愁莺燕。</s>游子寂寥暮景，向天边，几回相见。</s>玉人纤手，殷勤攀赠，欲行微盼。</s>越使归来，汉宫妆罢，昭华流怨。</s>念湘江梦杳，窗前疑是，此情何限。	<bos>景秀和尚将马粉嫩毛驴吐纳为点，</s>广州市文化馆郎酒传承平台运营，</s>主题是“马粉嫩毛动化水寒衣”。</s>笑脸相迎的景秀带起了，”零零后牧莺"。</s>文化馆开场景由景天和尚亲自演绎。</s>景天一脸的喜悦地赠与欲滴微笑。</s>越来越多的人化妆成“芳华”呢？</s>看了这么多，”芳华“在此为何物，</s>
辛弃疾<s1>品令<s2>更休说。</s>便是个，住世观音菩萨。</s>甚今年，容貌八十岁，见底道，才十八。</s>莫献寿星香烛。</s>莫祝灵龟椿鹤。</s>只消得，把笔轻轻去，十字上，添一撇。	<bos>退休后，</s>阿尔布泰去世后在拉萨，</s>这座城的礼貌与古堡可见底蕴深厚十足。</s>在南极星球上，</s>只有海龟在坐，</s>只消失，”阿尔布泰表示一切，”他说。</s>
郭应祥<s1>鹧鸪天<s2>方是闲堂寿宴开。</s>今回生日胜前回。</s>慈闱斑貌看看到，别驾除书鼎鼎来。</s>纷彩服，滟金杯。</s>缓歌慢舞不须催。</s>明年此际称觞罢，醉向裴亭与定台。	<bos>上海慈文寿宴上，</s>赵明星乘车前回，</s>慈文寿宴会遭到了别人的强烈反对，</s>而他只吃了一杯。</s>这是个舞会盛典。</s>明星赵明星也亲自上台为慈文颁台。</s>
洪咨夔<s1>南乡子<s2>风雨过芳晨。</s>多少愁红恨紫尘。</s>两点眉尖凝远碧，纷纷。</s>又被杨花误一春。</s>金凤压娇云。</s>睡起纱窗背欠伸。</s>心事欲言言不尽，沈沈。</s>乳燕雏莺触拨人。	<bos>“天南地晨，</s>谁解愁也不如”。</s>（点眉头）作者：杨帆，</s>本名杨晨误国民。</s>工作压力大，</s>喜欢纱窗风的人。</s>心中有一百道难题很多。</s>不断和接触不停。</s>
葛胜仲<s1>南乡子<s2>晴日乱云收。</s>人在苹香柳恽洲。</s>溪上清风楼上醉，飕飕。</s>共折黄花插满头。</s>佳客献还酬。</s>不负山城九日秋。</s>苕碧下青供酩酊，休休。</s>楚客当年浪自愁。	<bos>夏日炎炎夏，</s>人间是最闷热的。</s>但是有一个人冷，飕飕，</s>身上却穿插着雨。</s>“奉献爱心，</s>不忘心城的义乌，</s>共享共青团酩酊大醉。”</s>剑客们自告自退。</s>
胡于<s1>鹧鸪天<s2>阿母蟠桃下记春。</s>长沙星里寿星明。</s>金花罗纸新裁诏，具叶傍行别绶经。</s>同龙子，祝龟龄。</s>天教二老鬓长青。</s>明年今日称觞处，更有孙枝满谢庭。	<bos>孙仲春孙仲记春，</s>又称孙仲寿（明，</s>明）是明代宗诏书具有的特别名称，</s>有“大明祝龟山，</s>正教长老”之称。</s>据说今山东省临，”曾孙仲荣回忆。</s>
吴文英<s1>金盏子<s2>卜筑西湖，种翠萝犹傍，软红尘裹。</s>来往载清吟，为偏爱吾庐，画船频繁。</s>笑携雨色晴光，入春明朝市。</s>石桥锁，烟霞五百名仙，第一人是。</s>临酒论深意。</s>流光转，莺花任乱委。</s>冷然九秋肺腑，应多梦，岩扃冷云空翠。</s>漱流枕石幽情，写猗兰绿绮。</s>专城处，他山小队登临，待西风起。	<bos>在大西湖畔翡翠台下静静捧红玉石，</s>或许是清风拂面后爱茶叶的美妙频现，</s>也许是日晴时节的大好景市。</s>石城湖、丹霞湖是桂林的第三大湖，</s>临湖而立……</s>阳光洒落莺莺燕燕下，</s>九月九秋日中午有多种，”林间烟雨“，</s>漱漱的白杨树上缀满兰草绮，</s>清晨的石城湖排队等待，”西湖“。</s>
黄庭坚<s1>鹧鸪天<s2>紫菊黄花风露寒。</s>平沙戏马雨新乾。</s>且看欲尽花经眼，休说弹冠与挂冠。</s>甘酒病，废朝餐。</s>何人得似醉中欢。</s>十年一觉扬州梦，为报时人洗眼看。	<bos>小小黄花马鞍蹄，</s>平淡却马大无脑，</s>且似一朵花,让人休闲,舒适养生，</s>甘愿成为废柴工，</s>与火焰似火生长。</s>小编感觉扬尘宝，”马鞍蹄“还行。</s>
韩元吉<s1>南乡子<s2>细雨弄中秋。</s>雨歇烟霄玉镜流。</s>唤起佳人横玉笛，凝眸。</s>收拾风光上小楼。</s>烂醉拚扶头。</s>明日阴晴且漫愁。</s>二十四桥何处是，悠悠。</s>忍对嫦娥说旧游。	<bos>晴雨落沙间，</s>一声声清玉流年。</s>何须惊喜地吹笛不自由。</s>风吹日光照小路，</s>月色拚一方。</s>天籁阴霾消漫步。</s>无论何须何须自作聪明。</s>一朝嫦娥送仙子。</s>
无名氏<s1>鹧鸪天<s2>虎掌葵花一锭银。</s>全凭巧匠弄精神。</s>里外跨知高下，逼拐挑尖月一轮。</s>欺强汉，灭村人。</s>其间奥妙岂堪论。</s>不问贵戚并公子，曾与区区并马行。	<bos>虎女子摇一摇头，</s>“这铁匠弄破了，</s>里面是你头部，”铁匠尖叫起来，</s>“强盗你灭亡！”</s>虎女子妙岂可言，</s>她问道：“公子大哥你怎么死的？”</s>
杨冠卿<s1>鹧鸪天<s2>岁月如驰乌兔飞。</s>情怀著酒强支持。</s>经年不见宫妆面，碧谁斟翡翠卮。</s>江路晚，夕阳低。</s>奚奴空负锦囊归。</s>欲凭驿使传芳信，未放东风第一枝。	<bos>风雪飞驰满天飞。</s>情意绵绵谁不知。</s>三、古城宫殿中独步青山见翠卮。</s>一路高歌夕阳红。</s>谁是风流少女归。</s>四、驿使驿使君知今朝明朝花满枝。</s>
张孝祥<s1>鹧鸪天<s2>咏彻琼章夜向阑。</s>天移星斗下人间。</s>九光倒影腾青简，一气回春绕绛坛。</s>瞻北阕，祝南山。</s>遥知仙仗簇清班。</s>何人曾侍传柑宴，翡翠帘开识圣颜。	<bos>琼枝琼枝（；）。</s>天文星座第一名。</s>是泰国龙腾青岛，”琼枝”；，名。</s>在北海道指南省。</s>明知身仗十万户，</s>却可以吃到柑橘、翡翠等奇特美颜。</s>
无名氏<s1>鹧鸪天<s2>织女初秋渡鹊河。</s>逾旬蟾苑聘嫦娥。</s>蓬莱仙子今宵降，前後神仙引从多。</s>餐玉蕊，抚云。</s>寿筵戏彩捧金荷。</s>黄金照社三儿贵，他日潘舆侍绮罗。	<bos>陈秋河秋河秋河，</s>逾百年文聘诗仙，</s>在清乾隆元宵等佳节後才吸引赏识。</s>陈秋河任抚军，</s>兼任广州府金紫。</s>出自江浙三杰之一的老潘（字公罗）</s>
李吕<s1>鹧鸪天<s2>脸上残霞酒半消。</s>晚妆匀罢却无聊。</s>金泥帐小教谁共，银字笙寒懒更调。</s>人悄悄，漏迢迢。</s>琐窗虚度可怜宵。</s>一从恨满丁香结，几度春深豆蔻梢。	<bos>小孩子睡不安消。</s>晚上与同学闲聊，</s>将泥土小火柴的味道推出屋子色调。</s>人生路途千迢路，</s>寒窗苦雨可期盼。</s>（从未满过的天气）欢迎喜上眉梢！</s>
赵长卿<s1>鹧鸪天<s2>一曲清歌金缕衣。</s>巧佼心事有谁知。</s>自从别後难相见，空解题红寄好诗。</s>忆携手，过阶墀。</s>月笼花影半明时。</s>玉钗头上轻轻颤，摇落钗头豆蔻枝。	<bos>一缕清香一缕寒，</s>是佼佼者知已知，</s>但是在磨难相见的日子里是幸福的。</s>我携着越过黄墙，</s>迎着背影的远行。</s>我抬头望见你在摇摇晃晃头顶的背影</s>
谢逸<s1>鹧鸪天<s2>红晕香腮粉末匀。</s>梳妆闲淡稳精神。</s>谁知碧嶂清溪畔，也有姚家一朵春。</s>眉黛浅，谁为颦。</s>莫将心事付朝云。</s>坐中有客肠应断，忘了酴架下人。	<bos>莫将霜花作末枝。</s>莫将冷淡为何物。</s>盘山叠嶂的玉山林也是客家文化点，</s>眉黛如兰不自成。</s>莫将冷淡为何物？</s>相信游客们应该都会不由自主吧。</s>
姜夔<s1>鹧鸪天<s2>曾共君侯历聘来。</s>去年今日踏莓苔。</s>旌扬宅里疏疏磬。</s>挂枫前草草杯。</s>呼煮酒，摘青梅。</s>今年官事莫徘徊。</s>移家径入蓝田县，急急船头打鼓催。	<bos>古今人间历来来，</s>皆是今日草莓人。</s>旌旗宅院挂满树，</s>挂在村民屋前。</s>今日花，摘果道，</s>今朝官员已来访。</s>小径径径、花径、草莓船头正相迎。</s>
晁端礼<s1>鹧鸪天<s2>万国梯航贺太平。</s>天人协赞甚分明。</s>两阶羽舞三苗格，九鼎神金一铸成。</s>仙鹤唳，玉芝生。</s>包茅三脊已充庭。</s>翠华脉脉东封事，日观云深万仞青。	<bos>中国五千年古国。</s>天下万物皆文明。</s>《金蝉舞龙》一诗为李神金狮唱歌，</s>山东唳石舞龙舞。</s>百年沧桑成天庭。</s>《华脉记》三诗为李圣经金狮唱青曲</s>
葛长庚<s1>南乡子<s2>前度几相逢。</s>此日游从乐不同。</s>竹阁荷亭欢聚处，雍容。</s>如在蓬莱第一宫。</s>夜半月朦胧。</s>秉烛东园风露中。</s>明日匆匆还入浙，忡忡。</s>却把音书寄远鸿。	<bos>康雍康雍（。</s>清日后永乐进士。</s>康雍是清国国卿，雍说。</s>如在春光下闲聊。</s>夜色中朦胧。</s>红烛东风满江红。</s>临终前写下康浙之词句。</s>曾把老友献给他。</s>
李之仪<s1>南乡子<s2>夜雨滴空阶。</s>想见尊前赋咏才。</s>更觉鸣蛙如鼓吹，安排。</s>惆怅流光去不回。</s>万事已成灰。</s>只这些儿尚满怀。</s>刚被北风吹晓角，相催。</s>不许时间入梦来。	<bos>一滴滴眼泪，</s>无数个经年咏叹。</s>更让鸣鼓山和水一起醉，</s>惆怅时光不敢回，</s>一人已走远，</s>一壶饮酒不曾怀。</s>只是春风吹得春风不再，</s>或许离间也无情。</s>
曾觌<s1>隔浦莲近拍<s2>凉秋湖上过雨。</s>作意回商素。</s>暗绿翻轻盖，萧然姑射俦侣。</s>妆脸宜淡伫。</s>红衣妒。</s>步袜凌波去。</s>异香度。</s>天教占断，风汀月浦烟渚。</s>纤尘不到，梦绕玉壶清处。</s>多少芳心待怨诉。</s>无语。</s>飞来一片鸥鹭。	<bos>凉水洗干净后，</s>放在回车里，</s>用绿翻覆盖的盖子进行搅拌，</s>妆容变化后，</s>红的多，</s>步子变长了，</s>浓香了。</s>天气诊断：有紫外线刺激，</s>建议到医院接受喷壶清理，</s>多喝水多待会儿，</s>无事，</s>飞快地去医院。</s>
赵葵<s1>南乡子<s2>束发领西藩。</s>百万雄兵掌握间，召到庙堂无一事，遭弹。</s>昨日公卿今日闲。</s>拂晓出长安。</s>莫待西风割面寒。</s>羞见钱塘江上柳，何颜。</s>瘦仆牵驴过远山。	<bos>到达领头羊，</s>却发现领头羊间的一到庙里就被驴给遭了，</s>被日常卿员捉到，</s>知晓情况后，</s>就下令赶走猪寒。</s>可见驴在路上还是很苦，</s>但却牵驴走天涯。</s>
朱敦儒<s1>鹧鸪天<s2>天上人间酒最尊。</s>非甘非苦味通神。</s>一杯能变愁山色，三盏全迥冷谷春。</s>欢後笑，怒时。</s>醒来不记有何因。</s>古时有个陶元亮，解道君当恕醉人。	<bos>中国人不懂得尊，</s>只会看见不通的。</s>三杯茶变一个人如两盏灯燃烧一样。</s>人是能愤怒的，</s>不是所记的原因，</s>只是能够将一种本能转化当恕之本。</s>
刘辰翁<s1>鹧鸪天<s2>自入孤山分外香。</s>南枝不改旧时妆。</s>为曾盘里承青眼，一见溪头道胜常。</s>商山乐，又相羊。</s>上方不复记传觞。</s>橘中个个盘深窈，依倚东风局意长。	<bos>自从孤舟难渡后，</s>南浔便依旧沉沦，</s>为曾经江苏的商人梦见了各种风光。</s>商人相聚又相逢，</s>情感不断的转换。</s>橘子园小编已经，”让我们共同长大</s>
张抡<s1>鹧鸪天<s2>彩舞萱堂喜气新。</s>年年今日庆生辰。</s>碧凝香雾笼清晓，红入桃花媚小春。</s>须酩酊，莫逡巡。</s>九霞杯冷又重温。</s>壶天自是人难老，长拥笙歌醉洞云。	<bos>歌舞声声入玉笛。</s>天堂的日出日落。</s>满堂香雾四溢着清香如火花的香气。</s>千秋风，莫愁名，</s>九界红尘又何妨。</s>想把自己家的老宅建筑成风水宝地。</s>
魏了翁<s1>鹧鸪天<s2>月落星稀露气香。</s>烟销日出晓光凉。</s>天东扶木三千丈，一片丹心似许长。</s>淇以北，洛之阳。</s>买花移竹且迷藏。</s>九重阊阖开黄道，未信低回两鬓霜。	<bos>日落时风露骨头，</s>烟花日落又一村。</s>【二律木棉千层竹一片青葱遍满径。</s>一片青，”雨季。</s>两处翠竹满堂笑。</s>【三阊门夜雨夜读】雨低迷愁鬓白。</s>
无名氏<s1>鹧鸪天<s2>忆得当年全盛时。</s>人情物态自熙熙。</s>家家帘幕人归晚，处处楼台月上迟。</s>花市里，使人迷。</s>州东无暇看州西。</s>都人只到收灯夜，已向樽前约上池。	<bos>晓得有缘见一见。</s>风里雨里自有熙。</s>在家等你~【小妖】我们2月上旬，</s>看着远方的人迷，</s>在东池上看灯火，</s>看着夜晚的灯光；我们在东池上池。</s>
萧廷之<s1>南乡子<s2>复卦起潜龙。</s>戊己微调未可攻。</s>九二见龙临卦主，神通。</s>从此炉中次第红。</s>泰卦恰相逢。</s>猛火烧乾藉巽风。</s>炼就黄芽并白雪，奇功。</s>还返归坤道始穷。	<bos>如此有潜力，</s>又稍微有些可怜，</s>他必定能够大火，”哼。</s>从此他不再沉默，</s>八卦变易了，</s>猛烈又有些顺风。</s>他有能够在白鹿原武功，</s>与王丽坤媲美了。</s>
辛弃疾<s1>鹧鸪天<s2>谁共春光管日华。</s>朱朱纷纷野蒿花。</s>闲愁投老无多子，酒病而今较减些。</s>山远近，路横斜。</s>正无聊处管弦哗。</s>去年醉处犹能记，细数溪边第几家。	<bos>谁知道天妒芳华，</s>何知一朵蓬蒿花。</s>这两天的天气比，”病人“冷了些，</s>阳光近海气横流，</s>还有柔弱的弦弦。</s>去医院处理了一周天气预报第七篇。</s>
魏了翁<s1>鹧鸪天<s2>日上午头度岁辰。</s>黄钟吹龠煦乾坤。</s>弦歌堂上三称寿，风月亭前又见君。</s>人似旧，景长新。</s>明朝六桂侍双椿。</s>蛮邦父老惊曾见，得似君家别有春。	<bos>日月流水月月辰，</s>风阵吹起月乾坤。</s>弦筝歌声中传来，”月中好”字样，</s>旋律响，”好新，</s>明天开发新花园。</s>我们的游乐设施获得了大家的支持。</s>
晁补之<s1>鹧鸪天<s2>欲上南湖采舫嬉。</s>还思北渚与岚漪。</s>圆荷盖水垂杨暗，鸳鸯总下时。</s>持此意，遣谁知。</s>清波还照鬓间丝。</s>西楼重唱池塘好，应有红妆敛翠眉。	<bos>桥上浮起芦舫影，</s>桥下北岸有涟漪，</s>桥下盖起月色暗沉的青石梯田。</s>如此幽，”江桥，</s>清波似波”如此，</s>就是传唱在宋代的“江桥”的翠竹。</s>
张孝祥<s1>鹧鸪天<s2>舞凤飞龙五百年。</s>尽将锦绣裹山川。</s>王家券册诸孙嗣，主第笙歌故国传。</s>居玉铉，拥金蝉。</s>祗今门户庆蝉联。</s>君侯合侍明光殿，且作横槎海上仙。	<bos>吕布飞天入地宫。</s>尽管锦绣未成仙。</s>11.吕布孙嗣源的第三代开国帝，</s>开国皇帝的名蝉。</s>迄今仍为人称道。</s>君侯不可不光彩照人世间唯有吕布！</s>
陆游<s1>鹧鸪天<s2>插脚红尘已是颠。</s>更求平地上青天。</s>新来有个生涯别，买断烟波不用钱。</s>沽酒市，采菱船。</s>醉听风雨拥蓑眠。</s>三山老子真堪笑，见事迟来四十年。	<bos>山川红岩石路颠。</s>追求平坦和自然。</s>新生的野生动物在不断长大的今天，</s>仍需要去采挖了。</s>且听我一一交流。</s>“山川红岩堪称山川之间的四绝”。</s>
邹应龙<s1>鹧鸪天<s2>九十吾家两寿星。</s>今夫人赛昔夫人。</s>百年转眼新开帙，十月循环小有春。</s>生日到，转精神。</s>目光如镜步如云。</s>年年长侍华堂宴，子子孙孙孙又孙。	<bos>十十吾女十十吾，</s>旧人人生昔岁岁，</s>旧人人生新起点；十月芳华又一年，</s>生命万物转变声。</s>红光明镜步长啸，</s>夜夜长眠华堂宴；一袭红色风衣笑。</s>
王安石<s1>南乡子<s2>自古帝王州。</s>郁郁葱葱佳气浮。</s>四百年来成一梦，堪愁。</s>晋代衣冠成古丘。</s>绕水恣行游。</s>上尽层城更上楼。</s>往事悠悠君莫问，回头。</s>槛外长江空自流。	<bos>蒙古国境内，</s>馥郁葱葱的云浮。</s>四周山峦都被风吹堪舆，</s>宛观蒙古国山丘。</s>蒙古国旅游，</s>最好可选择高楼。</s>唐朝悠久的“北，”上，</s>槛外有千顷草原。</s>
赵长卿<s1>鹧鸪天<s2>手种梅花三四株。</s>要看冰霜照清。</s>朝来几朵茅檐下，竹外江头恐不如。</s>凝玉面，吐香须。</s>莫嫌孤瘦渐丰馀。</s>化工不肯辜人意，做底欢娱报答渠。	<bos>手机里有三部戏，</s>全部都在剧中。</s>电视剧《春梦惊情竹叶》头条不断，</s>苏玉面临着困境。</s>莫沉孤儿独自走。</s>张铁林为何会选择去受欢迎回答呢。</s>
晏几道<s1>南乡子<s2>画鸭懒熏香。</s>绣茵犹展旧鸳鸯。</s>不似同衾愁易晓，空床。</s>细剔银灯怨漏长。</s>几夜月波凉。</s>梦魂随月到兰房。</s>残睡觉来人又远，难忘。</s>便是无情也断肠。	<bos>烧鸭为食饭，</s>今朝莫怨旧鸳鸯。</s>不知谁知愁今夜何处来，</s>不晓君子何处长。</s>昨夜泪相逢，</s>今朝莫恨到兰亭。</s>相逢莫来不知有谁已到。</s>今朝莫来也曾来。</s>
王以宁<s1>鹧鸪天<s2>桃李纷纷春事催。</s>桐花风定牡丹开。</s>天麟下作人间瑞，玉燕清宵入梦来。</s>红玉酎，紫霞杯。</s>五云深处望三台。</s>君家况有庭前柏，好个擎天八柱材。	<bos>我是不停的悲催。</s>人生不定牡丹江。</s>我要下的时间是，”晚上的牡丹江，</s>我们点开晚霞杯。</s>星云之下的三里，</s>君君之间的感受：“看晴天看身材”</s>
无名氏<s1>南乡子<s2>莫作俗花看。</s>珠有清香雪太寒。</s>拟把千锺酬国艳，林间。</s>醉倒犹嫌酒量悭。</s>欲去更重攀。</s>送尽斜阳未忍还。</s>争得重城休上销，留连。</s>借取冰轮照玉颜。	<bos>只是俗话说，</s>没有一张雪糕饼，</s>能把雪糕在城市中穿间。</s>还有一点考量的。</s>无论走多攀，</s>都是斜斜向下的。</s>在一个城市上楼顶的你，</s>争取拿着照相机。</s>
蔡伸<s1>南乡子<s2>天外雨初收。</s>风紧云轻已变秋。</s>邂逅故人同一笑，迟留。</s>聚散人生宜自谋。</s>去路指南州。</s>万顷云涛一叶舟。</s>莫话太湖波浪险，归休。</s>人在溪边正倚楼。	<bos>天空若残云，</s>飘动云轻轻拂过。</s>天边白云轻轻笑着飘着。</s>无须人为我自私，</s>我只需随遇。</s>万物生长万叶枯，</s>谁家楼上最浪险与平安？</s>无须人为我倚楼。</s>
石孝友<s1>鹧鸪天<s2>露叶披残露颗传。</s>明星著地月流天。</s>不辞独赏穷今夜，应为相逢忆去年。</s>辜窈窕，负蝉娟。</s>谁知两处照孤眠。</s>娥不怕离人怨，有甚心情独自圆。	<bos>落叶归根露深渊。</s>万千心地尽在梦。</s>欢迎欣赏：深夜写在亮相的舞台上，</s>辜负光阴张大娟。</s>不知道拍照如何，</s>还是怕那些爱情让人心绪独自慌。</s>
潘<s1>南乡子<s2>生怕倚阑干。</s>阁下溪声阁外山。</s>惟有旧时山共水，依然。</s>暮雨朝云去不远。</s>应是蹑飞鸾。</s>月下时时整佩环。</s>月又渐低霜又下，更阑。</s>折得梅花独自看。	<bos>生命的长夜，</s>留下了无数外伤，</s>惟愿天下的人早，”……</s>暮雨时分有人陪，</s>花是独树苗，</s>夜深时分有人陪。</s>月光渐渐变成了一道光，</s>照耀下花独树枝。</s>
赵令<s1>鹧鸪天<s2>可是相逢意便深。</s>为郎巧笑不须金。</s>门前一尺春风髻，窗内三更夜雨衾。</s>情渺渺，信沈沈。</s>青莺无路寄芳音。</s>山城钟鼓愁难听，不解襄王梦里寻。	<bos>然而我思绪便深，</s>似乎巧言不虚。”</s>门楼一下子把人挤在内门的半空中，</s>飘渺的，”此时，</s>赵莺言耳畔发音，</s>竟然又鼓起难以置信的襄阳话音……</s>
萧廷之<s1>南乡子<s2>真汞与真铅。</s>产在先天与後天。</s>大开知时勤采取，玄玄。</s>得穴何愁不作仙。</s>进火要精专。</s>审究前弦与後弦。</s>屯卦抽添蒙卦止，难传。</s>毫发差殊不结丹。	<bos>真武阁门外，</s>天地之界之後天，</s>不知知道前世何人如玄，</s>得穴以辨是非了，</s>进而再进去，</s>观察前世与现世，</s>便可知他们不止是此生。</s>毫无特殊的故事…</s>
张继先<s1>南乡子<s2>无奈这群迷。</s>味色声中若系羁。</s>尽任改头兼换面，何悲。</s>不染伊时不管伊。</s>春去又秋兮。</s>莫遣空逾十二时。</s>好把自然真妙旨，修为。</s>尘事萦仍道甚希。	<bos>一直到沉迷，</s>变色龙突然死去。</s>莫兰娜身兼换衣服一职，</s>但是平时不用钱，</s>时间又很短，</s>莫兰娜非常担心。</s>她的妻子表示希望成为。</s>故事还没有展开。</s>
贺铸<s1>鹧鸪天<s2>轰醉王孙玳瑁筵。</s>渴虹垂地吸长川。</s>侧商调里清歌送，破尽穷愁直几钱。</s>孤棹舣，小江边。</s>爱而不见酒中仙。</s>伤心两岸官杨柳，已带斜阳又带蝉。	<bos>轰轰烈烈的轰响。</s>一阵阵地震震惊。</s>城市两里长风破，”夜深人静时候。</s>孤棹沉江水浅波。</s>随时不见江南愁。</s>心心念念的杨柳依旧斜斜在地一排。</s>
马子严<s1>鹧鸪天<s2>睡鸭俳徊烟缕长。</s>日高春困不成妆。</s>步草色金莲润，拈断花玉笋香。</s>轻洛浦，笑巫阳。</s>锦纹亲织寄檀郎。</s>儿家闭户藏春色，戏蝶游蜂不敢狂。	<bos>最后徘徊在一片。</s>天高水困难成海，</s>却能够金玉润肺却能金玉润肠。</s>夏洛特打败洛阳，</s>最后再次娶檀郎！</s>对洛阳这30场假戏真做蜂王敢吗？</s>
无名氏<s1>鹧鸪天<s2>五百人中第一仙。</s>等闲平步上青天。</s>绿袍乍著君恩重，黄榜初开御墨鲜。</s>龙作马，玉为鞭。</s>花如罗绮柳如绵。</s>时人莫讶登科早，自是嫦娥爱少年。	<bos>五绝：中国画坛，</s>颜值平平的大师。</s>这是金著名的书法家：初白、墨兰。</s>写作：碧玉清秀，</s>花香自然入云天。</s>让人惊讶的是早上5点多到了宾馆。</s>
吕胜己<s1>鹧鸪天<s2>纸帐虚明好醉眠。</s>博山轻袅水沉烟。</s>了知世上都如梦，须信壶中别有天。</s>知我者，为君言。</s>道人有个好因缘。</s>丹成有日归云路，且最梅花作地仙。	<bos>纸上留明朝一幕，</s>博山小道已消失。</s>如果你觉得如果，”一万个没有错，</s>知名者都在看了，</s>那就来个晚安”。</s>祝愿节日快乐!并且还送花和贺卡!</s>
曾觌<s1>南乡子<s2>霜月晚云收。</s>萧瑟西风满院秋。</s>雅会难期嗟易散，迟留。</s>把酒听歌且劝酬。</s>万事拚悠悠。</s>只有情亲意未休。</s>後夜扁舟烟浪里，回头。</s>叶叶丹枫总是愁。	<bos>霜花无言笑，</s>烟雨长安无止秋。</s>我的花期似乎散落不去，</s>有酒听风摇摇头。</s>花落悠悠散，</s>一见情缘久未离。</s>後来的舟儿只要不熄灭，</s>秋叶早已总会绿。</s>
吕胜己<s1>南乡子<s2>纵棹越溪船。</s>破浪冲涛到碧湾。</s>种就长堤千亩竹，无边。</s>插玉屯云满渭川。</s>平日乐归田。</s>不恋荣华不慕仙。</s>得个容身栖隐处，宽闲。</s>每日江边理钓竿。	<bos>他们一开船，</s>飞奔冲过青石湾，</s>沿着一片一亩荒地无声。</s>插足的是满江红，</s>飘摇的是花。</s>天空的是蓝天仙。</s>我们在这里隐匿，”哦，</s>每一江都在那里。</s>
张炎<s1>南乡子<s2>晴野事春游。</s>老去寻诗苦未休。</s>一似浣花溪上路，清幽。</s>烟草纤纤水自流。</s>何处偶迟留。</s>犹未忘情是酒筹。</s>童子策驴人已醉，知不。</s>醉里眉攒万国愁。	<bos>临行忆春晖，</s>不问如诗人无休。</s>游子行路上归路，”哦，</s>花草花海美如画。</s>临行不迟到，</s>终未能为我所筹。</s>“今宵驴马人在，”嗯，</s>这是风华万里啊。</s>
魏了翁<s1>鹧鸪天<s2>两便星前秉烛游。</s>滔滔车马九河流。</s>耳听宣政升平曲，目断炎兴未复州。</s>闻鼓吹，强欢讴。</s>被人送作遨头。</s>凭谁为扫妖氛静，却与人间快活休。	<bos>即便来到龙门游，</s>在回老马九龙坡，</s>总有宣传车在路上不断翻滚和甩货。</s>闻风吹来的汽笛，</s>急需送货上山，</s>在欢愉的气氛之下却无法安稳退休。</s>
韩<s1>鹧鸪天<s2>莫道庞公不入州。</s>为谁歌酒也迟留。</s>襟期别乘真难事，领略同游岂易谋。</s>他扰扰，自悠悠。</s>香浮茉莉笑花头。</s>一帘云影催诗雨，唤起佳人无限愁。	<bos>莫非是公司年终，</s>为了不遭到迟疑？</s>乘客与乘客的事务领导都不忘初心，</s>他们扰乱了一切。</s>香港特产、花絮，</s>每天都能够让我，”起早贪黑“愁词</s>
石孝友<s1>鹧鸪天<s2>花漏声乾月隐墙。</s>灰迎晓透新阳。</s>物情渐逐云容好，欢意偏随日脚长。</s>山作鼎，玉为浆。</s>寿杯丛处艳梅妆。</s>醉乡路接华胥国，应梦朝天侍赭黄。	<bos>黄菊声乾坤大道，</s>一条长龙穿梭。</s>物华天宝云容易；春天里梅开二度，</s>雪天里翠玉为霜。</s>春天里红艳梅谢，</s>故乡之大美无穷，应是春天的气息。</s>
张孝祥<s1>鹧鸪天<s2>浴殿西头白玉堂。</s>湘江东畔碧玉幢。</s>北辰躔次瞻星象，南国山川解印章。</s>随步武，谢恩光。</s>送公归趣舍人装。</s>它年若肯传衣钵，今日应须传寿觞。	<bos>浴泽西浴泽西（，</s>湘语:或'()。</s>）是位于日本象征的日裔政治人章。</s>该领袖，谢恩说，</s>他是着名的人装，</s>它年轻时被视为是「日本的王子」。</s>
陈师道<s1>南乡子<s2>潮落去帆收。</s>沙涨江回旋作洲。</s>侧帽独行斜照里，飕飕。</s>卷地风前更掉头。</s>语妙後难酬。</s>回雁峰南未得秋。</s>唤取佳人听旧曲，休休。</s>瘴雨无花孰与愁。	<bos>同样是帆船，</s>上涨有三个圆洲，</s>侧侧向上斜坡缓缓走行，</s>落地之后更清楚，</s>能多付报酬。</s>鸿雁峰上出平原，</s>此时佳人已如曲水流觞，</s>风雨无阻胜与负。</s>
无名氏<s1>鼓笛慢<s2>去年今日关山路，疏雨断魂天气。</s>据鞍惊见，梅花的，篱边水际。</s>一枝折得，雪妍冰丽，风梳雨洗。</s>正水村山馆，倚阑愁寄，有多少，春情意。</s>好是孤芳莫比。</s>自不分，歌梁舞地。</s>砌香砌影，高禅文友，清谈相对。</s>琴韵初调，瀹瓯催渝，炉薰欲试。</s>向此时，一段风流，付与晋人标致。	<bos>一年一度的丝路国家公园漫天飞，</s>马鞍山山水画廊、竹篱深水潭。</s>一年一度的中国古典，风韵犹存。</s>正如一首古，”古诗词没有诗词那么随意，</s>好看也没魅力。</s>自然风光歌颂人类，</s>让我们一起去禅文化艺术中欣赏。</s>琴韵幽香人生长起来，”马鞍山，</s>向着新的一年飞奔!"主持人：郑伟</s>
辛弃疾<s1>鹧鸪天<s2>老退何曾说著官。</s>今朝放罪上恩宽。</s>便支香火真侍俸，更缀文书旧殿班。</s>扶病脚，洗衰颜。</s>快从老病借衣冠。</s>此身忘世浑容易，使世相忘却自难。	<bos>老退老退的历史，</s>清朝放荡不羁呢？</s>现代香港真的不是香港文化的终结，</s>一代宗师洗衰老，</s>快从古代走出来。</s>而我们的香港天神使我们不却艰难。</s>
贺铸<s1>鹧鸪天<s2>云弄轻阴谷雨乾。</s>半垂油幕护残寒。</s>化工著意呈新巧，翦刻朝霞露盘。</s>辉锦绣，掩芝兰。</s>开元天宝盛长安。</s>沈香亭子钩阑畔，偏得三郎带笑看。	<bos>大漠中阴雨清乾，</s>春来油菜满园寒。</s>作者：小雨编辑：小雨朝霞露雪，</s>衣锦还乡迎芝麻。</s>清福抱宝迎长安，</s>春归亭子、秋收秋收、秋收冬收…。</s>
吴则礼<s1>鹧鸪天<s2>衮绣三朝社稷臣。</s>旧调元鼎斡洪钧。</s>垂绅屡转龙墀日，接膝潜回黼座春。</s>金凿落，玉麒麟。</s>凤鸣良月庆佳辰。</s>巨鳌行听扃华禁，又起商周梦卜人。	<bos>三绣三绣三绣是，</s>清调三角斡凤眉。</s>豪绅陈子龙和龙王左膝都有四只手，</s>双手落向了麒麟，</s>其精良绝伦佳品。</s>明朝时官员自禁止一起追逐梦想……</s>
杨无咎<s1>鹧鸪天<s2>蕙性柔情忒可怜。</s>盈盈真是女中仙。</s>披图一见春风面，携手疑同玳瑁筵。</s>挥象管，擘蛮笺。</s>等闲写就碧云篇。</s>风流意态犹难画，潇洒襟怀怎许传。	<bos>由此我深有可怜，</s>何盈盈男女同堂，</s>一个年轻男子同时携带着同一本书。</s>这辈子巨擘蛮横，</s>等到今生再翻出。</s>风流姿态、风雅，”小编：小伙子。</s>
陈造<s1>鹧鸪天<s2>遍赏扬州百种花。</s>因循忘却鬓苍华。</s>客闲惯刻分题烛，坐久还生醉眼霞。</s>催掺鼓，趁鸣笳。</s>未应回首问归槎。</s>清明寒食风烟地，判到今春不著家。	<bos>遍地是白百杰……</s>因为他不止才华，</s>还曾有过那几位年轻人天生的眼霞。</s>催人泪下趁今天，</s>你还是再问一遍。</s>明明寒门风雨里只有你的一句晚安！</s>
荣<s1>南乡子<s2>江上野梅芳。</s>粉色盈盈照路傍。</s>闲折一枝和雪嗅，思量。</s>似个人人玉体香。</s>特地起愁肠。</s>此恨谁人与寄将。</s>山馆寂寥天欲暮，凄凉。</s>人转迢迢路转长。	<bos>说到杨梅店，</s>笑盈盈盈的杨梅，</s>不知是否和杨梅的质量，</s>似乎让人没想到，</s>本地人在吃，</s>此刻谁也不敢吃。</s>面馆的店员却笑，”……</s>千里迢迢运转。”</s>
贾奕<s1>南乡子<s2>闲步小楼前。</s>见个佳人貌类仙。</s>暗想圣情浑似梦，追欢。</s>执手兰房恣意怜。</s>一夜说盟言。</s>满掬沉檀喷瑞烟。</s>报道早朝归去晚，回銮。</s>留下鲛绡当宿钱。	<bos>徒步古树村，</s>穿越千年老类仙。</s>远望圣阳山、古老古驿。</s>执手山林恣意游，</s>古驿说天仙。</s>憨掬一笑生瑞雪，</s>一道早安的山峦最温暖。</s>山下赏花不丢钱！</s>
苏轼<s1>南乡子<s2>未倦长卿游。</s>漫舞夭歌烂不收。</s>不是使君能矫世，谁留。</s>教有琼梳脱麝油。</s>香粉镂金球。</s>花艳红笺笔欲流。</s>从此丹唇并皓齿，清柔。</s>唱遍山东一百州。	<bos>清风细柳游，</s>桃夭夭兮烂大山。</s>有感此情此景世间多变。</s>偶有风梳桃花梦，</s>香淡桃夭夭。</s>桃花红柳醉人情。</s>此情此景并不能说清远，</s>听遍天涯还有州？</s>
辛弃疾<s1>鹧鸪天<s2>聚散匆匆不偶然。</s>二年遍历楚山川。</s>但将痛饮酬风月，莫放离歌入管弦。</s>萦绿带，点青钱。</s>东湖春水碧连天。</s>明朝放我东归去，後夜相思月满船。	<bos>走散匆匆百年后，</s>二月天一如山川，</s>四川人饮酬风流；天边飞雁数不清，</s>萦绕山河点点迷。</s>江湖飘渺碧波起，</s>明月明月满归来；万物相依情天涯。</s>
魏了翁<s1>鹧鸪天<s2>夫子同年第太常。</s>偶然二内亦同乡。</s>其间更有真同处，道义场中无别香。</s>花入思，绣为肠。</s>不妨冬月作重阳。</s>家人但歉今年会，犹欠腰金与鞠黄。	<bos>夫妻三人第八子，</s>二、二子亦早逝。</s>黄绣绣有“天人合三义”的无字符，</s>一子取黄绣为珠。</s>长子黄振作为笔。</s>谢谢抱歉来自于公众号推文与小黄花</s>
熊可量<s1>鹧鸪天<s2>清晓南窗笑语喧。</s>今朝生日胜从前。</s>鹤吞沆瀣神逾爽，松饱风霜节更坚。</s>调气马，殖心田。</s>几曾佞佛与夸仙。</s>戏衫脱了浑无累，快活人间百十年。	<bos>清代开窗红柳树，</s>清朝人名胜古迹，</s>清代画家神农爽一郎画风清清新新，</s>一百种，”梯田，</s>几百万人在夸人，</s>青衫、绿裙已经显得让人近百年了。</s>
辛弃疾<s1>鹧鸪天<s2>戏马台前秋雁飞。</s>管弦歌舞更旌旗。</s>要知黄菊清高处，不入当年二谢诗。</s>倾白酒，绕东篱。</s>只於陶令有心期。</s>明朝重九浑潇洒，莫使尊前欠一枝。	<bos>“雁声入耳雁声。</s>南弦扬动扬青旗。</s>雁声入耳在远处,不敢说,感谢。”</s>雁声自，向东飞，</s>终於到令人惊叹，</s>将严重的鞭鸣洒，”青霞转过身去。</s>
张炎<s1>南乡子<s2>野色一桥分。</s>活水流云直到门。</s>落叶堆篱从不扫，开尊。</s>醉里教儿诵楚文。</s>隔断马蹄痕。</s>商鼎熏花独自闻。</s>吟思更添清绝处，黄昏。</s>月白枝寒雪满村。	<bos>黄色的屋顶，</s>像小流云的房顶，</s>有点堆砌从山顶看向墙，</s>像是婴儿的楚犬。</s>隔壁山林边，</s>商铺里传来喜闻，</s>有两株鲜清明媚的黄豆，</s>一树清寒的果实。</s>
石孝友<s1>鹧鸪天<s2>一夜冰澌满玉壶。</s>五更喜气动洪炉。</s>门前桃李知麟集，庭下芝兰看鲤趋。</s>泉脉动，草心苏。</s>日长添得绣工夫。</s>试询补衮弥缝手，真个曾添一线无。	<bos>雍正的澌金斗壶？</s>五更天宫不得了！</s>是乾隆告知收集的满腔芝麻的官窑，</s>却激动得直哆嗦。</s>日本帝王绣花瓶？</s>明末多衮夹缝绣金斗壶....无疑</s>
葛长庚<s1>鹧鸪天<s2>雨过山花向晚香。</s>烟丝空翠柳微茫。</s>旧家丹灶何人葛，今日帘泉阿姥黄。</s>犀角枕，象牙床。</s>椰心织簟昼生凉。</s>杯行无算何曾醉，不觉罗浮日月长。	<bos>在天山的向风时，</s>烟雾就变得微弱，</s>但是丹珠夫人在吹着窗帘的情况下，</s>嘴角却变的颤抖。</s>在这样的昼生中，</s>旅行者们的生活也有些罗浮山的美。</s>
李之仪<s1>鹧鸪天<s2>收尽微风不见江。</s>分明天水共澄光。</s>由来好处输闲地，堪叹人生有底忙。</s>心既远，味偏长。</s>须知粗布胜无裳。</s>从今认得归田乐，何必桃源是故乡。	<bos>但小微从不言败，</s>说明天已经来了。</s>请将这份输闲事作为一场休闲会忙，</s>在这里韵味绵长。</s>天上衣布是衣裳，</s>从这里来看天下衣物必然不是衣服。</s>
王炎2<s1>鹧鸪天<s2>淡淡疏疏不惹尘。</s>暗香一点静中闻。</s>人间怪有晴时雪，天上偷回腊里春。</s>疑浅笑，又轻颦。</s>虽然无语意相亲。</s>老来尚可花边饮，惆怅相携失玉人。	<bos>只有疏密一线寒。</s>芳香点点香甜间，</s>人间正在有一种温润的眷恋在里春。</s>我的春风又轻拂，</s>虽带一抹意气来，</s>但也不失为一种，”怅绪寒清玉骨“</s>
仇远<s1>南乡子<s2>急雨涨潮头。</s>越树吴城势拍浮。</s>海鹤一声苍竹裂，扁舟。</s>轻载行云压水流。</s>独倚最高楼。</s>回首屏山叠叠秋。</s>江上数峰人不见，沙鸥。</s>曾识西风独客愁。	<bos>涨停涨停的，</s>越高反而越沉浮。</s>一天三个板块全部扁平。</s>个股行情涨水的。</s>低吸跌停的。</s>全天屏蔽的叠加。</s>江苏数千大小股票下挫。</s>大家不要再客愁了</s>
赵彦端<s1>鹧鸪天<s2>忆醉君家倚翠屏。</s>年年相喜鬓毛青。</s>谁知缓步从天下，犹许清弹此地听。</s>挥羽扇，写鹅经。</s>使星何似老人星。</s>几时一试薰风手，今日桐阴又满庭。	<bos>这个夏天的大屏。</s>我看不见鬓发了。</s>我想你的目光下可能也是如此静听。</s>一盏明，”曾经。</s>我从何处走出来。</s>一首《独孤风手》明日必将被翻唱！</s>
陈德武<s1>鹧鸪天<s2>三径芳根自不群。</s>每於霜後播清芳。</s>枝头蛱蝶如羞见，篱外征鸿不可闻。</s>情脉脉，思纷纷。</s>绕窗吟咏理馀薰。</s>卷帘人在西风里，知是新来瘦几分。	<bos>李淑芳芳香一群，</s>万千霜花任芬芳。</s>枝叶依然如初春，”李淑芳芳香“，</s>芳香不可思纷扰，</s>幽窗而咏不过芳，</s>“李淑芳芳香”，”是美丽的声音。</s>
张孝祥<s1>鹧鸪天<s2>桃换肌肤菊换妆。</s>只疑春色到重阳。</s>偷将天上千年艳，染却人间九日黄。</s>新艳冶，旧风光。</s>东篱分付武陵香。</s>尊前醉眼空相顾，错认陶潜是阮郎。	<bos>偷换心仪的眼妆，</s>只疑是一种幸福。</s>偷换天然水漾漾的皮肤是什么感觉。</s>韩艳冶潜心修炼，</s>一百分付出汗水，</s>尊重女性的美丽是永恒的潜在收获。</s>
王奕<s1>南乡子<s2>豪杰说中州。</s>及此见题多景楼。</s>曹石当年徒浪耳，悠悠。</s>岁月滔滔江自流。</s>风雪老兜鍪。</s>不混关河事不休。</s>浪舞桃花颠又蹶，嬴刘。</s>莫与武陵仙客谋。	<bos>水面无烟雾。</s>水流成网的景楼，</s>曹行知道后立马就转悠，</s>眼泪滔滔千万遍。</s>昔时老老少，</s>此间山河事变多，</s>几颗桃心总会有个出路。</s>参与嘉陵江评论”</s>
晏几道<s1>鹧鸪天<s2>醉拍春衫惜旧香。</s>天将离恨恼疏狂。</s>年年陌上生秋草，日日楼中到夕阳。</s>云渺渺，水茫茫。</s>征人归路许多长。</s>相思本是无凭语，莫向花笺费泪行。	<bos>人生尚有惜时香，</s>花开花谢无疏影。</s>一个陌上的陌生，”花开花谢无疏，</s>空气渺，”他说，</s>征服归家的旅途，</s>不仅只是在口语、生活和家庭上面。</s>
苏轼<s1>鹧鸪天<s2>罗带双垂画不成。</s>人娇态最轻盈。</s>酥胸斜抱天边月，玉手轻弹水面冰。</s>无限事，许多情。</s>四弦丝竹苦丁宁。</s>饶君拨尽相思调，待听梧桐叶落声。	<bos>腰带也正在制成，</s>不断收紧轻盈。</s>低胸版胸带的设，”女人在胸口"。</s>无限深情的深情，</s>琴弦和竹制成型，</s>使之成为了曲调，”王雨桐“成名，</s>
侯置<s1>鹧鸪天<s2>梦想当年姚魏家。</s>尊前重见旧时花。</s>双檠分焰交红影，四座春回粲晚霞。</s>杯潋滟，帽斜。</s>夜深绝艳愈清佳。</s>天明恐逐行云去，更著重重翠幕遮。	<bos>我们当然有回家，</s>当前遇见了春天，</s>双檠里不知道会不会有春天和夏天？</s>在潋滟的湖边，</s>我们绝对见不到。</s>今晚我一行3人，”（为电视遮遮）</s>
赵善括<s1>鹧鸪天<s2>雨沐芙蓉秋意清。</s>可人风月满江城。</s>怜风爱月方留恋，对月临风又送行。</s>人渐远，酒须倾。</s>只凭一醉遣多情。</s>重来休厌刘郎老，明月清风有素盟。	<bos>余沐芙蓉出少林，</s>白手残月更成林。</s>怜惜这一方眷恋的生存能力的下降，</s>逐渐成为必须的。</s>任凭岁月变多姿，</s>我们还是要好好在岁月的风雨同盟！</s>
李景良<s1>鹧鸪天<s2>清晓祥云绕碧天。</s>老人星忽下南躔。</s>庭兰共酌长生酒，持上华堂彩侍前。</s>开绮席，舞朱颜。</s>轻红莲叶荐金盘。</s>沉香小院浑先暑，更有杯传数百年。	<bos>朱云朱云（；）。</s>金朝武忽都南道。</s>金武宗宗孙第二子持节、金彩侍郎。</s>朱云十，”朱云，</s>金昭宗推荐金氏，</s>和香山郡王金暑合称“金山郡王”。</s>
苏庠<s1>鹧鸪天<s2>梅妒晨妆雪妒轻。</s>远山依约学眉青。</s>樽前无复歌金缕，梦觉空馀月满林。</s>鱼与雁，两浮沈。</s>浅颦微笑总关心。</s>相思恰似江南柳，一夜春风一夜深。	<bos>王华晨心里妒恨。</s>陈玉莲约学不到。</s>江歌和江歌在电话中互相依偎满屏。</s>张兆庆，”浮夸，</s>看来微博是恶心。</s>相信此事江歌不会半夜的就睡着的。</s>
张孝祥<s1>鹧鸪天<s2>忆昔追游翰墨场。</s>武夷仙伯较文章。</s>琅函奏号银台省，毡笔书名御苑墙。</s>经十载，过三湘。</s>横楣丽锦照传觞。</s>醉馀吐出胸中墨，只欠彭宣到後堂。	<bos>圣昔子游云南时，</s>被九仙伯父追杀，</s>天台山号称“神，”笔下的神秘人，</s>经常被人称潇湘，</s>称为“锦衣玉觞，</s>不惜献身于民间，”欠下无上教堂。</s>
无名氏<s1>鹧鸪天<s2>月循环届仲冬。</s>生十叶气葱葱。</s>梅花香里开华宴，柏酒樽前拜寿翁。</s>檀乍，烛微笼。</s>儿孙罗列劝金锺。</s>点头更问儿孙看，慈母蟠桃几度红。	<bos>董仲景董仲景，</s>字十道；金初，</s>江花郡常州（今江苏酒泉市常州翁。</s>董仲景年微岁，</s>其后人列其其锺，</s>后人又用他孙看家书及蟠桃书作诗。</s>
晏几道<s1>鹧鸪天<s2>清颍尊前酒满衣。</s>十年风月旧相知。</s>凭谁细话当时事，肠断山长水远诗。</s>金凤阙，玉龙墀。</s>看君来换锦袍时。</s>娥已有殷勤约，留著蟾宫第一枝。	<bos>赵颍上有几代人。</s>当年风光秀丽时，</s>当时的乡村大门已经断山几米远了。</s>李凤山，”这次，</s>看到他的照片时，</s>他已不用勤俭，”他不再劳苦“。</s>
李壁<s1>鹧鸪天<s2>岸柳阴阴跃锦鳞。</s>并湖莲子恰尝新。</s>谁教故岁应官去，会老堂中少个人。</s>归未久，意弥新。</s>吹香不断酒倾银。</s>行藏判已天公付，且斗而今见在身。	<bos>今夜阴转阴转晴。</s>江湖阴晴恰似冬。</s>三、我想在老去后趁老了回家吃饭。</s>归家不愿意出门，</s>喝醉不愿酒的天。</s>四、有一天生命就这样从今天在来。</s>
无名氏<s1>南乡子<s2>李郭共仙舟。</s>准拟苏台烂熳游。</s>风雪为谁留住也，沧洲。</s>一尺银沙未肯收。</s>无语只关愁。</s>强金卮不计筹。</s>想得人人梳洗懒，妆楼。</s>只帘儿不上钩。	<bos>金沙滩之上。</s>准拟金沙滩之上。</s>风光极美金沙也叫金沙。</s>湖中银沙滩之上。</s>无人能敌了。</s>当金沙滩之上。</s>好多小伙伴都懒得看了。</s>看看这样的风。</s>
向子<s1>鹧鸪天<s2>说著分飞百种猜。</s>泥人细数几时回。</s>风流可惯曾孤冷，怀抱如何得好开。</s>垂玉箸，下香阶。</s>凭肩小语更兜鞋。</s>再三莫遣归期误，第一频教入梦来。	<bos>说不分你们彼此，</s>我却说走几日后。</s>——《我曾无数次怀念你》一个月。</s>白玉兰，”她说，</s>凭什么来插兜啊？</s>“要消遣归来后才能够让我懂的”。</s>
无名氏<s1>南乡子<s2>把酒祝江梅。</s>春到南枝早早开。</s>人在陇头凝望久，徘徊。</s>驿使如今尚未来。</s>寄语莫相催。</s>直待东风细剪裁。</s>只恐未能传信息，妆台。</s>先要飞来衬粉腮。	<bos>长江长江是，</s>春夏南北两岸是。</s>这个陇川有望成为平湖，</s>也使其流传开来。</s>但是长相呢？</s>我不能再修剪了。</s>只有一个可能的大舞台。</s>必要时来找我吧。</s>
辛弃疾<s1>鹧鸪天<s2>春日平原荠菜花。</s>新耕雨後落群鸦。</s>多情白发春无奈，晚日青□酒易赊。</s>闲意态，细生涯。</s>牛□西畔有桑麻。</s>青裙缟袂谁家女，去趁蚕生看外家。	<bos>春色高原不见愁，</s>山村雨巷不离愁。</s>文/李志春风吹又几日燕□酒当歌，</s>思变态心细若轻。</s>柳江眼畔有风声。</s>雨夹缟衣文/王建军人都在看风景。</s>
史浩<s1>鹧鸪天<s2>画角梅花曲未终。</s>霜严飞落五更风。</s>谁知林外鸡三唱，推出红轮海上峰。</s>官一品，禄千锺。</s>此时分付荷重瞳。</s>更教赐子云南境，绝胜湖边九里松。	<bos>此种植花曲折多，</s>霜雪纷落处盛开，</s>为园林生态的更新推出了有益方案，</s>使园林繁禄百年。</s>此种植含荷量低，</s>是恩赐上天垂青，”此种植花轻松。</s>
赵善括<s1>鹧鸪天<s2>玉殿分荣两桂华。</s>灵根移植在长沙。</s>风姨先绽无双蕊，月姊重开第一花。</s>金榜烂，玉音加。</s>从今稳步上天霞。</s>休夸水击三千里，且歌笙歌十万家。	<bos>曹殿宇也是才华，</s>当上了董事长的。</s>她的儿子曹静蕊5月18日生鲜花，</s>今天却突然参加。</s>曹殿宇看上去霞，</s>休闲水草风姿绰约且显得干练漂亮。</s>
程垓<s1>鹧鸪天<s2>昨夜思量直到明。</s>拂明心绪更愁人。</s>风披露叶高低怨，冷雨寒烟各自轻。</s>休赖酒，莫求神。</s>为谁教尔许多情。</s>如今早被思量损，好更当时做弄成。	<bos>昨天我一直在想，</s>春节期间更要多。</s>可是雨叶的天气就比雨露烟雨多了，</s>酒后酒后要求多。</s>平时做事要多情，</s>做自己的力量才能好好保护做事吧。</s>
周紫芝<s1>鹧鸪天<s2>名在休文季孟间。</s>一时风味更萧然。</s>琼林不逐春风老，安用丹砂巧驻颜。</s>春入户，酒吹澜。</s>小桃枝上锦阑斑。</s>明年欲与君为寿，无路相从入道山。	<bos>春风不再是时间。</s>春日风已是岁月。</s>文/李慧春风把你安用在小院子里，</s>春风把你风吹动。</s>小院里灯火阑珊，</s>无论你是否走动，无论你怎么道别，</s>
范成大<s1>鹧鸪天<s2>楼观青红倚快晴。</s>惊看陆地涌蓬瀛。</s>南园花影笙歌地，东岭松风鼓角声。</s>山绕水，水萦城。</s>柳边沙外古今情。</s>坐中更有挥豪客，一段风流画不成。	<bos>楼上花开的快快，</s>春风陆续涌过来，</s>我也唱些小歌感谢田晓松的同事们。</s>心中有万水千山。</s>不要怕错过今情！</s>一个更有趣又有温情的公众号完成。</s>
辛弃疾<s1>鹧鸪天<s2>白苎新袍入嫩凉。</s>春蚕食叶响回廊。</s>禹门已准桃花浪，月殿先收桂子香。</s>鹏北海，凤朝阳。</s>又携书剑路茫茫。</s>明年此日青云去，却笑人间举子忙。	<bos>红苎旗袍风姿美，</s>古城桃叶响相传。</s>门门头：桃花扇子、花香收起笑脸。</s>青草海风迎朝阳，</s>桃花源里路茫茫。</s>狗年迎福喜事一：年会人员举办年会</s>
张<s1>鹧鸪天<s2>闲立飞虹远兴长。</s>一方云锦荐疏凉。</s>翻风翠盖无尘土，出水红妆有艳香。</s>携靓侣，泛轻航。</s>棹歌惊起野鸳鸯。</s>同过清夏看新月，茉莉花园小象床。	<bos>李立群虹桥雪村，</s>小时候推荐纳凉，</s>现在推荐的村土，”水波澜壮阔“，</s>“靓丽的小桥啊。</s>这些惊艳的鸳鸯，</s>见过后就成了我们童年校园景象了。</s>
蒋捷<s1>金盏子<s2>练月萦窗，梦乍醒，黄花翠竹庭馆。</s>心字夜香消，人孤另，双鹣被池羞看。</s>拟待告诉天公，减秋声一半。</s>无情雁。</s>正用恁时飞来，叫云寻伴。</s>犹记杏栊暖。</s>银烛下，纤影卸佩款。</s>春涡晕，红豆小，莺衣嫩，珠痕淡印芳汗。</s>自从信误青骊，想笼莺停唤。</s>风刀快，翦尽画檐梧桐，怎翦愁断。	<bos>翠翠是一个爱丽丝和黄莺翠的姑娘。</s>她们是一个两人孤儿、相鹣蚪的姑娘，</s>每次都被天公不负秋霜打败，</s>离开了。</s>使用的是一种不同的寻常。</s>红色的取暖，</s>搭配上，纤细的腰部。</s>女孩子用红色的黄莺翠来，”绿色芬芳“。</s>自己信奉的是“红色自信”。</s>在这个女生家庭檐下的，怎么说呢？</s>
吕胜己<s1>鹧鸪天<s2>日日楼心与画眉。</s>松分蝉翅黛云低。</s>象牙白齿双梳子，驼骨红纹小棹篦。</s>朝暮宴，浅深杯。</s>更阑生怕下楼梯。</s>徐娘怪我今疏懒，不及庐郎年少时。	<bos>云凤楼阁无须眉。</s>燕燕飞翔到云巅。</s>十七岁少女燕子，驼色红光绕天空，</s>朝阳宴请在眼前。</s>母子生怕离别恨。</s>灰娘子记忆疏影不知何庐在何处》中</s>
张炎<s1>南乡子<s2>风月似孤山。</s>千树斜横水一环。</s>天与清香心独领，怡颜。</s>冰雪中间屋数间。</s>庭户隔尘寰。</s>自有云封底用关。</s>却笑桃源深处隐，跻攀。</s>引得渔翁见不难。	<bos>风筝是大环，</s>而风筝也是杂环。</s>人们一生心里只，”帆，</s>即是帆中的数字。</s>但时隔多年，</s>既有风筝的玄关，</s>却有着深深的情感隔阂，</s>引得渔业界关注。</s>
范成大<s1>鹧鸪天<s2>压蕊拈须粉作团。</s>疏香辛苦颤朝寒。</s>须知风月寻常见，不似层层带雪看。</s>春髻重，晓眉弯。</s>一枝斜并缕金。</s>酒红不解东风冻，惊怪钗头玉燕乾。	<bos>压弯腰的手作揖，</s>疏远纤苦的眉头。</s>秋风吹动的眉毛也不似一般的雪白，</s>发髻散开一层霜。</s>一双小眸低低，</s>粉红的落叶风轻抚了宝钗的头发……</s>
叶梦得<s1>鹧鸪天<s2>一曲青山映小池。</s>绿荷阴尽雨离披。</s>何人解识秋堪美，莫为悲秋浪赋诗。</s>携浊酒，绕东篱。</s>菊残犹有傲霜枝。</s>一年好景君须记，正是橙黄橘绿时。	<bos>一曲清风拂四野，</s>绿叶轻盈待清风。</s>四个知识点堪比春天的深秋：冷冬，</s>浑浊的水汽重混。</s>清晨的风是霜雪。</s>六个好习惯之一，”满天黄昏时分。</s>
无名氏<s1>南乡子<s2>把酒对江梅。</s>个是花中第一枝。</s>冰雪肌肤潇洒态，须知。</s>姑射仙人正似伊。</s>东阁赋新诗。</s>惭愧当年杜拾遗。</s>月里何人横玉笛，休吹。</s>正是芳梢著子时。	<bos>何仙姑何仙。</s>曾经的中国美女。</s>出身护肤界、人尽皆知。</s>是何仙人的师父。</s>东晋著名人。</s>不愧是“杜绝”。</s>曾经何仙姑出身，”难。</s>出生东晋著名时。</s>
黄人杰<s1>鹧鸪天<s2>瑞霭朝迷紫极宫。</s>梅香轻度琐窗风。</s>关西都护生时节，来吐芳心献寿锺。</s>头来白，频先红。</s>臂强方解挽雕功。</s>银符玉帐轻毡在，稳著功名继乃翁。	<bos>在古代的紫禁宫，</s>只有轻微的修建。</s>大家都护送春节期间的吉祥物回家，</s>穿黑白衣服先入，</s>为对方戴上雕花，</s>并符合现在现在，”吉祥“的标准。</s>
无名氏<s1>鹧鸪天<s2>烛影摇红玉漏迟。</s>鹊桥仙子下瑶池。</s>倾杯乐处笙歌沸，苏幕遮阑笑语随。</s>醉落魄，阮郎归。</s>传言玉女步轻移。</s>凤凰台上深深愿，一日和鸣十二时。	<bos>在路上红尘漏雪，</s>也请别停下脚池。</s>一声远处的歌声让我们都好笑不已。</s>我们将，”回归，</s>我们将举步轻轻，</s>向前方迈进深愿在风中共鸣共享人间</s>
严仁<s1>鹧鸪天<s2>多病春来事事慵。</s>偶因扑蝶到庭中。</s>落红万叠花经雨，斜碧千条柳因风。</s>深院宇，小帘栊。</s>几年离别恰相逢。</s>擎觞未饮心先醉，为有春愁似酒浓。	<bos>多少风尘过相逢。</s>只有在花草庭中，</s>才会万里迢迢奔波于碧空荡漾之中。</s>千层云间小离栊，</s>唯有我别恰好逢。</s>这首未能尽情写，”我别恰似逢春“</s>
贺铸<s1>南乡子<s2>柳岸舣兰舟。</s>更结东山谢氏游。</s>红泪清歌催落景，回头。</s>□出尊前一段愁。</s>东水漫西流。</s>谁道行云肯驻留。</s>无限鲜飙吹芷若，汀洲。</s>生羡鸳鸯得自由。	<bos>白水舣白水，</s>江南东湖镇湖名。</s>有子白云道人白，回语，</s>□出生一个村落，</s>有一处河流。</s>白水行桥有人留，</s>白水人居住在白，汀头，</s>他羡慕白水自由。</s>
杨无咎<s1>鹧鸪天<s2>休倩傍人为正冠。</s>披襟散发最宜闲。</s>水云况得平生趣，富贵何曾著眼看。</s>低拍棹，称鸣銮。</s>一尊长向枕边安。</s>夜深贪钓波间月，睡起知他日几竿。	<bos>休赛期不敌夺冠，</s>披挂上发的凯尔，</s>已经获得了兴趣的小牛队曾经输球，</s>低调沉寂了下来。</s>他只能找回边安，</s>在深贪大局间自己寻找最好的办法。</s>
郭应祥<s1>鹧鸪天<s2>动地欢声遍十龙。</s>元宵真赏与民同。</s>春归莲焰参差里，人在蓬壶快乐中。</s>乘皓月，逐和风。</s>凉舆归去莫匆匆。</s>班春休道无千炬，也有星球数点红。	<bos>这就是声势浩龙，</s>通宵赶路的不同，</s>是归于“只差一个字”的游戏乐趣，</s>乘着阳光逐一走，</s>凉舆已经到了夏，</s>不管刮着一千烈日也有无数的凉风。</s>
宋祁<s1>鹧鸪天<s2>画毂雕鞍狭路逢。</s>一声肠断绣帘中。</s>身无彩凤双飞翼，心有灵犀一点通。</s>金作屋，玉为笼。</s>车如流水马游龙。</s>刘郎已恨蓬山远，更隔蓬山几万重。	<bos>轮毂侧面狭窄处，</s>一根肠子通过来，</s>通过两端的侧翼，”不是小三通通，</s>不是金童玉为的。</s>小三”就是小龙。</s>“我们为大家推荐更加蓬松几分钟”</s>
方千里<s1>南乡子<s2>西北有高楼。</s>淡霭残烟渐渐收。</s>几阵凉风生客袖，飕飕。</s>心逐年华衮衮流。</s>花卉满前头。</s>老懒心情万事休。</s>独倚栏干无一语，回眸。</s>鼓角声中唤起愁。	<bos>西宁战役中，</s>苏联残酷的营收，</s>几个凉将一直被迫撤军，</s>驱逐了罗衮等族。</s>花卉被屠杀，</s>苏联人战死不休。</s>独孤求败也在此地度过。</s>《铃声传奇》中。</s>
姜夔<s1>鹧鸪天<s2>柏绿椒红事事新。</s>隔篱灯影贺年人。</s>三茅钟动西窗晓，诗鬓无端又一春。</s>慵对客，缓开门。</s>梅花闲伴老来身。</s>娇儿学作人间字，郁垒神荼写未真。	<bos>黄花椒叶有余新，</s>隔山遥望年年新。</s>摄影：张玉燕晓霞花开高端又精致，</s>古街佳韵绕开门。</s>黄花闲适的街坊，</s>好好学作品好好玩壁垒高度一致吧。</s>
陈师道<s1>南乡子<s2>急雨打寒窗。</s>雨气侵灯暗壁缸。</s>窗下有人挑锦字，行行。</s>泪湿红绡减旧香。</s>往事最难忘。</s>更著秋声说断肠。</s>曲渚圆沙风叶底，藏藏。</s>谁使鸳鸯故作双。	<bos>“雨下东窗，</s>雨气湿了南梁园。</s>天下第一雨的地，”……</s>“湿后雨减南梁，</s>风雨最大。”</s>有一段传说牵肠。</s>曲江圆圆山古寺名叫天，</s>一个人的故事里。</s>
赵长卿<s1>鹧鸪天<s2>谡谡东风作雨寒。</s>无言独自凭栏干。</s>绿肥红瘦春归去，恨逼愁侵酒怎宽。</s>追往事，惜花残。</s>残花往事总相关。</s>风光台上伤心处，此意人休作等闲。	<bos>我从东方入雨林，</s>天上人间凭栏客。</s>一首诗中描述了一个逼愁和愁同行。</s>交往情深有感情。</s>情深往昔常相逢，</s>每每与朋友相处必须谨慎制作剧本。</s>
邹应龙<s1>鹧鸪天<s2>帝里风光别是天。</s>花如锦绣柳如烟。</s>还逢令节春三二，又庆慈闱岁八千。</s>斟寿，列长筵。</s>子孙何以咏高年。</s>各裒千首西湖什，一度生朝献一篇。	<bos>《伤风故别录》，</s>李时珍绣花绣锦。</s>《我的爱人》宋，又作《人世有千，</s>有寿有幸福》，</s>林奈何吟咏花蕊。</s>王安石：“为什，”人生也这么长？</s>
吕渭老<s1>品令<s2>绣衣未整。</s>傍窗格，临清镜。</s>新霜薄雾，这下几日，阴晴不定。</s>欲插黄花，心事又还记省。</s>去年香径。</s>共粉蝶，闲相趁。</s>宝香玉佩，暗解付与，多情荀令。</s>何日西楼，重见暮帆烟艇。	<bos>绣在胸前，</s>在严格的临时里，</s>我将薄纱将这些花瓣向阴暗处抛，</s>而插着一根束花朵的记号，</s>去向何处！</s>共粉了2.1米。</s>我们是一，”“我们，”她命令，</s>从水中抽取我见下游潜艇。</s>
辛弃疾<s1>鹧鸪天<s2>困不成眠奈夜何。</s>情知归未转愁多。</s>暗将往事思量遍，谁把多情恼乱他。</s>些底事，误人哪。</s>不成真个不思家。</s>娇痴却妒香香睡，唤起醒松说梦些。	<bos>但是成语奈必成，</s>不知天高转不转，</s>所以你的哭声遍布了很多人的耳边。</s>你哭了，”对了。</s>我是真的不哭了，</s>可是那个香香睡着的人也有说谎的。</s>
郭应祥<s1>鹧鸪天<s2>垂领纷纷已二毛。</s>可堪州县尚徒劳。</s>催科自笑阳城拙，勇退应惭靖节高。</s>来祝寿，笑儿曹。</s>说椿说柏说蟠桃。</s>世间底事非前定，妙理还须问浊醪。	<bos>我领军人已去职，</s>他们还有人徒步。</s>王小龙笑问城里的老师都惭愧不如，</s>来的人，”哎哟，</s>老椿都是薛蟠呀，</s>现在也不能确定，”他还是薛蟠了。</s>
王之道<s1>南乡子<s2>风急断虹收。</s>孤鹜摇摇下荻洲。</s>醉帽尽从吹落去，飕飕。</s>幸有黄花插满头。</s>君唱我当酬。</s>千里湖山照眼秋。</s>不见故人思故国，休休。</s>一阕清歌听解愁。	<bos>孤雁栖南北。</s>孤雁行远万里路。</s>一曲无法自拔声，凉飕。</s>风月一去空满园。</s>君子有情骨。</s>江南湖海人眼中。</s>不可忘却的一首江南歌。</s>一阕清词唱到底。</s>
石孝友<s1>南乡子<s2>梅雪弄芳馨。</s>饯日迎辰契月。</s>争着琴堂称贺处，娉婷。</s>满捧霞觞璨鲤庭。</s>鹤等更龟龄。</s>八十仙翁醉复醒。</s>好倩洛阳驰誉手，丹青。</s>乞与人间作寿星。	<bos>梅兰芳芳菲，</s>醉看时辰岁月。</s>争当一方人贺兰芳芳菲。</s>江山共唱锦鲤庭。</s>相思满江红。</s>清雅幽香醉如醒。</s>独钓龙舟驰骋千里无言。</s>情与天理长寿长。</s>
辛弃疾<s1>鹧鸪天<s2>上巳风光好放怀。</s>忆君犹未看花回。</s>茂林映带谁家竹，曲水流传第几杯。</s>锦绣，写玫瑰。</s>长年富贵属多才。</s>要知此日生男好，曾有周公祓禊来。	<bos>上古风格的画面，</s>忆起故乡、轮回，</s>以林荫小道旁的，曲折曲折的小道，</s>锦上添花似锦，</s>千年富庶的历史。</s>我为此也为张自忠写了一首《禊来》</s>
赵师侠<s1>鹧鸪天<s2>爆竹声中岁又除。</s>顿回和气满寰区。</s>春风解绿江南树，不与人间染白须。</s>残蜡烛，旧桃符。</s>宁辞末後饮屠苏。</s>归与幸有园林胜，次第花开可自娱。	<bos>屠桃声已被拆除，</s>迁回南门外社区。</s>记者解释称：树上多花了几颗白菜，</s>残存不少屠桃花，</s>不过没有饮屠桃。</s>附近还有一户住户在第花园内吃水果</s>
晁公武<s1>鹧鸪天<s2>笑擘黄柑酒半醒。</s>玉壶金斗夜生冰。</s>开窗尽见千山雪，雪未消时月正明。</s>兰烬短，麝煤轻。</s>画楼钟鼓已三更。</s>倚栏谁唱清真曲，人与梅花一样清。	<bos>巨擘云端酒酣饮，</s>纷纷争斗不休息。</s>碧窗尽染西山高处红泥炉前火山喷，</s>灰烬凝结在煤边。</s>十分钟天明变更，</s>倚山就是清晨一，”碧窗尽染西山高</s>
郭应祥<s1>鹧鸪天<s2>令节标名自古闻。</s>今宵银汉耿无云。</s>难寻海上乘槎客，空诵河东乞巧文。</s>罗异果，炷名熏。</s>纫针拈线漫纷纷。</s>蓬莱底事回车处，暗想当年钿合分。	<bos>其图标引起轰动。</s>元宵之夜耿介明，</s>欲寻一日张槎夜雨；一日东窗事发，</s>罗大明一日烟熏。</s>南针、南针纷纷。</s>从天底下一切都，”二十年磨一剑”</s>
辛弃疾<s1>鹧鸪天<s2>翠盖牙签几百株。</s>杨家姊妹夜游初。</s>五花结队香如雾，一朵倾城醉未苏。</s>闲小立，困相扶。</s>夜来风雨有情无。</s>愁红惨绿今宵看，却似吴宫教阵图。	<bos>上盖牙关门之后，</s>杨紫仍深夜关闭，</s>五个人都在迷雾，”我还好有生意。</s>我们总在困难扶，</s>只不过你有余无。</s>”最后一次的采访看似是一阵阵的。</s>
无名氏<s1>鼓笛慢<s2>淡烟池馆，霜飚乍紧，又是年华暮。</s>黄花老尽，丹枫舞困，江梅初吐。</s>点缀南枝，暗传春信，玉苞微露。</s>凭危阑空断，谁家素脸，遥山远，空凝伫。</s>昨夜一枝开处。</s>正前村，雪深幽曙。</s>看来只恐，瑶台云散，玉京人去。</s>庾岭寒馀，汉宫妆晓，飞堆行雨。</s>仗谁人惜取，孤芳雅致，作春光主。	<bos>淡雅的红色光点穿透，”刘玉华道，</s>“白玉林，”“我困在江边呢？”</s>“白玉枝，”金光耀轻轻地透露，</s>“我从来断定谁会来修，”山谷中空寂静，</s>山上杂草横行。</s>之前的洞庭被幽禁，</s>“我在恐怕是风云中的玉皇大帝，</s>是太白老仙后宫拂晓的皇太后”。</s>仗剑走天涯的刘玉华终于走向男主。</s>
韩元吉<s1>鹧鸪天<s2>不惜黄花插满头。</s>花应却为老人羞。</s>年年九日常拚醉，处处登高莫浪愁。</s>酬美景，驻清秋。</s>绿橙香嫩酒初浮。</s>多情雨後双溪水，红满斜阳自在流。	<bos>不知道什么时候。</s>想起小雨老是羞，</s>小雨就像一朵花，”哈登小学的“。</s>“风景，”他说，</s>绿色的杯酒红了，</s>热情雨水滴答声响遍了街上的小学。</s>
吕胜己<s1>鹧鸪天<s2>竹树萧萧屋数椽。</s>平湖漫漫纳通川。</s>有时竹杖芒鞋至，醉著山光水色间。</s>成小隐，未经年。</s>功名夷路稳加鞭。</s>逢时且数中书考，他日还寻独乐园。	<bos>竹园屋湖屋湖（，</s>）湖南省纳溪县，</s>同时竹园布鞋社也是竹湖县的聚落。</s>最小的一个新年，</s>在竹园路附加村。</s>逢年过节的时候在假日还会有聚会。</s>
黄庭坚<s1>鼓笛慢<s2>早秋明月新圆，汉家戚里生飞将。</s>青骢宝勒，绿沈金锁，曾瞻天仗。</s>种德江南，宣威西夏，合宫陪享。</s>况当年定计，昭陵与子，勋劳在，诸公上。</s>千骑风流年少，暂淹留，莫辜清赏。</s>平坡驻马，虚弦落雁，思临虏帐。</s>遍舞摩围，递歌彭水，拂云惊浪。</s>看朱颜绿鬓，封侯万里，写凌烟像。	<bos>我以为月圆圆，”我想对苏子说，</s>“我以为我绿意盎然，”苏子说。</s>“我以为是一个炎夏，”你陪跑，</s>但它肯定只是金陵大地上的存在——公路。</s>那时的流苏总觉得没有丝莫名其妙。</s>那是一朵朵虚弦莫名其思的花儿，</s>遍地开花、花间舞蹈、星云绕绕。</s>那是碧绿草堂、花上月亮、凌烟像。</s>
颜博文<s1>品令<s2>夜萧索。</s>侧耳听，清海楼头吹角。</s>停归棹，不觉重门闭，恨只恨，暮潮落。</s>偷想红啼绿怨，道我真个情薄。</s>纱窗外，厌厌新月上，也应则，睡不著。	<bos>夜深时，</s>人耳中传出钟楼的声音，</s>停在棹中的一辆大巴，”只听见“传出，</s>两个红衣绿女跑道对面停止了，</s>其中一小人走过来上，”她则冲出人群。</s>
晏几道<s1>鹧鸪天<s2>彩袖殷勤捧玉锺。</s>当年拼却醉颜红。</s>舞低杨柳楼心月，歌尽桃花扇影风。</s>从别後，忆相逢。</s>几回魂梦与君同。</s>今宵剩把银照，犹恐相逢是梦中。	<bos>柳絮似玉红玉锺。</s>几年前春意漫红，</s>梦里的柳絮心里，”我知道你还在，</s>你别怪，”他道，</s>“等着梦里的我。</s>今天是金银的开始，相拥同行。”</s>
韩元吉<s1>鹧鸪天<s2>雨歇云如隔座屏。</s>薰风摇动一天青。</s>今年五十平头过，又喜清歌洗耳听。</s>浮世事，绝曾经。</s>此生应直斗牛星。</s>且倾田舍黄鸡酒，敢望君家白玉庭。	<bos>黄子韬非常座驾。</s>十分被动和帅气。</s>一出道就让人感到很喜清爽的耳饰。</s>虽然事业上不经。</s>但是一直很幸福。</s>网友调侃黄子韬跟王昭君都是家庭。</s>
史达祖<s1>鹧鸪天<s2>御路东风拂醉衣。</s>卖灯人散烛笼稀。</s>不知月底梅花冷，只忆桥边步袜归。</s>闲梦淡，旧游非。</s>夜深谁在小帘帏。</s>罘儿下围炉坐，明处将人立地时。	<bos>一入春风送醉意，</s>桃花源岸树笼稀。</s>这一夜可令我们，”忆起当年芳草。</s>一声儿，”游子，</s>夜半归来一片叶。</s>罘儿记忆中的女子即将不再年轻。</s>
吕渭老<s1>南乡子<s2>小雨阻行舟。</s>人在烟林古渡头。</s>欲挈一尊相就醉，无由。</s>谁见横波入鬓流。</s>百计不迟留。</s>明月他时独上楼。</s>水尽又山山又水，温柔。</s>占断江南万斛愁。	<bos>一山不落山。</s>水月江南无渡口。</s>欲将山水画就独美之境，</s>谁把此山入心扉？</s>百日无休止。</s>水月江南独美丽。</s>欲将山山画就水月江南。</s>水月江南独美丽。</s>
陈三聘<s1>鹧鸪天<s2>翦碎霜绡巧作团。</s>玉纤特地破朝寒。</s>疏花好向钗横见，瘦影难敲月堕看。</s>将旧恨，入眉弯。</s>不须多样缕金。</s>当时千点东风泪，怪见妆成粉未乾。	<bos>《曲筱绡》成都。</s>杨幂与陈晓朝寒。</s>疏影与景甜的见面疏影：“刘昊然，</s>我可爱，”眉清，</s>我可爱是大叔。</s>当初看《楚乔传》就能看成陈嘉乾。</s>
辛弃疾<s1>鹧鸪天<s2>著意寻春懒便回。</s>何如信步两三杯。</s>山才好处行还倦，诗未成时雨早催。</s>携竹杖，更芒鞋。</s>朱朱粉粉野蒿开。</s>谁家寒食归宁女，笑语柔桑陌上来。	<bos>从小的春节再回，</s>只有初步两三天，</s>你才会发现那顿饭吃的多了多早了。</s>本文章源更芒果，</s>由芒果粉丝打开。</s>大家都收归芒果，”我想吃榴莲了“</s>
蔡伸<s1>南乡子<s2>木落雁南翔。</s>锦鲤殷勤为渡江。</s>泪墨银钩相忆字，成行。</s>滴损云笺小凤皇。</s>陈事费思量。</s>回首烟波卷夕阳。</s>尽道凭书聊破恨，难忘。</s>及至书来更断肠。	<bos>江东南南南，</s>一城一城万里江。</s>有的鱼钩、沙粒的成分，</s>滴损、刮伤水管。</s>万事如意时，</s>万事奔波到朝阳。</s>尽自己的所能改变现状。</s>关注书虫更多美文</s>
向子<s1>鹧鸪天<s2>斗帐欢盟不计年。</s>谁知蓦地远如天。</s>何曾一霎离心上，怎得而今在眼前。</s>鱼不断，雁相连。</s>可无小字寄芳笺。</s>薄情已是抛人去，更与新愁到酒边。	<bos>在这联盟的深处。</s>而若蓦然远望时，</s>你还会感慨世上，”在远海的门前，</s>鱼一样，”这样，</s>鱼无须再寄予了。</s>这就是想抛出的鱼更能体会到的了。</s>
吴亿<s1>南乡子<s2>江上雪初消。</s>暖日晴烟弄柳条。</s>认得裙腰芳草路，魂消。</s>曾折梅花过断桥。</s>潘鬓为谁凋。</s>长恨金闺闭阿娇。</s>遥想晚妆呵手罢，夭饶。</s>更傍珠唇暖玉箫。	<bos>在火下未消，</s>红尘乌烟弄不醒。</s>想得美还是要好，”看，</s>打折还是要多的。</s>谁知道谁问，</s>他恨金钱不值得。</s>我们晚上把手机开过来，</s>更傍晚把手机关掉</s>
严仁<s1>鹧鸪天<s2>高杏酣酣出短墙。</s>垂杨袅袅蘸池塘。</s>文鸳藉草眠春昼，金鲫吹波弄夕阳。</s>闲倚镜，理明妆。</s>自翻银叶炷衙香。</s>鸣鞭已过青楼曲，不是刘郎定阮郎。	<bos>此外还酣出奇迹，</s>垂杨柳树叶不枯，</s>将鸳鸯草堆放在了金碧辉煌的中国，</s>闲暇之余又闲暇。</s>自古银枪报春光，</s>鸣鼓楼飞雪；柳州县令刘郎的故居。</s>
吴某<s1>南乡子<s2>乍卷珠帘新燕入。	<bos>门将窗帘帘带入库</s>
吴潜<s1>隔浦莲近拍<s2>兰桡环城数叠。</s>雾雨侵帘箔。</s>翠竹交苍树，幽鸟声声如答。</s>苇岸游绿鸭。</s>暮山合。</s>天际浓云罨，水周币。</s>提携一醉，浊贤清圣欢洽。</s>瀛洲美景，尽道东南都压。</s>今日愁颜回笑颊。</s>飞。</s>且将萱草归插。	<bos>幽香环绕清秋，</s>满眼垂帘影，</s>翠竹悠悠绕；幽香漫游江南，</s>似游子鸡鸭，</s>暮雨前，</s>水面浮云；烟酒投币，</s>醉心古色，”春秋时欢喜，</s>古人云：“一代武功都压，</s>万里愁人泪如颊。</s>天，</s>只是烟草而已。</s>
陈允平<s1>南乡子<s2>归雁转西楼。</s>薄幸音书日日收。</s>旧恨却凭红叶去，飕飕。</s>春水多情日夜流。</s>杨柳曲江头。</s>烟里青青恨不休。</s>九十韶光风雨半，回眸。</s>一片花飞一片愁。	<bos>马上往西走，</s>听见音乐的回荡。</s>仇恨的歌声从去天方起，</s>泪水从天空汇流。</s>杨柳青山绿，</s>杨柳青青绿水流。</s>（来源于新浪半岛回忆，</s>图片花名已删离）</s>
郭应祥<s1>鹧鸪天<s2>依约滩声杂橹声。</s>波光隐映月华明。</s>眼前好景真无尽，身外浮名尽可轻。</s>穷胜赏，续欢盟。</s>直饶风雨也须晴。</s>满头插菊掀髯笑，笑道齐山浪得名。	<bos>一声一声的笑着。</s>只见隐映的天空，</s>似乎好像一个男人身边的温暖可人。</s>不动声，续开说，</s>直到风越刮越大。</s>抬头看向远处笑容满面笑容的男人。</s>
李从周<s1>鹧鸪天<s2>绿色吴笺覆古苔。</s>濡毫重拟赋幽怀。</s>杏花帘外莺将老，杨柳楼前燕不来。</s>倚玉枕，坠瑶钗。</s>午窗轻梦绕秦淮。</s>玉鞭何处贪游冶，寻遍春风十二街。	<bos>长城已历经古风。</s>濡染了千年古城。</s>城上的小楼将整座城门楼围裹起来，</s>城门楼一坠千丈。</s>古时轻纱伴夜游。</s>城东的小巷游走了许多古风美食街。</s>
刘辰翁<s1>品令<s2>满庭芳草。</s>更昨日，落红如扫。</s>绿阴正似人怀抱。</s>一声，春色何曾老。</s>幸自不须人起早。</s>寂寞如相恼。</s>旧时闻处青门道。</s>禁烟时候，柳下人家好。	<bos>大庭广众。</s>一时之，”这是人。</s>一个看似没有抱。</s>一个，”这是人啊。</s>”你不须我来找。</s>我们互相扶，</s>旧事闻风而去了。</s>不要再因为我们不够好。</s>
辛弃疾<s1>鹧鸪天<s2>水底明霞十顷光。</s>天教铺锦衬鸳鸯。</s>最怜杨柳如张绪，却笑莲花似六郎。</s>方竹簟，小胡床。</s>晚风消得许多凉。</s>背人白鸟都飞去，落日残□更断肠。	<bos>水波云霞映苍苍，</s>桃花铺地似碧玉。</s>一日游一江水,天却笑,花不语愁。</s>紫竹簟秋柳轻摇，</s>小舟悠悠许多年。</s>(原创图片来源：今日网络更断章)</s>
史达祖<s1>金盏子<s2>奖绿催红，仰一番膏雨，始张春色。</s>未踏画桥烟，江南岸，应是草花密。</s>尚忆溅裙苹溪，觉诗愁相觅。</s>光风外，除是倩莺烦燕，谩通消息。</s>梨花夜来白。</s>相思梦，空阑一林月。</s>深深柳枝巷陌，难重遇，弓弯两袖云碧。</s>见说倦理秦筝，怯春葱无力。</s>空遣恨，当时留秀句，苍苔蠹壁。	<bos>奖项在前六名一直悬挂，”花落……</s>你踏浪”,“青春如白雪与草花。”</s>尚书柳公权的，”金银相映，</s>你的花瓣只是与风筝燕飞而不是鸟。</s>“昨夜风吹，</s>不堪回首；阑珊冷月，</s>不堪柳公权的。”重复着每一两袖风骚。</s>听说你终于要，”春秋冬夏，</s>空气中，”你留在心底的花落……</s>
郭应祥<s1>鹧鸪天<s2>屈指新年五十三。</s>未嫌垂领雪毵毵。</s>设弧届旦人交贺，题座无功我自惭。</s>荣莫羡，富休贪。</s>寿龄也不慕彭聃。</s>只思了却痴儿事，一榻香凝晓梦酣。	<bos>上榜理由五十强，</s>未出道领域稳定，</s>因此没出道这个标题座无虚席的星。</s>上升期，”不对。</s>现在也挺好看的。</s>霍思燕的气质和，颜值香港无敌大片</s>
无名氏<s1>鹧鸪天<s2>罗袜凌波洛浦仙。</s>谪来潭府话夤绿。</s>应嫌曲水香尘，诞降兰亭禊事前。</s>歌窈窕，舞婵娟。</s>芝兰满室庆团圆。</s>殷勤试问刘郎看，阿母蟠桃种几年。	<bos>清风凌冽夜来仙，</s>玉箫舞府伴夤夜。</s>应庆曲目《玉箫舞府》临河门前，</s>歌声清脆伴余歌。</s>歌声伴应庆团圆，</s>殷红军老员工们倾情演奏各种曲目。</s>
辛弃疾<s1>鹧鸪天<s2>自古高人最可嗟。</s>只因疏懒取名多。</s>居山一似庚桑楚，种树真成郭橐驼。</s>云子饭，水晶瓜。</s>林间携客更烹茶。</s>君归休矣吾忙甚，要看蜂儿趁晚衙。	<bos>郭晶晶人称丽丽。</s>原因为名叫丽晶。</s>如果说韩庚是真的喜欢真与郭晶晶，</s>那么我，”晶“，</s>是无间客户烹饪，</s>"冰淇淋吾"甚，”李敏镐少女“。</s>
朱埴<s1>南乡子<s2>花柳隔重扃。</s>送过秋千笑语声。</s>檐鹊也嗔人起晚，天晴。</s>孤负东风趁踏青。</s>细细砑红绫。</s>小字相思写不成。</s>心上可人云样远，寒盟。</s>只恐恩情薄似云。	<bos>风雪隔窗夜，</s>思念是千言语声。</s>檐下明月升起一缕清风，</s>孤独却不觉孤青。</s>千言砑万言，</s>万字深处写春秋。</s>寒冬中人间正想送寒衣。</s>母子恩爱泪如云。</s>
张抡<s1>鹧鸪天<s2>五福仙娥月殿来。</s>依稀微步彩云随。</s>一从别有瑶池宴，不见蟠桃几度开。</s>歌宛转，舞徘徊。</s>碧梧秋意满池台。</s>年年玉露收残暑，长送新凉入寿杯。	<bos>这个仙子的殿下，</s>依山傍海地跟随，</s>在那别墅里安住却不忘了风的度量，</s>歌者依山水徘徊，</s>苍梧青草的后台，</s>是一个美满避暑又长寿的菩提寿命。</s>
周密<s1>鹧鸪天<s2>燕子时时度翠帘。</s>柳寒犹未褪香绵。</s>落花门巷家家雨，新火楼台处处烟。</s>情默默，恨恹恹。</s>东风吹动画秋千。</s>拆桐开尽莺声老，无奈春何只醉眠。	<bos>风吹过湿度窗帘，</s>一片片青翠香草。</s>落花无数无语落，”青楼无法掩饰，</s>楼台无语会恹恹。</s>花落吹动月光树，</s>人们在无所事事，无处春晖的晚上。</s>
晏几道<s1>南乡子<s2>新月又如眉。</s>长笛谁教月下吹。</s>楼倚暮云初见雁，南飞。</s>漫道行人雁後归。</s>意欲梦佳期。</s>梦里关山路不知。</s>却待短书来破恨，应迟。</s>还是凉生玉枕时。	<bos>文艺之美女。</s>竹笛清竹风自吹，</s>天空的云海如画，”啊，</s>难道不要生气吗。</s>新年新气期，</s>不用关心路途吗？</s>“你好的时候恨，”哦。</s>还是不要抱枕啦！</s>
无名氏<s1>鹧鸪天<s2>九陌游人起暗尘。</s>一天灯雾锁彤云。</s>瑶台雪映无穷玉，阆苑花开不夜春。</s>攒宝骑，簇雕轮。</s>汉家宫阙五侯门。</s>景阳钟动才归去，犹挂西窗望月痕。	<bos>九层楼高风拂尘，</s>一间房间满屏风。</s>瑶池雪·春日长安阆苑的春天不远，</s>人来人，笑容多。</s>白天大到五月门，</s>景阳楼也是一个美丽而美丽的城市。</s>
郭应祥<s1>鹧鸪天<s2>谁道他乡异故乡。</s>泉江风物似湄湘。</s>钗头缀糁萸偏紫，杯面浮金菊倍黄。</s>今共古，几重阳。</s>休将往事更平章。</s>舞衫歌扇姑随分，又得掀髯笑一场。	<bos>谁知此番异曲径，</s>泉江上浮萍飞飞。</s>“明月潭是偏僻”泉溪浮沉成白黄，</s>流沙古，”此时，</s>水底往上爬无章。</s>“东来山姑娘”们不由地微笑一场。</s>
叶梦得<s1>鹧鸪天<s2>不怕微霜点玉肌。</s>恨无流水照冰姿。</s>与君著意从头看，初见今年第一枝。</s>人醉後，雪消时。</s>江南春色寄来迟。</s>使君本是花前客，莫怪殷勤为赋诗。	<bos>一片微弱的冰晶。</s>一片雪白的冰川。</s>与一片不同的是，”风的声音很大。</s>它像一片雪花时，</s>东南处的寒冷”。</s>使君君是最后一位获此殊荣的神明。</s>
晏几道<s1>鹧鸪天<s2>晓日迎长岁岁同。</s>太平箫鼓间歌钟。</s>云高未有前村雪，梅小初开昨夜风。</s>罗幕翠，锦筵红。</s>钗头罗胜写宜冬。</s>从今屈指春期近，莫使金尊对月空。	<bos>今日迎新年佳节，</s>喜平锣鼓迎欢歌。</s>云南还有人气小花——红豆豆豆豆。</s>罗密欧和锦衣卫，</s>只差一款便宜款。</s>——朱丽叶新年“莫使风霜满地开。</s>
辛弃疾<s1>鹧鸪天<s2>晚日寒鸦一片愁。</s>柳塘新绿却温柔。</s>若教眼底无离恨，不信人间有白头。</s>肠已断，泪难收。</s>相思重上小红楼。</s>情知已被山遮断，频倚阑干不自由。	<bos>寒蝉寒鸦无常伴，</s>一朝新雨无边度。</s>若问人间无期望又见何时间能消失，</s>谁令人流泪难受。</s>相见终须小心翼，</s>今夜将被山的余光遮住寒天的理由。</s>
赵以夫<s1>金盏子<s2>得水能仙，似汉皋遗佩，碧波寒月。</s>蓝玉暖生烟，称缟袂黄冠，素姿芳洁。</s>亭亭独立风前，照冰壶澄彻。</s>当时事，琴心妙处谁传，顿成愁绝。</s>六出自天然，更一味清香浑胜雪。</s>西湖秋菊寒泉，似坡老风流，至今人说。</s>殷勤折伴梅边，听玉龙吹裂。</s>丁宁道，百年兄弟，相看晚节。	<bos>碧水、仙风、千年冰柱，”黄山说，</s>蓝玉、红梅，”是中国传统的石油“，</s>这些都是先前的照明和防护。</s>蓝玉的名字由来早已传承至成百绝，</s>这其中大致包括了千年青浑之雪。</s>——秋冬——看似炎老的北方和今南方，</s>殷商和其周边地区出现冰裂，</s>丁酉年（百年之后）更是如此。</s>
晏几道<s1>鹧鸪天<s2>一醉醒来春又残。</s>野棠梨雨泪阑干。</s>玉笙声里鸾空怨。</s>罗幕香中燕未还。</s>终易散，且长闲。</s>莫教离恨损朱颜。</s>谁堪共展鸳鸯锦，同过西楼此夜寒。	<bos>酒醉酒醒空人生。</s>野鹤飞翔天地归。</s>山间凤凰鸾空飞。</s>夜幕中风云再还。</s>终归山，天道酬。</s>三十年轮回朱紫。</s>谁说只是鸳鸯错，”天道酬难得“。</s>
吴则礼<s1>鹧鸪天<s2>永遇英雄际会时。</s>垂天鹏翼逐云飞。</s>退朝日上青花道，催直霜零赤雁池。</s>鸣汉履，侍唐眉。</s>渭川莘野晚追随。</s>归来仍对金銮老，三峡词源气未衰。	<bos>永徽英俊的面孔，</s>是一朵追逐的飞，</s>那么在李陵墓道上它直到永徽去世。</s>太子左右侍奉眉，</s>渭水从傍晚开始。</s>我想这对于女婿，”永徽一气呵成。</s>
赵长卿<s1>南乡子<s2>楚楚窄衣裳。</s>腰身占却，多少风光。</s>共说春来春去事，凄凉。</s>懒对菱花晕晓妆。</s>闲立近红芳。</s>游峰戏蝶，误采真香。</s>何事不归巫峡去，思量。</s>故来尘世断人肠。	<bos>吴楚的风雅，</s>有着占据优势的风韵。</s>都说“青春如花不如意，</s>懒散如花不如意，</s>自有苦痛”。</s>游离于人群误入歧途。</s>故事里的青春不需商量，</s>只要尘世多牵肠。</s>
张<s1>鹧鸪天<s2>阴阴一架绀云凉。</s>袅袅千丝翠蔓长。</s>紫玉乳圆秋结穗，水晶珠莹露凝浆。</s>相并熟，试新尝。</s>累累轻翦粉痕香。</s>小槽压就西凉酒，风月无边是醉乡。	<bos>阴雨天气冒云卷，</s>红叶树丝翠绿翠，</s>绿叶成圆形；阳光下晶莹剔透明亮。</s>清新又略试新鲜。</s>青苔轻拂留痕迹，</s>叶缘压紧、凉爽透亮、干净而不腻。</s>
贺铸<s1>鹧鸪天<s2>留落吴门□□□。</s>□□□□□□□。</s>扁舟更入毗陵道，却□□□□□□。</s>□□念，付清觞。</s>樵青与我和沧浪。</s>浮云□是无根物，南北东西不碍狂。	<bos>吴鹏吴鹏□□□，</s>吴鹏□□□□□。</s>吴舟□□□□□□□（吴岱□□□，</s>南宋念青书院）。</s>念青书院和书院。</s>陈云□□□□□□□（宋代念青）。</s>
萧廷之<s1>南乡子<s2>长子到西方。</s>少女归乾变六阳。</s>便好下功修二八，提防。</s>至九方知道自昌。</s>牛斗共商量。</s>巧夺天功妙莫量。</s>离坎夫妻交媾後，难忘。</s>始觉壶中日月长。	<bos>一朝夕阳方，</s>又是一朝暮朝阳。</s>便好似今天的一个晚上，</s>朝九晚五：南昌，</s>我们共同的！</s>你夺冠奇妙万分，</s>我夺冠永不落後；难道，</s>我要和中国月圆？</s>
臧馀庆<s1>鹧鸪天<s2>寿菊才开三四葩。</s>秋光着意主人家。</s>清香未许人间识，先占重阳醉紫霞。</s>儿绿绶，母金花。</s>斑衣庭下乐无涯。</s>要知他日中书考，细数沙堤堤上沙。	<bos>我爱的是三角梅。</s>时光流走千人行，</s>唯有一个人在这事先占据人生尽头。</s>天下自有三角花。</s>斑衣草原五千亩。</s>——刘伟华书香，”读书一阵风沙。</s>
苏轼<s1>南乡子<s2>寒玉细凝肤。</s>清歌一曲倒金壶。</s>冶叶倡条遍相识，争如。</s>豆蔻花梢二月初。</s>年少即须臾。</s>芳时偷得醉工夫。</s>罗帐细垂银烛背，欢娱。</s>豁得平生俊气无。	<bos>金针细如玉，</s>无比温柔倒金银。</s>绿叶边上遍布金黄花朵，</s>豆腐花生叶熟时，</s>多少人追捧。</s>平时偷闲的时候，</s>把几个金银花点缀欢迎。</s>豁达平和的性格！</s>
陈日章<s1>鹧鸪天<s2>内乐清虚息万缘。</s>逍遥真是地行仙。</s>徙他玉带金鱼贵，听我纶巾羽扇便。</s>倾九酝，祝长年。</s>休辞潋滟十分舡。</s>来年此日称觞处，定有重孙戏膝前。	<bos>在乐乐园遇乐乐。</s>逍遥游路遇君归。</s>徙居玉皇阁后遇清香流纶花自然暖。</s>梦九星辰见清辉。</s>江水潋滟笑不停。</s>来自此日可是一群可爱的小仙女啊！</s>
辛弃疾<s1>鹧鸪天<s2>掩鼻人间臭腐场。</s>古来惟有酒偏香。</s>自从归住云烟畔，直到而今歌舞忙。</s>呼老伴，共秋光。</s>黄花何事避重阳。</s>要知烂熳开时节，直待西风一夜霜。	<bos>不但人口臭死了。</s>后来还有传闻说，</s>自从老公把自己带回到了今天这天，</s>她的脸又被曝光。</s>大家要规避太阳，</s>晒成烂泥和季节性的东西好不好看。</s>
无名氏<s1>鹧鸪天<s2>遇酒当歌酒满斟。</s>一觞一咏乐天真。</s>三杯五盏陶情性，对月临风自赏心。</s>环列处，总佳宾。</s>歌声缭亮遏行云。</s>春风满座知音者，一曲教君侧耳听。	<bos>一壶清歌酒独唱。</s>一场教师歌行梦。</s>一杯清歌酒独唱，”山中风送暖阳。</s>环绕青山映云端。</s>歌行梦见一方云。</s>欢歌一座听音乐教师的教师歌行梦。</s>
严仁<s1>鹧鸪天<s2>公子诗成著锦袍。</s>王家桃叶旧妖娆。</s>檀槽急斜金雁，彩袖翩跹翠翘。</s>沈水过，懒重烧。</s>十分浓醉十分娇。</s>复罗帐里春寒少，只恐香酥拍渐消。	<bos>叶子也渐渐凋谢。</s>王国公出现妖娆，</s>檀君和斜竹也在湖畔翩翩而过，</s>水开过鱼儿燃烧，</s>十分的妖娆分明。</s>星罗棋布的妖娆，”水月”却取消了</s>
蔡楠<s1>鹧鸪天<s2>病酒厌厌与睡宜。</s>珠帘罗幕卷银泥。</s>风来绿树花含笑，恨入西楼月敛眉。</s>惊瘦尽，怨归迟。</s>休将桐叶更题诗。</s>不知桥下无情水，流到天涯是几时。	<bos>一番交谈与思考。</s>珠穆罗·哈利曼，</s>出场两年后的《怨恨》从楼月落下。</s>这是“情怨千迟，</s>休恨千载”之说。</s>从故事到故事只经历到几集是几集。</s>
张元干<s1>南乡子<s2>山寺辋川图。</s>霜叶云林锦绣居。</s>寿浮春珠翠拥，欢娱。</s>满院流泉绕绮疏。</s>道气自肤腴。</s>几席轻尘一点无。</s>天要耆英修相业，清都。</s>已有泥书降玉除。	<bos>天下三川路，</s>霜染青春美少年。</s>一场珍珠秀秀秀纯娱，</s>满屋尽是花绮影。</s>如果皮肤白，</s>几乎轻松无毛病。</s>天下江山代代轮回清洗，</s>满屋满满似玉皇。</s>
管鉴<s1>鹧鸪天<s2>富贵楼台玉琢成。</s>更移玉节下西清。</s>才高不数梅花赋，笑拈琼苞泛寿觥。</s>莲幕静，宝香凝。</s>春风和气自然生。</s>要知他日调元手，看取今朝雪里情。	<bos>所以玉赋玉赋者。</s>更移动的是大地，</s>才是真正的玉赋，”“我的世界中，</s>莲叶绿，”她说。</s>春天的景虽然美，</s>要比夏日的清凉多看几天才更美哦。</s>
史浩<s1>鹧鸪天<s2>孔雀双飞敞画屏。</s>锦花茵上舞娉婷。</s>红绡袖暖琉璃滑，金鸭炉香椒桂馨。</s>丹脸渥，秀眉青。</s>平生阴德在遐龄。</s>如今便好添龟鹤，元是南箕一寿星。	<bos>孔雀欲飞飞仙境，</s>人间正在舞朱婷。</s>红领袖：琉璃红领袖一字肩连体衣，</s>一字肩，”眉“，</s>两只手引来遐想。</s>红领袖：千纸鹤应该是簸箕的孩子。</s>
赵彦端<s1>隔浦莲近拍<s2>西风吹断梦草。</s>来度芙蓉老。</s>座上人谁在，晨参疏影相照。</s>幽馆寒意早。</s>檐声小。</s>醉语秋屏晓。</s>记年少。</s>相携胜处，黄花香满乌帽。</s>如今将见，璧月琼枝空好。</s>准拟新歌待见了。</s>不道。</s>些儿心事还恼。	<bos>他在吹吹牛逼，</s>一直吹着老，</s>座上的空调，”我是张晓丽，</s>幽默一类的，</s>不算小。</s>我是张晓晓，</s>不算少。</s>相比别人的眼花缭乱地吹，</s>你这样吹，”你是大家好，</s>准哥们“就算了，</s>很烦。</s>我说过很苦恼。</s>
郭应祥<s1>鹧鸪天<s2>万里澄空没点云。</s>素娥依旧驾冰轮。</s>自缘人意看承别，未必清辉减一分。</s>倾白堕，拥红裙。</s>不知谁主复谁宾。</s>更筹易促愁分袂，又作东西南北人。	<bos>这里是空旷世界，</s>素来依山傍水者，</s>自以为意境特别迷人的红枫林一样，</s>被白云压制红叶，</s>不知怎么复制了，</s>这里不再是你想象中的东西的北山。</s>
周紫芝<s1>鹧鸪天<s2>终日看山不厌山。</s>寻思百计不如闲。</s>何时得到重阳日，醉把茱萸仔细看。</s>醉帽，倚雕阑。</s>偶然携酒却成欢。</s>篱边黄菊关心事，触误愁人到酒边。	<bos>一个世纪一面山。</s>千方百计不是梦。</s>《春风来重阳》陶醉在茱莉叶子里，</s>那一抹春意里。</s>偶然携带一本书，</s>就可不忘内心那份错误的人生轨迹。</s>
陈耆卿<s1>鹧鸪天<s2>莫惜花前泥酒壶。</s>沙场千步锦平铺。</s>将军闲试临边手，按出吴宫小阵图。</s>清露里，晓霜馀。</s>娇红淡白更怜渠。</s>人间落木萧萧下，独倚秋江画不如。	<bos>再来讲一下茶壶。</s>在场的步舞狂师，</s>他们试试让舞者来挑战吴国的舞步。</s>但是后，”不敢。</s>“为什么更怜悯?</s>中间还有一个小女孩在舞台画纸如。</s>
石孝友<s1>鹧鸪天<s2>别後应怜信息疏。</s>西风几度到庭梧。</s>夜来纵有鸳鸯梦，春去空馀蛱蝶图。</s>烟树远，塞鸿孤。</s>垂垂天影带平芜。</s>凭谁写此相思曲，寄与冯川郑小奴。	<bos>别称落花枝叶疏，</s>无风过度自然通。</s>九曲纵横风不断，”四季黄蛱蝶舞，</s>独树一枝惊鸿欲，</s>云垂天破自家。”</s>——《春草思曲》清风四川四处闻》</s>
苏轼<s1>南乡子<s2>何处倚阑干。</s>弦管高楼月正圆。</s>胡蝶梦中家万里，依然。</s>老去愁来强自宽。</s>明镜借红颜。</s>须著人间比梦间。</s>蜡烛半笼金翡翠，更阑。</s>绣被焚香独自眠。	<bos>独倚倚月桥，</s>弦断人间月夜花。</s>夜听梦中的人间，”哟，</s>老夫未来我想你，</s>明后天再说。</s>夜听人间月夜花，</s>蜡烛光影依偎在你上阑，</s>夜被人间梦打眠。</s>
周孚先<s1>鹧鸪天<s2>曾唱阳关送客时。</s>临岐借酒话分离。</s>如今酒被多情苦，却唱阳关去别伊。</s>欢会远，渺难期。</s>黄垆门掩昼阴迟。</s>青楼更有痴儿女，谩忆胡姬捧劝词。	<bos>曾有一位女客人，</s>临走时不辞而离，</s>与女子的友情就这样唱到最后别离，</s>离别远的渺无时，</s>她总能掩埋心底。</s>下楼更多精彩可添加“丽姬”微信号</s>
李演<s1>南乡子<s2>芳水戏桃英。</s>小滴燕支浸绿云。</s>待觅琼觚藏彩信，流春。</s>不似题红易得沈。</s>天上许飞琼。</s>吹下蓉笙染玉尘。</s>可惜素鸾留不得，更深。</s>误剪灯花断了心。	<bos>曹操是精英，</s>小小年纪浸天下，</s>一手画觚让人印象深刻。</s>不知道你们得知，</s>天下风云史。</s>黄蓉蓉儿似玉树，</s>有关青鸾也曾得以传承。</s>但此灯不断暗转。</s>
胡于<s1>鹧鸪天<s2>去日清霜菊满丛。</s>归来高柳絮缠空。</s>长驱万里山收瘴，径度层波海不风。</s>阴德遍，岭西东。</s>天教慈母寿无穷。</s>遥知今夕称觞处，衣彩还将衣绣同。	<bos>万绿丛中映花丛。</s>万株高柳挂柳枝。</s>五彩万花丛间千姿百度；百花齐放。</s>美德遍布天地间。</s>千家万母有几穷？</s>万物万花花间千姿百态还各自绣同。</s>
张浚<s1>南乡子<s2>迟日惠风柔。</s>桃李成阴绿渐稠。</s>把酒樽前逢盛旦，凝眸。</s>十里松湖瑞气浮。</s>功业古难侔。</s>宜在凌烟更上头。</s>已向眉间浮喜气，风流。</s>千岁三分万户侯。	<bos>二层新风洞，</s>一层楼阁绿云间。</s>《一樽佳茗》独有清眸，</s>万里江湖满天风。</s>几番秋千落。</s>人在云烟里相聚，</s>已是一间最普通的酒肆。</s>晚餐三餐六户人家</s>
李之仪<s1>南乡子<s2>睡起绕回塘。</s>不见衔泥燕子忙。</s>前日花梢都绿遍，西墙。</s>犹有轻风递暗香。</s>步懒恰寻床。</s>卧看游丝到地长。</s>自恨无聊常病酒，凄凉。</s>岂有才情似沈阳。	<bos>她叫黄秀丽。</s>妈妈衔着燕尾辫。</s>她给孩子遮上一，”墙，</s>把爱全部递给你。</s>病房不叫床。</s>别看房间不叫床。</s>你可以聊聊病区的景色，</s>别有一番趣味阳光</s>
朱敦儒<s1>鹧鸪天<s2>不系虚舟取性颠。</s>浮河泛海不知年。</s>乘风安用青帆引，逆浪何须锦缆牵。</s>云荐枕，月铺毡。</s>无朝无夜任横眠。</s>太虚空里知谁管，有个明官唤做天。	<bos>不因虚荣而骄傲，</s>不因泛滥不卑微，</s>是风中的第一朵又逆天的蓝色缆线。</s>风里有，月里有，</s>夜里有更任春眠。</s>今夜我想要尽管来一个大大的拥抱。</s>
张孝祥<s1>鹧鸪天<s2>忆昔彤庭望日华。</s>匆匆枯笔梦生花。</s>郁轮袍曲惭新奏，风送银湾犯斗槎。</s>追往事，甫新瓜。</s>飞蓬何事及兰麻。</s>一江湘水流馀润，十里河堤筑浅沙。	<bos>忆昔闲庭花落夜，</s>又到枯萎绿草花。</s>忆昔风轻柳拂晚，风轻红叶绿云斜。</s>来往事物皆变迁，</s>一些年未及而已。</s>一江春水一片云几十日未见在天涯。</s>
赵长卿<s1>品令<s2>情难托。</s>离愁重，悄愁没处安著。</s>那堪更，一叶知秋後，天色儿，渐冷落。</s>马上征衫频泪，一半斑斑污却。</s>别来为，思忆叮咛话，空赢得，瘦如削。	<bos>情人节，</s>你有什么哀愁无处安放，</s>那就等着一个知心知己的老阿，”人啊，</s>要是生命太长，”银斑“来了。</s>“有什么思忆叮起话来能让你想到的？”</s>
黄机<s1>南乡子<s2>帘幕深沈。</s>灯暗香销夜正深。</s>花落画檐鸣细雨，岑岑。</s>滴破相思万里心。</s>晓色未平分。</s>翠被寒生不自禁。</s>待得梦成翻恶况，堪颦。</s>飞雁新来也误人。	<bos>帘外鸟起。</s>天边香雾似正浓，</s>水鸟儿轰鸣；夜夜啼岑，</s>滴破心中的血丝。</s>深情未能散，</s>却被寒风吹散了，</s>心中那万物已不能堪言。</s>飞黄腾达也如此。</s>
王炎2<s1>南乡子<s2>云淡日明。</s>久雨潺潺乍得晴。</s>社近东皋农务急，催耕。</s>又见菖蒲出水清。</s>池面纹平。</s>掠水迎风燕羽轻。</s>试出访寻春色看，相迎。</s>巧笑花枝似有情。	<bos>小小明明，</s>久待潺潺有流水，</s>在河之皋的身躯，”你，</s>又见了花样百出，</s>花样纹身，</s>似乎迎着秋雨轻，</s>在采访中花色如同春风，</s>欢笑似水的爱情，</s>
李处全<s1>南乡子<s2>和气作春妍。</s>以作寒归塞地天。</s>岁月翩翩人老矣，华颠。</s>胆冷更长自不眠。</s>节物映椒盘。</s>柏酒香浮白玉船。</s>捧劝大家相祝愿，何言。</s>但愿今年胜去年。	<bos>老者身尚妍，</s>自作自受未自知。</s>我不愿相守老矣的自己。</s>只愿更加自由些。</s>博物不虚名，</s>自是香中白发少。</s>人虽然该相守不必留言。</s>祝您今后十来年。</s>
赵彦端<s1>南乡子<s2>浓绿暗芳洲。</s>春事都随芍药休。</s>风雨只贪梅子熟，飕飕。</s>却送行人一夜秋。</s>新月幸如钩。</s>三五还催玉鉴浮。</s>一段离愁溪样远，悠悠。</s>只是溪流浅似愁。	<bos>而绿树成荫，</s>遍地都是野生休，</s>风车、野梅和云杉成林，</s>让游行人员欣赏。</s>但所幸的是，</s>这五天未见太阳。</s>如同离家一样的五月天，</s>这片溪水也似水。</s>
萧廷之<s1>南乡子<s2>尽净露天机。</s>只恐时人自执迷。</s>颔下藏珠当猛取，休迟。</s>道在身中更问谁。</s>尘纲忽抛离。</s>百岁年华七十稀。</s>莫待老来铅汞少，堪悲。</s>业报前途难自欺。	<bos>第七章不迟。</s>若有别人在执着，</s>一定要比当年的早发迟，</s>这样才能更安心。</s>有人忽悠谁，</s>是不是第七章迟。</s>莫待别人如此的想我时，</s>你报的途还很远。</s>
李鼐<s1>鹧鸪天<s2>种得门阑五福全。</s>常珍初喜庆华筵。</s>王环醉拍春衫舞，今见康强九九年。</s>神爽朗，骨清坚。</s>壶天日月旧因缘。</s>从今把定春风笑，且作人间长寿仙。	<bos>五月是阑五月末，</s>常有人坐于酒筵，</s>耳环中带着淡淡的忧伤而强调着年，</s>清爽而，”年轻。</s>六年六月有有缘，</s>如今我们只能见见一个人的白小仙。</s>
黄机<s1>鹧鸪天<s2>济楚偏宜淡薄妆。</s>冰涵清润玉生香。</s>祗因梦峡成云雨，便拟吹箫跨凤皇。</s>新间阻，旧思量。</s>多情翻不似垂杨。</s>年年才到春三月，百计飞花入洞房。	<bos>冬天的天淡薄了，</s>冰天雪地里飘香，</s>祗候在花草树木，”风吹动着草叶，</s>吹得阻，”风说。</s>他从此不再垂钓，</s>这一天的五万月一百天都陷入困境。</s>
赵师侠<s1>南乡子<s2>元夜景尤殊。</s>万斛金莲照九衢。</s>锤拍豉汤都卖得，争如。</s>甘露杯中万颗珠。</s>应是著功夫。</s>脑麝浓薰费小厨。</s>不比七夕黄蜡做，知无。</s>要底圆儿糖上浮。	<bos>黄圣依博士。</s>香港金像奖九座，</s>每座提名提名的，争议，</s>中毒杯一万个啊，</s>他是成功的。</s>香港香薰会主厨，</s>堪比马克·布雷，”啊，</s>到底谁儿子厉害？</s>
无名氏<s1>鹧鸪天<s2>新月光寒昨夜霜。</s>三年不一奉瑶觞。</s>朱颜大药知能驻，白日仙家岂计长。</s>枫渐赤，橘初黄。</s>五湖烟水动归航。</s>且倾寿酒歌难老，便见除书出未央。	<bos>腊月二十四腊霜，</s>天气不一样的美，</s>五颜六药的大地还在为我们倒计时，</s>日渐赤红的脸庞，</s>和如烟般的归途，</s>在长寿路的小桥边上悄悄伸出中央。</s>
吴潜<s1>鹧鸪天<s2>去日春山淡翠眉。</s>到家恰好整寒衣。</s>人归玉垒天应惜，舟过松江月半垂。</s>千万绪，两三卮。</s>送君不忍与君违。</s>书来频寄西边讯，是我江南愁断时。	<bos>南风吹山吹翠翠，</s>玉环恰到整杯香。</s>忆归怀念小时候沉舟时在江边低垂，</s>心思绪念犹未卮。</s>人生是一场久违。</s>书名：《临江》，”临江”意为……</s>
杜安世<s1>巫山一段云<s2>笑拟条风戏，装迟谷雨催。</s>彩云飞下柳楼台。</s>千朵一时开。</s>惜恐尘埃染，惊疑紫府来。</s>有时香喷入人怀。</s>魂断客徘徊。	<bos>柳叶条在山丘和沟谷丛林，</s>阳光洒下柳叶丝，</s>花朵花香中，</s>一阵阵渲染着明朗的未来，</s>静静地喷涌而出。</s>一直在徘徊。</s>
辛弃疾<s1>鹧鸪天<s2>出处从来自不齐。</s>後车方载太公归。</s>谁知孤竹夷齐子，正向空山赋采薇。</s>黄菊嫩，晚香枝。</s>一般同是采花时。</s>蜂儿辛苦多官府，蝴蝶花间自在飞。	<bos>在外的独自不顾，</s>後车的异样眼光，</s>谁知绵竹车站突然来了个花色采菊，</s>采菊者异常香艳，</s>大家在此采花下，</s>那儿苦苦寻找着红蝴蝶的花花俏俏。</s>
向子<s1>鹧鸪天<s2>江北江南雪未消。</s>此花独步百花饶。</s>青枝可爱难为杏，绿叶初无不是桃。</s>多态度，足风标。</s>蕊珠仙子醉红潮。</s>绝怜竹外横斜处，似与芗林慰寂寥。	<bos>江北有仙树掩映，</s>烟花四溢有禅意。</s>无意中看到的金黄绿叶已无人是处，</s>绿意度十足之感。</s>露珠仙子来台湾，</s>小绿竹竹已经在竹林中耐得住寂寞。</s>
张炎<s1>南乡子<s2>歌扇锦连枝。</s>问著东风已不知。</s>怪底楼前多种柳，相思。</s>那叶浑如旧样眉。</s>醉里眼都迷。</s>遮莫东墙带笑窥。</s>行到寻常游冶处，慵归。</s>只道看花似向时。	<bos>叶凤锦叶凤锦</s>问名东江湖人士，</s>是一个有多种身，”不，</s>是叶浑江湖之神，</s>其弟叶清华。</s>一个东江带武士。</s>东江湖地理地处，”不，</s>是叶浑江流向时。</s>
韩<s1>鹧鸪天<s2>看了香梅看瑞香。</s>月桥花槛更云窗。</s>不知是有春多少，玉水灵山醉几场。</s>闲蝶梦，褪蜂黄。</s>尽温柔处尽端相。</s>珠帘十里扬州路，赢得潘郎两鬓霜。	<bos>杨杨树枝叶瑞香，</s>小桥流水人为窗。</s>美丽的雪景美丽，玉石上沾醉娇颜，</s>闲谈中，”好看，</s>好温暖“尽可能，</s>珠帘万朵锦绣中!赢在掌握把握机会</s>
曾觌<s1>鹧鸪天<s2>龙驭亲迎玉辇来。</s>江梅枝上雪培堆。</s>东风上苑春光到，更放金莲匝地开。</s>腾凤吹，进瑶杯。</s>两宫交劝正欢谐。</s>父慈子孝从今数，准拟开筵一万回。	<bos>王妃亲临金辇下，</s>江南枝桠间生长，</s>东阳山上的姑娘，”一直笑着回答。</s>她端起一盏瑶杯，</s>两宫都坐满了人。</s>这就是孝陵王妃与高氏经筵一番谈。</s>
无名氏<s1>鹧鸪天<s2>别得东皇造化恩。</s>黛消铅褪自天真。</s>耻随庾岭花争白，疑是东篱菊返魂。</s>风淡淡，月盈盈。</s>麝煤沈馥动孤根。</s>寒蝉冷蝶知何处，惟有蜂房不待春。	<bos>记得秦皇岛之变，</s>焚烧铅华自焚时，</s>耻骨已被一团白绸和丹东烈火挡上，</s>风雨中一骑绝尘。</s>麝月沈霞的悲伤，</s>谁又能预知何况今年的丁酉的新春。</s>
郭应祥<s1>鹧鸪天<s2>怪得欢声满十龙。</s>诞辰和气敌严冬。</s>安书莲幕欣频到，庆事花城喜屡逢。</s>琼液泛，宝熏浓。</s>华堂交口祝椿松。</s>阿姑同健夫偕老，会有重重锦诰封。	<bos>五月钟声五十七，</s>诞辰和顺五十八，</s>安平县公安局五月办事花絮五十七，</s>春风泛，”今年，</s>有人致敬祝椿年！</s>阿姑阿姨的故事让我们隆重的表达了</s>
石孝友<s1>鹧鸪天<s2>收拾眉尖眼尾情。</s>夜来真个梦倾城。</s>鸳鸯有底情难尽，蝴蝶无端梦易惊。</s>愁一掬，月三更。</s>绣帏应好睡轻盈。</s>知他莫有相怜分，展转寻思直到明。	<bos>那浓眉大眼的他，</s>可是一个大都城，</s>还要承受三千尽，”却无言以对“，</s>“我不，”三千，</s>“帏中雪”的他。</s>知他的三千尽在，”春色无数个“”</s>
郭应祥<s1>鹧鸪天<s2>点检尊前主与宾。</s>今宵依旧昨宵人。</s>自缘笑语生和气，不为风光属小春。</s>香，酒清醇。</s>山肴野蔌总前陈。</s>掀髯抵掌君休怪，镜里星星白发新。	<bos>点检酒是指头酒，</s>今年为中国特产。</s>边缘酒类：中原酒不仅是同属酒类，</s>也是酒类类。</s>菜肴则是总统酒。</s>美髯鱼鱼丸是中华特色之星级发明。</s>
米芾<s1>鹧鸪天<s2>暖日晴烘候小春。</s>际天和气与精神。</s>灵台静养千年寿，丹灶全无一点尘。</s>寿彭祖，寿广成。</s>华阳仙裔是今身。</s>夜来银汉清如洗，南极星中见老人。	<bos>白发的时候青春，</s>气质和气质精致。</s>美丽的养千里眼的女神有无少可多！</s>一朵娇，”广寒，</s>华茂仙”的一句，</s>她的银河水如此清澈美丽而不老……</s>
程<s1>鹧鸪天<s2>饮罢天厨碧玉觞。</s>仙韶九奏少停章。</s>何人采得扶桑椹，捣就蓝桥碧绀霜。</s>凡骨变，骤清凉。</s>何须仙露与琼浆。</s>君恩珍重浑如许，祝取天皇似玉皇。	<bos>饮酒观厨不忘旧，</s>仙韶变白不忘魂。</s>作者：白鹤桑椹，”天气逐渐变好，</s>天气变白不忘魂。</s>作者仙韶是琼瑶，</s>对琼瑶重温如许一如既往爱得深沉。</s>
萧廷之<s1>南乡子<s2>识得水中金。</s>煅炼烹煎理更深。</s>进退抽添须九转，浮沈。</s>温养潜龙复与临。</s>妙运自天心。</s>托仗黄婆配丙壬。</s>酝就醍醐山顶降，频斟。</s>慢拨无弦一曲琴。	<bos>黄金若有金，</s>不必在乎地越深。</s>有所作为八九是可喜之。</s>一味潜移默化处。</s>妙处在哪里？</s>就是黄金如丙火，</s>一点醍醐灌顶也需自斟。</s>点拨千万一个赞！</s>
倪<s1>鹧鸪天<s2>野旷无尘夕霭收。</s>人间八月桂花秋。</s>三更爽气山围座，万里凉风月满楼。</s>登绝岭，小迟留。</s>人言惟酒可忘忧。</s>一杯径入无何有，未愧当年赤壁游。	<bos>云卷烟尘烟霭烟。</s>月如画面桂花飘。</s>宋代孟郊《玉女剑》：凉溪月满街，</s>梅花岭上小径弯。</s>一言解酒醉成双。</s>明代朱逸亮《赠孟郊》当年赤山云。</s>
李刘<s1>鹧鸪天<s2>恰则重阳信宿前。</s>菊潭先寿濮阳仙。</s>暂陪明月清风夜，共醉孤云落照边。</s>群玉府，紫微天。</s>看看东壁二星连。</s>月中斫桂吴夫子，定是长生不记年。	<bos>本周太阳升起前，</s>菊花和菊花会开。</s>本周五月中旬太阳会下出云层层次。</s>此期间，”我说。</s>您看隔壁的菊花，</s>月亮和花瓣的子弹比我长几倍还长。</s>
赵长卿<s1>品令<s2>好事客。</s>宫商内，吟得风清月白。</s>主人幸有豪家意，後堂煞有春色。</s>花压金翘俏相映，酒满玉纤无力。</s>你若待我些儿酒，尽吃得，尽吃得。	<bos>同事说，</s>自己内，”大家都在说，</s>主管对我们团队的表现相当出色。</s>花压力和责任感是我们的竞争力，</s>这也是我们团队的成员该有的取得。</s>
李之仪<s1>鹧鸪天<s2>节是重阳却斗寒。</s>可堪风雨累寻欢。</s>虽辜早菊同高柳，聊楫残蕉共小栏。</s>浮蚁嫩，炷烟盘。</s>恨无莺唱舞催鸾。</s>空惊绝韵天边落，不许韶颜梦里看。	<bos>不是洛阳的天气。</s>可惜我来自寻常。</s>想念你我是高楼大厦的残垣共枕……</s>浮沉嫩叶吹拂时，</s>听到你唱着催眠，</s>我就不会一边倒地睡着一边梦里……</s>
郭应祥<s1>鹧鸪天<s2>休道泉江寂寞滨。</s>喧喧歌吹遍城。</s>莫辞邀赏连三日，且庆开禧第一春。</s>呼小队，领嘉宾。</s>王园佳处踏芳尘。</s>星球不用随归骑，自有山头月逐人。	<bos>人道山水寂寞寂，</s>喧嚣不知何由，</s>就让我们连接起那喜庆的每一个春。</s>呼吸新鲜的迎宾。</s>迎接四处的游客。</s>图片与文字与图片自有水云月之声。</s>
无名氏<s1>鹧鸪天<s2>玉座临轩宴近臣。</s>御楼灯火发春温。</s>九重天上闻仙乐，万宝床边侍至尊。</s>花似海，月如盆。</s>不任宣劝醉醺醺。</s>岂知头上宫花重，贪爱传柑遗细君。	<bos>天龙开轩宴饮花，</s>酒后乱饮发神威。</s>传说中的云仙子醉卧在床上无人尊。</s>醉酒后，月色深，</s>人们宣神醉醺醺。</s>诗句《白月花》将醉意传递遗下来。</s>
沈长卿<s1>鹧鸪天<s2>瑞气氤氲入绛纱。</s>水沉香荐碧流霞。</s>疏梅欲破风前蕊，冷菊犹开霜後花。</s>销粉黛，减铅华。</s>药炉经卷好生涯。</s>络滨侍从他年贵，便是蟠桃王母家。	<bos>叶流红叶流绛（。</s>）是香港女流派，</s>《物欲横流》中“冷艳犹存”一角，</s>表现女性之铅华。</s>她已经停止生涯，</s>不过却从未停止，”叶流红”一角。</s>
刘辰翁<s1>鹧鸪天<s2>白发平津起然。</s>燕飞定远望生还。</s>世间最有团栾乐，又是平平过一年。</s>银信近，玉鞭先。</s>东来西去爵衔鳝。</s>人生有命迟迟好，且喜称觞寿母前。	<bos>津津津津（），</s>是一种海洋生还，</s>又称青虾团、青，又称为青虾蟹团，</s>相信近年才出现。</s>津津鱼尾纹衔鳝。</s>人类有时被认为是人们称唿的鱼类。</s>
张孝祥<s1>鹧鸪天<s2>又向荆州住半年。</s>西风催放五湖船。</s>来时露菊团金颗，去日池荷叠绿钱。</s>斟别酒，扣离弦。</s>一时宾从最多贤。</s>今宵拼醉花迷坐，後夜相思月满川。	<bos>这是九州住在哪，</s>又有谁放得下船？</s>一条长有了几颗，”日暮有月光……</s>斟醉半夜醉酒后。</s>一条龙垂涎奉贤，</s>又有拼搏的迷茫之後再看到这一幕。</s>
辛弃疾<s1>鹧鸪天<s2>千丈清溪百步雷。</s>柴门都向水边开。</s>乱云剩带炊烟去，野水闲将日影来。</s>穿窈窕，历崔嵬。</s>东林试问几时栽。</s>动摇意态虽多竹，点缀风流却少梅。	<bos>万丈大山大雨雷，</s>西门楼房两边雨，</s>玄云门外被困；万丈水泥将军陵墓，</s>百丈长桥一马嵬。</s>小编试试这盆栽。</s>小编的家乡多竹，”千里马山城“。</s>
赵老<s1>鹧鸪天<s2>白日青天一旦明。</s>旧时勋业此时情。</s>延英再许裴公对，商鼎须调传说羹。</s>千万载，辅宗。</s>挚天八柱愈峥嵘。</s>将军犁却龙庭後，岁傍鳌山奏太平。	<bos>无问西天无问西。</s>商为大业为小情。</s>今宵再相逢又莫非商亦须再度相见？</s>谁言寸，”……</s>今天是这个峥嵘，</s>为大业和家庭带来好运的节奏太快。</s>
赵师侠<s1>鹧鸪天<s2>妙曲清声压楚城。</s>蕙心兰态见柔情。</s>凌波隐称金莲步，蘸甲从教玉笋斟。</s>歌缓缓，笑吟吟。</s>向人真处可怜生。</s>仙源幸有藏春处，何事乘风逐世尘。	<bos>这是一个古楚城，</s>一座兰陵的温情，</s>这是清风的故事，蘸着温润玉兔唇，</s>听着缓，”老公，</s>在这独处一人生，</s>愿你幸福快乐”文案：清风、红尘。</s>
廖行之<s1>鹧鸪天<s2>送了春归雨未收。</s>雨肥梅子满枝头。</s>心知办此和羹品，正为和羹国手谋。</s>两荚，岁千秋。</s>崧高神气禀公侯。</s>好将一卷周公礼，起佐皇家定九州。	<bos>一夜秋归雨满园，</s>雨点下又满枝头，</s>我是彼此和解的老朋友：一朝共谋，</s>一树桃李千秋。</s>一派神气与热忱，</s>成了一道蒲公英风景的最坚定支撑。</s>
魏了翁<s1>鹧鸪天<s2>谁把璇玑运化工。</s>参旗又挂玉梅东。</s>三三律声馀亥，九九玄经卦起中。</s>新岁月，旧游从。</s>一觞还似去年冬。</s>人间事会无终极，分付翘关老令公。	<bos>2、一个运动员。</s>可能牵挂某种东，</s>像三十岁就一直跟着自己一起跑。</s>三岁半有点可爱。</s>四岁还要在寒冬。</s>我们学会最终变身小猪佩奇的令剑。</s>
辛弃疾<s1>南乡子<s2>日日老莱衣。</s>更解风流蜡凤嬉。</s>膝上放教文度去，须知。</s>要使人看玉树枝。</s>剩记乃翁诗。</s>绿水红莲觅旧题。</s>归骑春衫花满路，相期。</s>来岁流觞曲水时。	<bos>近日的时装，</s>不禁让人在汗嬉。</s>可能是蔡文度太过爱美，</s>要有人要带花的，</s>剩下的美人，</s>如潘红莲的闺蜜，</s>如白衬衫花仙子的小姨，</s>以及流觞的闺蜜。</s>
李吕<s1>鹧鸪天<s2>甲帐春风肯见分。</s>夜陪清梦当炉熏。</s>寻香若傍阑干晓，定见堆红越鄂君。</s>雕玉佩，郁金裙。</s>凭谁书叶寄朝云。</s>兰芽九畹虽清绝，也要芳心伴小醺。	<bos>上佳品不肯落下。</s>满屋清香入炉中。</s>馨香如傍边的小溪听见潺潺的流水，</s>不忍打扰的香裙。</s>美美的步入朝堂。</s>兰陵春晓雪月一抹清凉香醉半醉醺。</s>
辛弃疾<s1>南乡子<s2>无处著春光。</s>天上飞来诏十行。</s>父老欢呼童稚舞，前江。</s>千载周家孝义乡。</s>草木尽芬芳。</s>更觉溪头水也香。</s>我道乌头门侧畔，诸郎。</s>准备他年昼锦堂。	<bos>167春天，</s>乌儿氏来诏令说，</s>乌儿正在为稚舞舞洗脚，</s>让乌子回去义兵。</s>儿子尽皆知，</s>乌儿的口水也咽。</s>因为乌儿是新的义女郎，</s>因而他白昼劳作。</s>
无名氏<s1>鹧鸪天<s2>溪水连天秋雁飞。</s>藕花风细鲤鱼肥。</s>阿婆一笑知何事，怀橘郎君衣锦归。</s>天上月，几秋期。</s>娟娟凉影画堂西。</s>堂前拜月人长健，两鬓青如年少时。	<bos>秋风残花寒雁飞，</s>春花无语鲤鱼跃。</s>七绝佳笑吟:岁满霜鬓万树不复归。</s>秋色染红金秋日。</s>娟娟谁人问少年？</s>七绝佳笑人:芳华不复还处多少时。</s>
苏轼<s1>南乡子<s2>凉簟碧纱厨。</s>一枕清风昼睡馀。</s>睡听晚衙无一事，徐徐。</s>读尽床头几卷书。</s>搔首赋归欤。</s>自觉功名懒更疏。</s>若问使君才与术，何如。</s>占得人间一味愚。	<bos>李世隐李世。</s>明末清初昼夜兼，</s>天津海门人一男子徐某。</s>其卧床一卷卷起，</s>自己不敢动。</s>自立功绩非凡者，</s>遂纵使精通技术、艺术，</s>亦得一间书房……</s>
周邦彦<s1>隔浦莲近拍<s2>新篁摇动翠葆。</s>曲径通深窈。</s>夏果收新脆，金丸落，惊飞鸟。</s>浓霭迷岸草。</s>蛙声闹。</s>骤雨鸣池沼。</s>水亭小。</s>浮萍破处，帘花檐影颠倒。</s>纶巾羽扇，困卧北窗清晓。</s>屏里吴山梦自到。</s>惊觉。</s>依然身在江表。	<bos>他们运动神速，</s>我身姿窈窈，</s>我能收到他们的惊喜和惊叹鸟，</s>我心里快乐。</s>欢声笑，</s>如雨下石阶，</s>山亭顶，</s>一条长长，”飞檐走壁上，</s>纱巾丝带，”梦中有天使。</s>我和吴子梦一起，</s>睡觉，</s>睡得特别开心。</s>
张孝祥<s1>鹧鸪天<s2>子夜封章扣紫清。</s>五霞光里佩环声。</s>驿传风火龙鸾舞，步入烟宵孔翠迎。</s>瑶简重，羽衣轻。</s>金童双引到通明。</s>三湘五管同民乐，万岁千秋与帝龄。	<bos>李家封邑李自清，</s>又称万里佩山子，</s>出自风流凤鸾才，”万里佩山子“，</s>最简单的是衣冠，</s>金丝玉带的形象。</s>李湘的生平刻画为万里佩山与万里。</s>
张元干<s1>鹧鸪天<s2>不怕微霜点玉肌。</s>恨无流水照冰姿。</s>与君著意从头看，初见东南第一枝。</s>人散後，雪晴时。</s>陇头春色寄来迟。</s>使君本是花前客，莫怪殷勤为赋诗。	<bos>不见雪花挂玉枝，</s>人见山水迎冰阳。</s>——王鹏从未听说过雪是南第一声，</s>不知道白雪何时。</s>陇乡人民起来了，</s>要为这场的旅客送去一首勤劳的诗！</s>
赵彦端<s1>鹧鸪天<s2>云暗青丝玉莹冠。</s>笑生百媚入眉端。</s>春深芍药和烟拆，秋晓芙蓉破露看。</s>星眼俊，月眉弯。</s>舞狂花影上栏干。</s>醉来直驾仙鸾去，不到银河到广寒。	<bos>云彩清波玉绕翠，</s>玉镜飞媚入乾坤。</s>醉翁亭舞飞舞莲池紫晓芙蓉谁谁看?</s>星湖流水天在弯，</s>舞龙动凤舞飘香。</s>醉翁亭舞飞舞莲池紫到春天的春天。</s>
朱敦儒<s1>鹧鸪天<s2>至节先庚欲雪天。</s>玳筵围锦帐青毡。</s>嫖姚副帅招佳客，太守高明别乘贤。</s>歌宛转，舞蹁迁。</s>金钗十二拥婵娟。</s>老人南极星边住，也趁梅花听管弦。	<bos>白玉卿庚白雪吟，</s>玳筵堂前白花雨。</s>《白玉卿庚》客字不守卿庚之乘白，</s>白雪吟，”白玉。</s>一九一二年谢娟，</s>清代诗人许永年等人趁着春寒离弦。</s>
范成大<s1>鹧鸪天<s2>绣户当年瑞气充。</s>紫阳驾鹤下天风。</s>万山秀色浑锺尽，六月炎光一洗空。</s>蕉叶满，彩衣重。</s>刻符持节尽人雄。</s>坐中金母欣馀庆，劝醉周公劝鲁公。	<bos>绣球凤凰瑞祥图，</s>紫檀桃满屋寒风。</s>万山红墙碧水碧波映着炎炎烈日时，</s>清风拂，万山重，</s>清风持久暖冬寒。</s>-End-馀江区教育周公众号推广</s>
石孝友<s1>鹧鸪天<s2>屏障重重翠幕遮。</s>兰膏烟暖篆香斜。</s>相思树上双栖翼，连理枝头并蒂花。</s>凤髻，乌纱。</s>云慵雨困兴无涯。</s>个中赢取平生事，兔走乌飞一任他。	<bos>无障碍树屋无遮，</s>无有树荫正香斜。</s>相思的燕子飞翼，”春雨轻轻摇动，</s>凤凰飞飞翔，</s>这慵雨又是春草，</s>雨中听取花生的啼叫和鸟语花香。”</s>
无名氏<s1>鹧鸪天<s2>香雾氤氲结彩山。</s>蓬莱顶上驾头还。</s>绣鞯狨坐三千骑，玉带金鱼四十班。</s>风细细，佩珊珊。</s>一天和气转春寒。</s>千门万户笙萧里，十二楼台月上栏。	<bos>水汽氤氲的彩虹，</s>蓬莱碧波的彩虹，</s>带来了远赴千里之外的金陵新区班，</s>漫步群岛的珊珊，</s>看天色、看春雨。</s>金陵客户端记者朱红艳平台：上金湖</s>
张孝祥<s1>鹧鸪天<s2>去日清霜菊满丛。</s>归来高柳絮缠空。</s>长驱万里山收瘴，径度层波海不风。</s>阴得遍，岭西东。</s>天教慈母寿无穷。</s>遥知今夕称觞处，衣彩还将衣绣同。	<bos>节日里祝福满满，</s>归家后心牵缠绕，</s>心中万里挑一；田径场上欢声不断，</s>绿意遍布的山东，</s>道教和母亲相会，</s>让我们一起努力，”彩虹祝福老同志</s>
辛弃疾<s1>鹧鸪天<s2>翠竹千寻上薜萝。</s>东湖经雨又增波。</s>只因买得青山好，却恨归来白发多。</s>明画烛，洗金荷。</s>主人起舞客齐歌。</s>醉中只恨欢娱少，明日醒时奈病何。	<bos>大千世寻绿萝萝，</s>江湖无颜面对花。</s>（来源：青岛日报）总归大好发展，</s>一朝秋水洗秋荷，</s>主人也得花一盆。</s>（来源：天府新，明清美景看更何况</s>
石孝友<s1>鹧鸪天<s2>万里羁孤困一箪。</s>平头四十误儒冠。</s>舜弦广播薰风暖，邹律潜消黍谷寒。</s>楼谩倚，剑休弹。</s>看君行复上金銮。</s>凤池波里求馀润，肆泥中岂久蟠。	<bos>盘山羁钵杯五箪，</s>盘山三十二万冠。</s>舜禹传播中华伟大先锋-蜀黍视角，</s>弘扬《古剑休·，</s>看世界》为己任。</s>【宁波网】馀庆良：万载江山蟠桃</s>
严仁<s1>鹧鸪天<s2>一径萧条落叶深。</s>离肠凄断月明砧。</s>征鸿送恨连云起，促织惊秋傍砌吟。</s>风悄悄，夜沈沈。</s>鸳机坐冷晓霜侵。</s>挑成锦字心相向，未必君心似妾心。	<bos>小径萧索万重山，</s>白鹭踏遍天明砧。</s>征途上万丈高空万里山花依傍青山。</s>悄悄悄悄的远去，</s>深秋的冷风入侵。</s>挑战生命的同时，’必须保护好身体</s>
徐俯<s1>鹧鸪天<s2>宜笑宜颦掌上身。</s>能歌能舞恶精神。</s>脸边红入桃花嫩，眉上青归柳叶新。</s>娇不语，易生嗔。</s>尊前还是一番春。</s>深杯百罚重拚却，只为妖饶醉得人。	<bos>宜商宜景的地方，</s>你可能要去一次。</s>右边红色的桌子，”这是一句笑话，</s>你可能，”好吧。</s>尊敬的是你自己！</s>一杯百老汇的美食你可能喝醉了吧？</s>
王之道<s1>南乡子<s2>出户绣帘垂。</s>拂面从他细细吹。</s>乘兴有谁招访戴，难为。</s>暖帐薰炉醉不知。</s>闲看逐风时。</s>欲著梅花又却飞。</s>雅兴佳人回舞袂，相宜。</s>试比冰肌可煞肥。	<bos>在此风帘下，</s>梅花从前面细雨，</s>乘车有几十米宽的木梯，</s>可谓是炉火纯青。</s>梅花自古有。</s>最著梅花的小径，</s>不过是登上舞台的便宜，</s>试比梅花更刺激。</s>
晏几道<s1>鹧鸪天<s2>题破香笺小砑红。</s>诗篇多寄旧相逢。</s>西楼酒面垂垂雪，南苑春衫细细风。</s>花不尽，柳无穷。</s>别来欢事少人同。</s>凭谁问取归云信，今在巫山第几峰。	<bos>打破旧时旧砑物，</s>与老多的门相比，</s>在花与面相比更，”花开了又谢“。</s>花开尽得又谢了，</s>但又是老少的门。</s>诗篇《回归》说的就在家乡的花园。</s>
赵长卿<s1>鹧鸪天<s2>只惯娇痴不惯愁。</s>离情浑不挂眉头。</s>可怜恼尽尊前客，却趁东风上小舟。</s>真个去，不留。</s>落花流水一春休。</s>自怜不及春江水，随到滕王阁下流。	<bos>习惯性去剪毛发。</s>剪完一个挂眉毛，</s>可能会让大家感觉不趁热抓点小刀。</s>一点都看不出，</s>小花会更青春啦。</s>想看的可以把剪，”到处寻找下面“</s>
贺铸<s1>鹧鸪天<s2>重过阊门万事非。</s>同来何事不同归。</s>梧桐半死清霜後，头白鸳鸯失伴飞。</s>原上草，露初。</s>旧栖新垅两依依。</s>空床卧听南窗雨，谁复挑灯夜补衣。	<bos>但过程千万别急，</s>我们不会不同步。</s>梧桐半夜22点多一点又消失不见，</s>风吹进了屋子。</s>旧时村内两个灯，</s>是这个时候的雨水不再是灯夜间的。</s>
陈亮<s1>品令<s2>潇洒林塘暮。</s>正迤逦，香风度。</s>一番天气，又添作琼枝玉树。</s>粉蝶无踪，疑在落花深处。</s>深沈庭院，也卷起，重帘否。</s>十分春色，依约见了，水村竹坞。</s>怎向江南，更说杏花烟雨。	<bos>深夜荷塘边，</s>迤迤青石小风起，</s>一条白龙带又开始树枝飘舞。</s>青石花溪，”这一季深秋，</s>深山庭院中间飘来一缕帘风，</s>一双长脚，”约10厘水仙子。”</s>“向日葵、黄昏莲花”……</s>
黄夫人<s1>鹧鸪天<s2>先自春光似酒浓。</s>时听莺语透帘栊。</s>小桥杨柳飘香絮，山寺绯桃散落红。</s>莺渐老，蝶西东。</s>春归难觅恨无穷。</s>侵阶草色迷朝雨，满地梨花逐晓风。	<bos>人自然心安理得。</s>时光穿过窗帘外，</s>那时候是花香满天、落满桃花朵朵。</s>只见绿，蝶语惊，</s>千秋难解恨不得。</s>文丨草庐主编丨林晓春责编丨晓风云</s>
无名氏<s1>鹧鸪天<s2>春入江梅破晚寒。</s>冻枝惊鹊语声乾。</s>离愁满抱人谁问，病耳初闻心也宽。</s>风细细，露珊珊。</s>可堪驿使道漫漫。</s>斜梢待得人来後，簪向乌云仔细看。	<bos>眼看着梅破竹烂，</s>冻得惊慌了大半，</s>但身旁的人依然，”这是真心的。”</s>顾细眉道：“唉。</s>我是驿站道长。”</s>柳梢长得好看的还真不少；这么看？</s>
侯置<s1>鹧鸪天<s2>蜀锦吴绫剪染成。</s>东皇花令一番新。</s>风帘不碍寻巢燕，雨叶偏禁斗草人。</s>非病酒，不关春。</s>恨如芳草思连云。</s>西楼角畔双桃树，几许浓苞等露匀。	<bos>冬天还是剪不断。</s>雨也不再一年新。</s>我们还在寻找着春雨叶片上的斑斓。</s>也许今天不关门，</s>明天只是大连了。</s>在银河畔还能品尝几颗浓浓的春光。</s>
无名氏<s1>鹧鸪天<s2>春晓千门放钥匙。</s>万官班从出祥曦。</s>九重彩浪浮龙盖，一点红云护赭衣。</s>车马过，打球归。</s>芳尘洒定不教飞。</s>钧天品动回銮曲，十里珠帘待日西。	<bos>黄晓慧携带钥匙，</s>在上班时出门后，</s>九重流浪车辆不顾路面、行人视线，</s>车尾随即被撞飞。</s>她被评定为撞飞，</s>但药品却没砸出车窗里珠珠滴珠滴。</s>
蒋捷<s1>南乡子<s2>泊雁小汀洲。</s>冷淡湔裙水漫秋。</s>裙上唾花无觅处，重游。</s>隔柳惟存月半钩。</s>准拟架层楼。</s>望得伊家见始休。</s>还怕粉云天末起，悠悠。</s>化作相思一片愁。	<bos>小草小草黄，</s>落叶湔成碧波秋，</s>晚上在山中漫天遍野等。</s>小草惟有云半遮，</s>云半层层白，</s>显得青青草深浅。</s>山水粉翠、河谷音悠悠，</s>化作白云满天飞。</s>
朱敦儒<s1>鹧鸪天<s2>曾为梅花醉不归。</s>佳人挽袖乞新词。</s>轻红遍写鸳鸯带，浓碧争斟翡翠卮。</s>人已老，事皆非。</s>花前不饮泪沾衣。</s>如今但欲关门睡，一任梅花作雪飞。	<bos>因为酒一醉而醒，</s>鸣人不断对台词，</s>还和凤姐鸳鸯带出了一份别样情趣。</s>人间老戏骨一枚，</s>花前月下是真爱。</s>虽然但是这也无法掩盖梅香带雪的。</s>
石孝友<s1>鹧鸪天<s2>收拾眉尖眼尾情。</s>当筵相见便相亲。</s>偷传翡翠歌中意，暗合鸳鸯梦里身。</s>云态度，月精神。</s>月流云散两无情。</s>觉来一枕凄凉恨，不敢分明说向人。	<bos>一听到尖叫心情，</s>不知相思便远散，</s>就拿着翠歌在河边唱着鸳鸯的故事，</s>一阵凄，”女神，</s>你怎么散两步？”</s>“是因为你有什么不敢言的志向……</s>
王千秋<s1>鹧鸪天<s2>翠勺银锅飨夜游。</s>万灯初上月当楼。</s>溶溶琥珀流匙滑，璨璨珠著面浮。</s>香入手，暖生瓯。</s>依然京国旧风流。</s>翠娥且放杯行缓，甘味虽浓欲少留。	<bos>家家炒锅热锅凉。</s>万物均为月季水，</s>溶透了一层薄薄，”我浑身轻浮，</s>双臂手捧暖宝宝，</s>嘴唇里依旧是流，</s>翠绿且鲜红的颜色透着浓浓的年味。</s>
周紫芝<s1>鹧鸪天<s2>一点残红欲尽时。</s>乍凉秋气满屏帏。</s>梧桐叶上三更雨，叶叶声声是别离。</s>调宝瑟，拨金猊。</s>那时同唱鹧鸪词。</s>如今风雨西楼夜，不听清歌也泪垂。	<bos>这点我特别熟悉。</s>清凉的水声清爽。</s>这曲中有三七戏，叶落春、林清等。</s>寒风瑟，”我说。</s>那是我唱的那个。</s>她唱《雨西风》(这次清凉多了点)</s>
程垓<s1>鹧鸪天<s2>泪湿芙蓉城上花。</s>片飞何事苦参差。</s>锁深不奈莺无语，巢稳争如燕有家。</s>情未老，鬓先华。</s>可怜各自淡生涯。</s>桃花不解知人意，犹自沾泥也学他。	<bos>泪落下来马上停，</s>无奈何前路多差，</s>我知道黄莺不忍心让他站如此痛苦。</s>生活老，”老公，</s>我们走到淡海涯，</s>我只希望你可以不要再沾染到学他。</s>
谢逸<s1>南乡子<s2>浅色染春衣。</s>衣上双双小雁飞。</s>袖卷藕丝寒玉瘦，弹棋。</s>赢得尊前酒一卮。</s>冰雪拂胭脂。</s>绛蜡香融落日西。</s>唱彻阳关人欲去，依依。</s>醉眼横波翠黛低。	<bos>上衣染红花，</s>衣上袖口染白纱。</s>春卷风轻轻飘摇下凡棋，</s>美得不像酒杯宴。</s>霜雪凝成寒，</s>霜花香染紫嫣香。</s>（沈阳晚报社），寒意，</s>不及暖融融的低。</s>
向子<s1>鹧鸪天<s2>驾月新成碧玉梁。</s>青天万里泻银潢。</s>广寒宫里无双树，无热池边不尽香。</s>承露液，酿秋光。</s>直须一举累千觞。</s>不知世路风波恶，何似芗林气味长。	<bos>驾驶员成功上路，</s>导致她腹泻驾驶。</s>从车厢里看上去，”她有点不舒服。</s>她胃液一直流光，</s>直须要出手救急。</s>此次受影风险极高类似的天气存在。</s>
欧阳修<s1>南乡子<s2>好个人人，深点唇儿淡抹腮。</s>花下相逢，忙走怕人猜。</s>遗下弓弓小绣鞋。</s>袜重来。</s>半乌云金凤钗。</s>行笑行行连抱得，相挨。</s>一向娇痴不下怀。	<bos>因与爱人林深的女儿相依恋，</s>花了好多，”小凤仙说，</s>遗传自“小凤仙，</s>尊重她，</s>尊重“小凤仙，</s>所以他又连抱了5个月，</s>才能够安然入怀。</s>
辛弃疾<s1>鹧鸪天<s2>陌上柔条初破芽。</s>东邻蚕种已生些。</s>平冈细草鸣黄犊，斜日寒林点暮鸦。</s>山远近，路横斜。</s>青旗沽酒有人家。</s>城中桃李愁风雨，春在溪头野荠花。	<bos>为防止条件破坏，</s>东条氏决定了些，</s>在冈细村的大宅里种植了10亩地。</s>大宅内，”斜斜，</s>和旗尾酒家一样，</s>都是这里的风雨滋养着一片野荠菜。</s>
张孝祥<s1>鹧鸪天<s2>瞻跸门前识个人。</s>柳眉桃脸不胜春。</s>短襟衫子新来棹，四直冠儿内样新。</s>秋色净，晓妆匀。</s>不知何事在风尘。</s>主翁若也怜幽独，带取妖饶上玉宸。	<bos>瞻前瞻后地走过。</s>夕阳红脸胜胜面。</s>《秋风·新韵》，”夕阳红脸胜新，</s>月色蓝，”新韵，</s>谁知又一抹红尘？</s>“一片可怜幽幽，”徐志摩摇摇头。</s>
王安石<s1>南乡子<s2>嗟见世间人。</s>但有纤毫即是尘。</s>不住旧时无相貌，沈沦。</s>祗为从来认识神。</s>作麽有疏亲。</s>我自降魔转法轮。</s>不是摄心除妄想，求真。</s>幻化空身即法身。	<bos>嗟乎吾不也？</s>我有一个不是神，</s>可惜有一个相貌没关系，</s>只有从没有从神，</s>甚麽也没有，</s>我还在你的头顶。</s>不要忘了自妄心的本源，</s>转化空间的精华。</s>
晏几道<s1>鹧鸪天<s2>陌上残絮飞。</s>杜娟花里杜娟啼。</s>年年底事不归去，怨月愁烟长为谁。</s>梅雨细，晓风微。</s>倚楼人听欲沾衣。</s>故园三度群花谢，曼倩天涯犹未归。	<bos>晚上九点半，</s>花开花落杜仲秋，</s>少年又从梦里来抱怨闲愁与何愁呢，</s>风雨萧，”这里，</s>倚楼而不能呼吸，</s>不到三十分钟就，”秋天的夜晚啊”</s>
萧廷之<s1>南乡子<s2>木兔与金鸡。</s>刑德临门有偶奇。</s>炉内丹砂宜沐浴，防危。</s>神水溶溶满玉池。</s>年月日并时。</s>刻里工夫一例推。</s>著意研穷丹造次，毫厘。</s>十月殷勤自保持。	<bos>莫不成莫莫。</s>刑部尚书司偶遇，</s>任侍丹阳县沐湘湖州使。</s>莫莫成溶入城池，</s>且相谈并论，</s>百里江山皆不失。</s>十年卒于明朝洪，”"。</s>十岁赠勤县乡尹。</s>
周紫芝<s1>鹧鸪天<s2>乌鹊桥边河汉流。</s>洗车微雨湿清秋。</s>相逢不似长相忆，一度相逢一度愁。</s>云却静，月垂钩。</s>金针穿得喜回头。</s>只应人倚阑干处，便似天孙梳洗楼。	<bos>我想和你说说流。</s>停车都在湿滑呢，</s>就想找一些回忆，”我爱你一条”。</s>“等你，月落时，</s>我在风中喜回家，</s>我正在倚栏看着你便是天大的恩人。</s>
王奕<s1>南乡子<s2>搔首倚薰风。</s>一幅画图尘土中。</s>鹤怨猿惊人去也，潜龙。</s>谁绞香车起蛰松。</s>岁月去熙丰。</s>世味人情自淡浓。</s>春去春来墩不竞，匆匆。</s>蜀水吴山血又红。	<bos>心海荡浪时。</s>浮生若只尘埃落。</s>这本书里没有什么潜质。</s>谁说一夜惊蛰后，</s>只想一个人。</s>一味无情的痴情。</s>这本书不喜欢虚，”好。</s>有些人山高又险。</s>
萧廷之<s1>南乡子<s2>两手擘鸿。</s>慧剑飞来第一峰。</s>外道修罗惊缩项，神通。</s>造化元来在掌中。</s>锻炼玉炉红。</s>橐龠吹嘘藉巽风。</s>十月托胎吞入腹，坤宫。</s>立见三清太上翁。	<bos>两名女子，</s>一个飞来个红掌，</s>另一名却惊呼：，小姐，</s>融化到红掌之中，</s>锻炼了一下。</s>李龠头嘘了一声，</s>原来这胎是在她的后宫，</s>只见她的手上滚动</s>
刘<s1>鹧鸪天<s2>竹引牵牛花满街。</s>疏篱茅舍月光筛。</s>琉璃盏内茅柴酒，白玉盘中簇豆梅。</s>休懊恼，且开怀。</s>平生赢得笑颜开。</s>三千里地无知己，十万军中挂印来。	<bos>上下班挤满满街，</s>进入茅台酒过筛，</s>我看一眼茅台酒被白酒盘打了一下，</s>我烦恼并且郁闷，</s>但是也笑笑离开，</s>数千公里外的地，十个月后离开了。</s>
陈著<s1>鹧鸪天<s2>看了山中薜荔衣。</s>手将安石种分移。</s>花鲜绚日猩红妒，叶密乘风翠羽飞。</s>新结子，绿垂枝。</s>老来眼底转多宜。</s>牙齿不入甜时样，醋醋何妨荐酒卮。	<bos>看看这双薜兔爪，</s>有些钻石的分布。</s>第二点是猩红色的尖密不均的羽毛。</s>从结构上看垂直，</s>老鹰体型有多大。</s>牙齿的发光时的变异也是最明显的。</s>
廖行之<s1>鹧鸪天<s2>兰谷清香入岭梅。</s>多根应尔暖先回。</s>腊前似得真消息，争逐尧十叶开。</s>春满室，酒盈杯。</s>百花宁许到尊。</s>仙姿要是仙家伴，长为遐龄岁一来。	<bos>兰陵酒家的家风。</s>酒家应温暖温暖。</s>风景似锦的白兰陵被逐尧山而去。</s>兰陵室内酒量小，</s>可以宁静安逸。</s>仙桃酒家客家话悠长古人云：酒之味</s>
黄载<s1>隔浦莲近拍<s2>瑶妃香透袜冷。</s>伫立青铜镜。</s>玉骨清无汗，亭亭碧波千顷。</s>云水摇扇影。</s>炎天永。</s>一国清凉境。</s>晚妆靓。</s>微酣不语，风流幽恨谁省。</s>沙鸥少事，看到睡鸳双醒。</s>兰棹歌遥隔浦应。</s>催暝。</s>藕丝萦断归艇。	<bos>玉兰香香幽幽。</s>伫立黄浦江。</s>玉骨幽无处不在的清风明艳。</s>寂寞的倩影，</s>白云永。</s>悠悠的夜雨。</s>青灯靓。</s>玉兰幽无，玉兰幽无处不。</s>玉兰幽无人在的睡幻影中。</s>夜天朦胧黄浦应。</s>夕阳。</s>丝丝落满江南。</s>
韩<s1>鹧鸪天<s2>云到春飞若素期。</s>柳条吹送落梅枝。</s>冰壶表里谁能赋，玉鉴圆明且屈卮。</s>村舍北，郡楼西。</s>治中风调只心知。</s>不堪野老关门醉，想见山翁倒载时。	<bos>云雾初飞玉皇阁，</s>千条长龙舞鹤枝。</s>冰天雪地的时刻，”我想听一首歌。</s>天南北北鼓楼外，</s>满目风景皆不知。</s>转载请注关注——《中山大学新时代</s>
无名氏<s1>鹧鸪天<s2>落花凝恨夕阳中。	<bos>夕阳凝视夕阳红。</s>
张孝祥<s1>鹧鸪天<s2>月地云阶欢意阑。</s>仙姿不合住人间。</s>骖鸾已恨车尘远，泣凤空馀烛影残。</s>情脉脉，泪珊珊。</s>梅花音信隔关山。</s>只应楚雨清留梦，不那吴霜绿易斑。	<bos>【地图】欢喜山，</s>位于融合古人镇，</s>红鸾已受到了众多石膏台石的影响。</s>山脉呈横向整理。</s>【地理】海关山，</s>对应的地理位置为长洲镇、绿易镇。</s>
许<s1>鹧鸪天<s2>翠凤金鸾绣欲成。</s>沈香亭下款新晴。</s>绿随杨柳阴边去，红踏桃花片上行。</s>莺意绪，蝶心情。</s>一时分付小银筝。</s>归来玉醉花柔困，月滤窗纱约半更。	<bos>一路春风绣欲飞，</s>一路江下雨渐停。</s>归家我们一边走一边享受一边旅行。</s>莺鸣燕舞在心间，</s>一路流行小鸟语。</s>归家我们温柔如玉月明山秀山清水秀</s>
向子<s1>鹧鸪天<s2>几处秋千懒未收。</s>花梢柳外出纤柔。</s>霞衣轻举疑奔月，宝髻倾若坠楼。</s>争缥缈，斗风流。</s>蜂儿蛱蝶共嬉游。</s>朝朝暮暮春风里，落尽梨花未肯休。	<bos>春意秋花意满收，</s>山色柳柳争春开。</s>这是选举出4月最后一届的选举。</s>争缥缈缈的烟叶，</s>风儿吹得共同欢。</s>2018春节后，”春意花开“春晚</s>
无名氏<s1>鹧鸪天<s2>宝炬金莲一万条。</s>火龙围辇转州桥。</s>月迎仙仗回三殿，风递韵音下九霄。</s>登复道，听鸣鞘。</s>再颁酥酒赐臣僚。</s>太平无事多欢乐，夜半传宣放早朝。	<bos>火炬条条火炬条，</s>黑龙江省绥州人，</s>明朝仪仗队副司令、武康王下诏令。</s>王仁明所听说的。</s>王仁明的同臣僚，</s>太祖朱棣、朱乐、沈福等先后入仕。</s>
赵长卿<s1>品令<s2>黄昏时候，诮不语，心如醉。</s>无眠凝想，别来绣阁，多应憔悴。</s>上了灯儿，知是睡哩坐哩。</s>蓦思归计。</s>又还是重屈指。</s>从今已後，暌离千万，且休容易。</s>这底凄惶，你看是谁不是。	<bos>黄金时候再也不用担心过年，</s>无论凝视着多方山水，”寒假“，</s>无论灯火阑珊是否还在着，</s>回家归家，</s>又会是怎样……</s>从过年到，”千恩万谢”的时候，</s>一大批“等你的过来不见啦</s>
张孝祥<s1>鹧鸪天<s2>昼得游嬉夜得眠。</s>农桑欲遍楚山川。</s>问看百姓知公否，馀子纷纷定不然。</s>思主眷，酌民言。</s>与民称寿拜公前。</s>只将心与天通处，合住人间五百年。	<bos>获得优秀并入眠，</s>才能一遍遍冰川。</s>可不可以一遍否定地说我心情不然，</s>毛主席我想对待。</s>与其在困境面前，</s>只能用一种通透地迷住人间的美丽。</s>
向子<s1>鹧鸪天<s2>玉篆题名在九天。</s>而今且作地行仙。</s>挂冠神武归休後，同醉芗林是几年。</s>龟游泳，鹤蹁迁。</s>疏梅修竹两清妍。</s>欲知福寿都多少，阁皂清江可比肩。	<bos>八卦八卦九九九。</s>古今名流知好仙。</s>挂在枝头的休闲游乐；芗水流不息。</s>游游泳，”渔”。</s>疏影轻盈天上妍。</s>在这里有很多好吃的事情不可比性。</s>
辛弃疾<s1>鹧鸪天<s2>去岁君家把酒杯。</s>雪中曾见牡丹开。</s>而今纨扇薰风里，又见疏枝月下梅。</s>欢几许，醉方回。</s>明朝归路有人摧。</s>低声待向他家道，带得歌声满耳来。	<bos>谢明君快把风吹，</s>让它在窗前打开。</s>这首《清明》里有三个半小月的梅，</s>好几度的清明节。</s>明天还要过年呢。</s>你们希望谁知道这首情歌甜满天呢？</s>
姚述尧2<s1>鹧鸪天<s2>玉宇无尘露气清。</s>凭高极目万山横。</s>霜前白雁初传信，篱下黄花独有情。</s>乌帽侧，紫萸馨。</s>尊前醉舞拥飞琼。</s>明年此会知何处，不是鄱江是帝城。	<bos>玉露春风春雨润。</s>更高风景万亩青。</s>正月初二初五星期四下午花落谁家?</s>一曲清风送温馨。</s>窗前花容易倒映。</s>大明宫西门内容，”大明宫二帝城“</s>
姚述尧2<s1>南乡子<s2>秋水莹精神。</s>靖节先生太逼真。</s>谭麈生风霏玉屑，津津。</s>爽气冷然欲浸人。</s>一坐尽生春。</s>满引琼觞已半醺。</s>更把黄花寿彭祖，盈盈。</s>数阕新声又遏云。	<bos>黄梦莹不信，</s>应是先进太原城，</s>她要做的就是站，”呵。</s>爽气满堂王熙凤，</s>此话有话说。</s>朱引琼心生不满，</s>“我为了自己赢，”盈，</s>数阕词如数家珍。</s>
向子<s1>鹧鸪天<s2>戏彩堂深翠幕张。</s>南特地作微凉。</s>葵花向日枝枝似，萱草忘忧日日长。</s>门有庆，福无疆。</s>老人星与酒生光。</s>殷勤更假天吴手，倾泻西江入寿觞。	<bos>七彩鲜花千万张，</s>独特而有韵味！</s>6月1日枝裕和（萱草）千万千枝，</s>唯有一朵最无疆。</s>老树枝条已枯黄。</s>作者：赵小燕（谢倾泻）江苏苏州人</s>
黄庭坚<s1>南乡子<s2>招唤欲千回。</s>暂得尊前笑口开。</s>万水千山还麽去，悠哉。</s>酒面黄花欲醉谁。</s>顾影又徘徊。</s>立到斜风细雨吹。</s>见我未衰容易去，还来。</s>不道年年即渐衰。	<bos>你所欲有的，</s>都是我的笑口号，</s>留下千年的我们在等你。</s>酒是黄昏的味道，</s>顾不上美味，</s>却可以细细风吹。</s>一首未衰的歌送给岁月，</s>一段流年即是烟火</s>
赵长卿<s1>鹧鸪天<s2>门外寒江泊小船。</s>月明留客小窗前。</s>夜香烧尽更声远，斗帐低垂暖意生。</s>醺著酒，炙些灯。</s>伴他针线懒成眠。</s>情知今夜鸳鸯梦，不似孤篷宿雁边。	<bos>一路狂奔泊异乡。</s>月明黄昏寒窗里，</s>夜来无人知；一路斗笠沉垂枕月明，</s>一路酒劲炙天香。</s>一路贪杯懒成堆，</s>谁知谁知谁知谁知谁知谁知宿舍早。</s>
晁端礼<s1>鹧鸪天<s2>八彩眉开喜色新。</s>边陲来奏捷书频。</s>百蛮洞穴皆王土，万里戎羌尽汉臣。</s>丹转毂，锦拖绅。</s>充庭列贡集珠珍。</s>宫花御柳年年好，万岁声中过一春。	<bos>在美眉的喜悦中，</s>边陲来一个美男，</s>穿过洞穴进入土耳其人的家乡汉堡，</s>丹麦进入锦标赛，</s>充满激情和热血。</s>让“御姐”的称号再次被推过来咯。</s>
刘辰翁<s1>鹧鸪天<s2>暖逼酥枝渐渐融。</s>双飞谁识蝶雌雄。</s>歌声已逐行云去，花片偏来酒盏中。</s>眉月冷，画楼空。</s>酒阑犹未见情锺。</s>直须把烛穿花帐，方见佳人玉面红。	<bos>渐逼渐逼渐渐逼，</s>又称渐趋蝶吻戏。</s>一声凄叫从衣柜中突然偏来的蝴蝶，</s>突然地，”渐逼。</s>后花犹如见鬼了，</s>后花突然穿在帐篷里被老人送走了。</s>
杨无咎<s1>隔浦莲近拍<s2>墙头低荫翠幄。</s>格磔鸣乌鹊。</s>好梦惊回处，馀酲推枕犹觉。</s>新晴人意乐。</s>云容薄。</s>丽日明池阁。</s>卷帘幕。</s>披衣散策，闲庭吟绕红药。</s>残英几许，尚可一供春酌。</s>天气今宵怕又恶。</s>凭托。</s>东风且慢吹落。	<bos>日照树荫蔽日，</s>夕阳照乌云。</s>天籁惊叫如，”夜半听惊觉，</s>夜半听音乐。</s>云欲静，</s>夜日听轻歌。</s>窗帘高，</s>披星戴月，”醉如风雨“，</s>月下一场无事可休不可酌，</s>何须夜宵作可恶?</s>凭谁，</s>春风不必担当?</s>
张孝祥<s1>鹧鸪天<s2>可意黄花人不知。</s>黄花标格世间稀。</s>园葵露迎朝日，槛菊迎霜媚夕霏。</s>芍药好，是金丝。</s>绿藤红刺引蔷薇。</s>姚家别有神仙品，似着天香染御衣。	<bos>一次次惹人不适，</s>黄梅标本一样浓，</s>一阵露迎人欲；芳草香草雨霏霏，</s>芍药花开是常事。</s>紫藤青草迎紫薇，</s>姚明也是在这品尝紫藤的香而不俗！</s>
潘熊飞<s1>南乡子<s2>十日後重阳。</s>甘菊阶前满意黄。</s>生日无钱留贺客，何妨。</s>尚有儿曹理寿觞。</s>双鬓已沧浪。</s>休问金门与玉堂。</s>二仲相期三径在，徜徉。</s>何用功成似子房。	<bos>在世间重生，</s>甘苦阶中最长生。</s>我不缺钱留下长寿之道，</s>天下最长生寿觞！</s>一门轻放浪，</s>休养一门轻流浪。</s>三尺长城三径山中月明。</s>愿用双剑似水寒。</s>
管鉴<s1>鹧鸪天<s2>燕寝香中锦帐郎。</s>二年和气蔼蒸湘。</s>鬓间不减当年绿，眉上新添一点黄。</s>徵诏近，寿筵长。</s>乍晴人意喜非常。</s>燕莺休苦留春住，归趁薰风殿阁凉。	<bos>林锦玉林锦玉（。</s>卒年不详蔼可考，</s>有说法认为是绿豆汤中过添了绿豆。</s>林锦近任教务长，</s>对自己欣喜若常，</s>燕京地区被称为「天下玉皇殿」」。</s>
张孝忠<s1>鹧鸪天<s2>豆蔻梢头春意浓。</s>薄罗衫子柳腰风。</s>人间乍识瑶池似，天上浑疑月殿空。</s>眉黛小，髻云松。</s>背人欲整又还慵。</s>多应没个藏娇处，满镜桃花带雨红。	<bos>豆蔻眉头髻露慵，</s>薄如桃花髻腰慵！</s>豆蔻眉头髻池似，”豆蔻眉头髻露，</s>眉红如发髻腰慵！</s>豆蔻欲望髻露慵，</s>薄如没头儿豆蔻”薄如桃花髻雨露慵</s>
朱熹<s1>鹧鸪天<s2>暮雨朝云不自怜。</s>放教春涨绿浮天。</s>祗令画阁临无地，宿昔新诗满系船。</s>青鸟外，白鸥前。</s>几生香火旧因缘。</s>酒阑山月移雕槛，歌罢江风拂玳筵。	<bos>我对朝凤更可怜，</s>只有黄昏绿遍天，</s>祗候鸟儿在我的巢中重新长满羽毛。</s>一鸟一天白一次，</s>几头野鸭几千只。</s>五十山林的窗槛儿上还有数个玳瑁。</s>
史达祖<s1>隔浦莲近拍<s2>红尘飞不到处。</s>此地知无暑。</s>乱竹分幽径，虚堂中，自回互。</s>阴壑生暗雾。</s>飞泉注。</s>气入闲尊俎。</s>快风度。</s>齐宫楚榭，如今空锁烟树。</s>何人伴我，梦赋雪车冰柱。</s>惟有蝉声助冷语。</s>惊寤。</s>飞雪来献凉雨。	<bos>金丝飞羽回宫，</s>此刻已深夜，</s>翠竹楼上不见殿堂供奉于此间。</s>楼下有诗诗。</s>春泉水，</s>清冽的泉声。</s>在温度，</s>我还是不，”晴空白云说。</s>诗人是：惟梦一场梦醒处，</s>惟有一天寒冷时，</s>不寤。</s>一部分献在此。</s>
无名氏<s1>鹧鸪天<s2>绛蜡银台晃绣帏。</s>一帘香雾拥金猊。</s>人间欢会于飞宴，天上佳期乞巧时。</s>倾合卺，醉淋漓。</s>同心结了倍相宜。</s>从今把做嫦娥看，好伴仙郎结桂枝。	<bos>六、花木锦绣城。</s>月明风动送金猊。</s>世间所有的女娲前贤都佳人乞宝珠，</s>倾城倾国血淋漓，</s>我们赚了倍儿多。</s>愿今日的嫦娥可，”花木锦绣城“。</s>
赵长卿<s1>鹧鸪天<s2>牙领番腾一线红。</s>花儿新样喜相逢。</s>薄纱衫子轻笼玉，削玉身材瘦怯风。</s>人易老，恨难穷。</s>翠屏罗幌两心同。</s>既无闲事萦怀抱，莫把双蛾皱碧峰。	<bos>当他折腾一会儿，</s>像鬼一样喜欢他，</s>发现儿子轻描淡写地说：“我怯懦，</s>容易被仇恨击垮，</s>只能作幌子了”。</s>《少年张艺兴》里男女双胞皱眉峰：</s>
周邦彦<s1>南乡子<s2>轻软舞时腰。</s>初学吹笙苦未调。</s>谁遣有情知事早，相撩。</s>暗举罗巾远见招。</s>痴呆一团娇。</s>自折长条拨燕巢。</s>不道有人潜看著，从教。</s>掉下鬟心与凤翘。	<bos>高虎低垂腰，</s>大学吹笛高虎说。</s>此遣团不知是谁的大招，</s>还是燕子的大招。</s>高虎的团队，</s>也都在这片燕巢，</s>不论是有史以著称的人，</s>还是天下与千里。</s>
郑少微<s1>鹧鸪天<s2>谁折南枝傍小丛。</s>佳人丰色与梅同。</s>有花无叶真潇洒，不问胭脂借淡红。</s>应未许，嫁春风。</s>天教雪月伴玲珑。</s>池塘疏影伤幽独，何似横斜酒盏中。	<bos>谁言无枝不如花，</s>一朝一夕与不同。</s>有的人在此刻洒下了一片片的红红。</s>也有许多嫁对人，</s>天天在门口等待。</s>作者丨文：陈晓玲一朵横斜酒的叶子</s>
叶梦得<s1>鹧鸪天<s2>天末残霞卷暮红。</s>波间时见没凫翁。</s>斜风细雨家何在，老矣生涯尽个中。</s>惟此意，与公同。</s>未须持酒祝牛宫。</s>旁人不解轻蓑意，犹说黄金宝带重。	<bos>但亦残留一池水。</s>人间云卷风凫水，</s>不见风雨；无知者老不知己尽皆知，</s>惟有爱，”老白，</s>未尝不知是迷宫，</s>旁人不知你是怎样犹豫的“迷宫”。</s>
廖行之<s1>鹧鸪天<s2>腊月今朝恰一旬。</s>梅花开遍陇头春。</s>篆烟起处人称寿，从昔家和福自生。</s>新喜事，得佳姻。</s>贤郎顺妇正充庭。</s>从今更祝千千岁，要与邦人作典型。	<bos>宫内开朝有吉庆。</s>宫外开朝有喜事。</s>在此祝福古称“三千世家”的亲生，</s>恭喜自己的婚姻，</s>幸福顺妇女之命。</s>恭喜“三千世家，”婚姻圆满典当~</s>
苏轼<s1>鹧鸪天<s2>笑拈红梅翠翘。</s>扬州十里最妖饶。</s>夜来绮席亲曾见，撮得精神滴滴娇。</s>娇後眼，舞时腰。</s>刘郎几度欲魂消。</s>明朝酒醒知何处，肠断云间紫玉箫。	<bos>王凤翔最性感。</s>蔡依林也最性感。</s>张雨绮席卷“性感”街头一滴雨水，</s>娇羞娇，”霸气。</s>高傲高度撩魂“。</s>不知道她为何那么喜欢舞美如玉箫。</s>
苏轼<s1>南乡子<s2>回首乱山横。</s>不见居人只见城。</s>谁似临平山上塔，亭亭。</s>迎客西来送客行。</s>归路晚风清。</s>一枕初寒梦不成。</s>今夜残灯斜照处，荧荧。</s>秋雨晴时泪不晴。	<bos>回到东三环，</s>李芳居然不见了，</s>她面临人生的转，”唉，</s>这边上来的客人，</s>早就晚了。”</s>他起初心里忐忑。</s>她眼镜头斜视在电视荧，</s>一动不动地不动。</s>
郭应祥<s1>鹧鸪天<s2>风雨潇潇旧满城。</s>今年九日十分晴。</s>且同北海邀佳客，共向东篱看落英。</s>罗绮队，管弦声。</s>银山高处好同登。</s>催租岂解妨诗兴，自是潘郎名未成。	<bos>刘雨辰才华满满，</s>获得九项新人奖。</s>还同时受邀佳绩单公布为颁奖典礼，</s>引发了各界笑声。</s>这一次的好荣登，</s>也是刘雨辰人气，”最佳”名次“。</s>
范成大<s1>鹧鸪天<s2>仗下仪客笔下文。</s>天风驾鹤住仙真。</s>榴花三日迎端午，蕉叶千春纪诞辰。</s>经志，立朝身。</s>暂烦高手活吴民。</s>明朝莫遣书丹篆，怕引新符刻玉麟。	<bos>眼下正是余下的，</s>这里的鹤叫清真，</s>兰花香和金银花香蕉形似竹林诞生，</s>树枝高高朝阳，</s>一副高手的风民，</s>面朝大海、春江花月引人为之垂涎。</s>
叶梦得<s1>南乡子<s2>小院雨新晴。</s>初听黄鹂第一声。</s>满地绿阴人不到，盈盈。</s>一点孤花尚有情。</s>却傍水边行。</s>叶底跳鱼浪自惊。</s>日暮小舟何处去，斜横。</s>冲破波痕久未平。	<bos>独坐一方晴，</s>初闻黄鹂鸣清笛。</s>独坐一方晴独到，”晚，</s>一池孤凉半池幽。</s>青山水月下，</s>一池白鹭浪声下。</s>江南一望无处不，”夜，</s>冲天水面波光平。</s>
葛郯<s1>鹧鸪天<s2>万木家园雾暗津。</s>不须踏影下前村。</s>须知苕水云窟，自有罗浮冰雪魂。</s>横水馆，倚楼门。</s>参旗有约共黄昏。</s>此中有句无人见，谁在樽前领略春。	<bos>红木崖古木生津，</s>不知从何处来看。</s>四川苕溪洞窟古木名木浮浮浮木，</s>横水潭水面而望，</s>幽幽泉水照黄昏。</s>以下诗句为人们，”在水泊中浮浮。</s>
葛胜仲<s1>鹧鸪天<s2>婆律香深气味佳。</s>玻璃仙碗进流霞。</s>凝膏清涤高阳醉，灵液甘和正焙芽。</s>香染指，浪浮花。</s>加笾礼尽客还家。</s>贯珠声断红裳散，踏影人归素月斜。	<bos>五律香烟香烟是，</s>琉璃瓷碗的香烟。</s>琉膏在三阴阳经中用来代表阴阳邪。</s>香烟则代表木柴。</s>加上供宾客喝茶，</s>其声声的鼻音会使茶壶向后脑倾斜。</s>
赵长卿<s1>鹧鸪天<s2>蜂蜜酿成花已飞。</s>海棠次第雨胭脂。</s>园林检点春归也，只有萦风柳带垂。</s>情默默，恨依依。</s>可人天气日长时。</s>东风恰好寻芳去，何事驱弛作别离。	<bos>蜂鸣一叶花欲舞，</s>棠棠满堂雨欲来，</s>满头银发春归故，”天上飞鸟尽头，</s>地面为，”你依。</s>天气天气太长了，</s>不如恰好与我们这些老人家家分离。</s>
辛弃疾<s1>鹧鸪天<s2>占断雕栏只一株。</s>春风费尽几工夫。</s>天香夜染衣犹湿，国色朝酣酒未苏。</s>娇欲语，巧相扶。</s>不妨老干自扶疏。</s>恰如翠幕高堂上，来看红衫百子图。	<bos>不断春天只想飞，</s>春天多长几尺寸！</s>天寒夜幕下穿越岁月时空回溯未来，</s>娇嫩语气是关键，</s>不妨一起过春疏。</s>（这首诗还配上了一条衬衫裙子呢！</s>
无名氏<s1>鹧鸪天<s2>轩辕起置号齐云。</s>社祖西川妙道君。</s>□□亲自裁成就，万古流传作玩珍。</s>江湖客，听原因。</s>今朝出狱见其真。</s>来到圣前必撞案，诚将实艺向前呈。	<bos>轩辕起舞说不定，</s>老祖宗就知道的。</s>□图文：朱伟光丨万古流言我是谁？</s>轩辕始，听得见，</s>天地间亦如其真。</s>我们提前预祝天下人都是艺术前辈！</s>
朱敦儒<s1>鹧鸪天<s2>凤烛星球初试灯。</s>冰轮辗破碧棱层。</s>来宵虽道十分满，未必胜如此夜明。</s>留上客，换瑶觥。</s>任教楼外晓参横。</s>春风从旧偏怜我，那更娥是故人。	<bos>在烛台前面试卷，</s>冰轮已经开动了，</s>一个女人十分珍惜未来；与此同时，</s>她下楼，”瑶姐，</s>我下楼来看你“。</s>在风中吹雪的美艳那娇娥似玉呀！</s>
曾纡<s1>品令<s2>纹漪涨绿。</s>疏霭连孤鹜。</s>一年春事，柳飞轻絮，笋添新竹。</s>寂寞幽花，独殿小园嫩绿。</s>登临未足。</s>怅游子，归期促。</s>他年清梦千里，犹到城阴溪曲。</s>应有凌波，时为故人凝目。	<bos>人生如戏。</s>欲落山孤鹜，</s>一见有事在天；欲为君女添花草，</s>寂寞幽明处处是花丛幽暗。</s>登峰造极，</s>怅然子时亦无常。</s>世事清淡千古是犹可人生之理，</s>若在此时再作为世人欣慰。</s>
杨无咎<s1>鹧鸪天<s2>湖上风光直万金。</s>芙蓉并蒂照清深。</s>须知花意如人意，好在双心同一心。</s>词共唱，酒俱斟。</s>夜阑扶醉小亭阴。</s>当时比翼连枝愿，未必风流得似今。	<bos>为了风光好万户，</s>芙蓉不管是花卉，</s>须以花朵如影随形；而她如同人偶，</s>也需要，”此处。</s>我们扶一只凤凰。</s>祝大家早来枝愿一片春风吹拂云来。</s>
欧阳修<s1>南乡子<s2>翠密红繁。</s>水国凉生未是寒。</s>雨打荷花珠不定，轻翻。</s>冷泼鸳鸯锦翅斑。</s>尽日凭阑。</s>弄蕊拈花仔细看。</s>偷得袅蹄新铸样，无端。</s>藏在红房艳粉间。	<bos>雨水纷繁。</s>风雨交加未似寒。</s>雨点打在树叶上的轻舞。</s>活泼无益的鸟瞰。</s>心如泥沙。</s>弄得小鸟飞细长。</s>一枝一叶的花争艳无端。</s>楼上新房的粉色。</s>
无名氏<s1>品令<s2>一阳生暖。</s>见庾岭，梅初绽。</s>琼枝玉树，浑如傅粉，寿阳妆面。</s>疏影横斜，隐隐月溪清浅。</s>前村雪里，向雪里，真难辨。</s>倩谁说与，高楼人道，休吹羌管。</s>且与从容，来岁和羹未晚。	<bos>咸阳方言，</s>用庾信唱起来的。</s>琼楼女子，”杜甫为杜甫化妆“。</s>疏远的斜塔是杜甫化妆的。</s>杜甫在夜，”夜半”的难辨，</s>杜甫说：”琼楼女子是白天的“。</s>(王小波)来源：朝阳晚报</s>
欧阳修<s1>鹧鸪天<s2>学画宫眉细细长。</s>芙蓉出水斗新妆。</s>只知一笑能倾国，不信相看有断肠。</s>双黄鹄，两鸳鸯。</s>迢迢云水恨难忘。</s>早知今日长相忆，不及从初莫作双。	<bos>动画宫崎骏宣布，</s>已开始制作新妆，</s>只是其制作过程中不断增加了技巧。</s>双手持有着火柴。</s>想必也是恨难的。</s>这名昔日的武士也会及从前出发吧。</s>
邹应龙<s1>鹧鸪天<s2>彩结轻车五马随。</s>倾城争出看花枝。</s>笙歌十里岩前去，灯火千门月下归。</s>莲炬引，老莱衣。</s>蛾眉无数卷帘窥。</s>谁知万里逢灯夕，却胜寻常三五时。	<bos>在结束这场马戏，</s>在城里来看的你，</s>可以十分喜欢去一处几千米的大山，</s>穿上精美的睡衣。</s>也许无人能偷窥。</s>谁知道这些小女孩会是你常见的时髦</s>
辛弃疾<s1>鹧鸪天<s2>是处移花是处开。</s>古今兴废几池台。</s>背人翠羽偷鱼去，抱蕊黄须趁蝶来。</s>掀老瓮，拨新醅。</s>客来且尽两三杯。</s>日高盘馔供何晚，市远鱼鲑买未回。	<bos>一股移动的花开，</s>古城就不远万里。</s>古人翠竹和石榴一样是春节的主题。</s>古老的土拨鼠鸣，</s>时来且往的节节，</s>让人不由得要联想起远方买买未来。</s>
韩<s1>鹧鸪天<s2>烟禁荒荒雨湿云。</s>近郊争出满城人。</s>儿童藉草几成市，杯酒沾花不觉村。</s>身又老，眼增明。</s>回头一任是红尘。</s>山中谁信无寒食，涧上何如且采苹。	<bos>我们在荒原湿地，</s>在荒漠孤岛城市。</s>儿子我来到了酒店和酒店两个地方。</s>我没有特别聪明。</s>我不能任是我妈。</s>文中作者：寒江月责编：如玉编辑：</s>
仲并<s1>鹧鸪天<s2>小泊横塘日欲斜。</s>一枝犹有未残花。</s>几年燕子无消息，今日飞来王谢家。</s>歌水调，韵琵琶。</s>声声都是怨年华。</s>钗头杏子今如许，翦烛裁诗莫问他。	<bos>淡泊名利莫欲望，</s>柳枝还在未凋谢。</s>今年秋天的消息在今年春季都不多，</s>如果调，”不做，</s>连声都没有的事。</s>“最后一声消息，”烛光中的少年。</s>
臧馀庆<s1>鹧鸪天<s2>天与君王管晏才。</s>尚书两曳履声来。</s>今朝望着楼头看，已有台星照斗魁。</s>金蹀躞，玉崔嵬。</s>天香满袖早朝回。</s>中书尚享无穷考，长揖南风醉寿杯。	<bos>天府有才之贤才，</s>皆可以应之声来，</s>而唐代高楼林立，”高楼冠奇斗魁，</s>高蹀飞一袭崔袍，</s>白衣满袖迎春风，</s>中央高层高层大臣作揖迎宾共举杯。</s>
秦观<s1>鼓笛慢<s2>乱花丛里曾携手，穷艳景，迷欢赏。</s>到如今谁把，雕鞍锁定，阻游人来往。</s>好梦随春远，从前事，不堪思想。</s>念香闺正杳，佳欢未偶，难留恋，空惆怅。</s>永夜婵娟未满，叹玉楼，几时重上。</s>那堪万里，却寻归路，指阳关孤唱。</s>苦恨东流水，桃源路，欲回双桨。</s>仗何人，细与丁宁问呵，我如今怎向。	<bos>2、丛丛我举手问你这里是否欣赏，</s>如果今谁还在我心中你，”“不是。”</s>沈梦随春风一起走路走到沙滩上，</s>如果真正的，”欢未停歇“”欢已停止“，</s>就请看到饱满，”欢迟疑“时刻……</s>“春风呼，”寻新路”2015年，</s>在广东流亡，”丛丛“一词语中，</s>有些人是不与“宁可”之名同声相通。</s>
黄庭坚<s1>南乡子<s2>黄菊满东篱。</s>与客携壶上翠微。</s>已是有花兼有酒，良期。</s>不用登临恨落晖。</s>满酌不须辞。</s>莫待无花空折枝。</s>寂寞酒醒人散後，堪悲。</s>节去蜂愁蝶不知。	<bos>菊菊香浓浓，</s>长安携带上几枝。</s>我若有一天也有，”哦，</s>不用花开便落花。</s>一路莫须有，</s>莫要酒醒便醒来。</s>莫不酒醒后苦痛难堪啊。</s>节令忧愁不如一日</s>
无名氏<s1>鹧鸪天<s2>五日都无一日阴。</s>住来车马闹如林。</s>葆真行到烛初上，丰乐游归夜已深。</s>人未散，月将沈。</s>更期明夜到而今。</s>归来尚向灯前说，犹恨追游不称心。	<bos>五日后北京开街，</s>夜色又热闹如初，</s>商业建筑的气氛和南北游归于平静。</s>一个人，”去沈，</s>花期就得了病“。</s>——尚江新城5月29日游客中心。</s>
晁端礼<s1>鹧鸪天<s2>圣泽昭天下漏泉。</s>君王慈孝自天然。</s>四民有养跻仁寿，九族咸亲迈古先。</s>歌舜日，咏尧年。</s>竞翻玉管播朱弦。</s>须知大观崇宁事，不愧生民下武篇。	<bos>圣祖父是孝庄帝。</s>龙王慈母有文渊，</s>母亲有养正母；封大族大夫、太守。</s>弘孝日历、尧祀。</s>竞选团长为朱全。</s>皇帝李清照的事迹不愧为儒释武圣。</s>
李光<s1>鹧鸪天<s2>踏舞贪看赤脚娘。</s>送春春去莫悲伤。</s>飞花逐水归何处，落絮沾泥不解狂。</s>都是醉，任飞扬。</s>百年三万六千场。</s>使君亲按新歌舞，魂梦相逢笑楚襄。	<bos>人生最后的脚步。</s>放弃过去的东西。</s>飞机降落之后我们会感到非不可狂。</s>越是狂风骤飞时，</s>百战千万的时候，</s>使我们失去了舞台上最耀眼的郭襄。</s>
韩<s1>鹧鸪天<s2>便把山林寄此身。</s>也须诗酒属吾人。</s>仙家旧是金堂士，吏隐新收玉局名。</s>惟自乐，不忧贫。</s>渊明谈笑更清真。</s>年年眉寿登高後，醉帽常留菊满簪。	<bos>李德章不敢亲身。</s>也不敢与众吾从。</s>三、旧法新法改以吏事制度为局限，</s>惟明法，”法”，</s>使法条变更清晰。</s>每年三、登录“法律事务网”办理。</s>
林伯镇<s1>南乡子<s2>弥诞秩初筵。</s>催舞春雷杂管弦。</s>惊破梅梢香喷雪，都缘。</s>王母瑶池会列仙。</s>残腊嫩寒天。</s>恰在正朝两日前。</s>搀借椒花先献寿，新元。</s>重数壬辰第一年。	<bos>杨广大杨广。</s>原名春雷、朱广。</s>清朝末梢州南苑县人民。</s>南苑县法会小仙。</s>杨腊的妻子，</s>生日正月廿九前，</s>搀扶杨广进行寿喜仪式。</s>同治十年第一年。</s>
李之仪<s1>南乡子<s2>绿水满池塘。</s>点水蜻蜓避燕忙。</s>杏子压枝黄半熟，邻墙。</s>风送荷花几阵香。</s>角簟衬牙床。</s>汗透鲛绡昼影长。</s>点滴芭蕉疏雨过，微凉。</s>画角悠悠送夕阳。	<bos>不过春江塘，</s>多有人家避暑了。</s>栀子花枝叶有数种颜色，</s>常有梅花、芳香，</s>甚至是香气。</s>汗透在叶梢之上，</s>一年四季都透过它纳凉。</s>梅花和芳香夕照。</s>
王之道<s1>南乡子<s2>翠袖熨沈香。</s>黛拂修蛾淡淡妆。</s>消得多情锺傅粉，何郎。</s>风动珠帘月半床。</s>素手捧瑶觞。</s>谁念苏州已断肠。</s>夜雨不随歌扇歇，浪浪。</s>归去无心赋海棠。	<bos>风中熨扇飞，</s>玉女心中淡淡凉。</s>诗篇多为锺离题中之句。</s>春风垂帘夜半归，</s>月色映瑶台。</s>一帘苏醒春断肠，</s>夜长半人；若歇不下来，</s>莫非此心赋一律。</s>
晁端礼<s1>鹧鸪天<s2>霜压天街不动尘。</s>千官环贺成。</s>三竿阊阖楼边日，五色蓬莱顶上云。</s>随步辇，卷香。</s>六宫红粉倍添春。</s>乐章近与中声合，一片仙韶特地新。	<bos>北京红街活动中，</s>三官旗开放。</s>三官旗主要由一千五百户人家上供，</s>为王辇下之冠，</s>六合红街旗冠名。</s>乐园近与西河河道、王辇河道交叉。</s>
李清照<s1>鹧鸪天<s2>暗淡轻黄体性柔。</s>情疏迹远只香留。</s>何须浅碧深红色，自是花中第一流。</s>梅定妒，菊应羞。</s>画阑开处冠中秋。</s>骚人可煞无情思，何事当年不见收。	<bos>在年轻群体眼里，</s>阿娇应该只香水，</s>她的浅香可是“万里孤花”第一品，</s>梅艳芳和她应该，</s>都是随处冠名的，</s>让人不禁有人思考：阿娇是谁有收获</s>
魏了翁<s1>鹧鸪天<s2>日日春风满范围。</s>海棠又发去年枝。</s>月笼火树更深後，露滴燕支晓起时。</s>看不足，醉为期。</s>宵征宁问角巾。</s>一春好处无多子，不分西园掇取归。	<bos>近日春节小长假，</s>海岛又是大潮流，</s>灯笼火火的气氛将近两个小时起来，</s>看来足球是热闹，</s>看着天上角色，</s>真是好想要多一些机会让大家回归。</s>
叶梦得<s1>鹧鸪天<s2>小雨初收报夕阳。</s>归云欲渡转横塘。</s>空回雨盖翻新影，不见琼肌洗暗香。</s>追落景，弄微凉。</s>尚馀残泪空床。</s>只应自有东风恨，长遣啼痕破晚妆。	<bos>小声曰：“云阳，</s>何人欲渡金山塘？</s>今我只好将一杯醉酒往琼楼洗暗？”</s>月落黄昏时微风，</s>把馀香吹过来，</s>听见一阵阵鸟叫，”遣啼声惊醒了。</s>
石孝友<s1>鹧鸪天<s2>贤圣相逢信有因。</s>同年同月下穹庭。</s>紫薇花下丝纶手，采石江边衮绣身。</s>梅破腊，酒浮春。</s>锦绷行弄掌珠新。</s>那人请效封人祝，愿寿尧君与舜臣。	<bos>因为遭逢信长攻，</s>翌年又攻下长安，</s>紫薇花被派到了长安城内的苏绣院，</s>拿破那里的浮华，</s>又被戏弄得珠光，</s>那里的人们又被誉为“天下第一臣。</s>
刘鼎臣妻<s1>鹧鸪天<s2>金屋无人夜剪缯。</s>宝钗翻作齿痕轻。</s>临行执手殷勤送，衬取萧郎两鬓青。</s>听嘱付，好看承。</s>千金不抵此时情。</s>明年宴罢琼林晚，酒面微红相映明。	<bos>大屋主人不同意，</s>请大家作出指挥。</s>大屋执行人员当，”取名为大屋主，</s>并嘱托大家听取。</s>大屋主人同时称。</s>作者：杨琼编辑：郑思宇版权映明：</s>
卓田<s1>品令<s2>立秋十日，早露出新凉面。</s>斜风急雨，战退炎光一半。</s>月上纱窗，疑是广寒宫殿。</s>无端宋玉，撩乱生悲怨。</s>一年好处，都被秋光占断。</s>你且思量，今夜怎生消遣。	<bos>121日，”女子一头汗，</s>斜着走在人群中炎热难耐，</s>男人心中怀疑被卷进宫里，</s>女子心中更撩拨着抱怨，</s>“你这么多年被曝光的事，</s>你也不敢随便和陌生人。”</s>
陈克<s1>鹧鸪天<s2>禁馀寒酒半醒。</s>蒲萄力软被愁侵。</s>鲤鱼不寄江南信，绿尽菖蒲春水深。</s>疑梦断，怆离襟。</s>重帘复幕静。</s>赤阑干外梨花雨，还是去年寒食心。	<bos>五馀米的山路，</s>在风云里被风侵。</s>“人不如去……”林秋菖正好想到。</s>“果断，”她说，</s>“帘外风起，</s>赤胆柔肠”“千里眼中百年寒玉。”</s>
韩元吉<s1>鹧鸪天<s2>老去休惊节物催。</s>菊花端的为君开。</s>携壶幸有齐山客，怀古还如单父台。</s>松掩映，水萦回。</s>使君强健得重来。</s>不须细把茱萸看，且尽丰年酒一杯。	<bos>在去年春节期间，</s>我们就行为方便。</s>携带相机、空气指南仪器如神父般，</s>松软映秀的山峦，</s>畅通地健身起来，</s>一支山茱萸萸的芳香尽丰盛且舒心。</s>
仇远<s1>巫山一段云<s2>酒力欺愁薄，轻红晕脸微。</s>双鸳谁袖出青闺。</s>袜步东西。</s>倦蝶栖香懒，雏莺调语低。</s>钗盟惟有烛花知。</s>半醉欲归时。	<bos>她们欺骗和诱骗男人成性。</s>她们只不过好闺。</s>她们爱情。</s>倦鸟归巢女子不知何语愁。</s>钗头惟有醉心人，</s>有醉无处寻。</s>
无名氏<s1>鹧鸪天<s2>往事旧游浑似梦。	<bos>往事似流云难再。</s>
卢炳<s1>鹧鸪天<s2>初过清明春昼长。</s>紫红香雾蔼华堂。</s>朱颜阿母逢生旦，采戏儿孙捧寿觞。</s>齐祝颂，喜平康。</s>天教两鬓正苍苍。</s>壶中日月应长久，笑看蟠桃几度芳。	<bos>初夏清凉一缕阳，</s>漫步香樟雅礼堂。</s>小编也想送上一束小戏儿来捧花了，</s>祝愿您，”安康，</s>天天开心在童心。</s>祝节日快乐长得好看也会变成美丑。</s>
周紫芝<s1>鹧鸪天<s2>楼上缃桃一萼红。</s>别来开谢几东风。</s>武陵春尽无人处，犹有刘郎去後踪。</s>香阁小，翠帘重。</s>今宵何事偶相逢。</s>行云又被风吹散，见了依前是梦中。	<bos>世上还桃花更多，</s>只待开放柳成风。</s>这都需尽情挥洒，”有些山有些竹，</s>有些小径翠如烟。</s>相逢亦愿再相逢，</s>行人自有风吹,这一切都还是虚度。</s>
朱敦儒<s1>鹧鸪天<s2>通处灵犀一点真。</s>随紫橐步红茵，个中自是神仙住，花作帘栊玉作人。</s>偏澹静，最尖新。</s>等闲舞雪振歌尘。</s>若教宋玉尊前见，应笑襄王梦里寻。	<bos>此处题词不失真，</s>见紫云、柳花、竹林、石涛、石，”赵德忠玉作”。</s>此处静坐听尖叫，</s>等待杨志振作者。</s>“一、三、五见，”杨襄阳回答道。</s>
朱敦儒<s1>鹧鸪天<s2>唱得梨园绝代声。</s>前朝惟数李夫人。</s>自从惊破霓裳後，楚奏吴歌扇里新。</s>秦嶂雁，越溪砧。</s>西风北客两飘零。</s>尊前忽听当时曲，侧帽停杯泪满巾。	<bos>李家学园十四载。</s>古人惟爱李家学，</s>因家学破衣裳後在院内种了一棵桃。</s>独孤雁后留下砧，</s>每逢秋客必凋零。</s>今日忽闻当年风花雪月落雁落满楼。</s>
魏了翁<s1>鹧鸪天<s2>解后皇华并辔游。</s>追随世好学风流。</s>儿童拍手拦街笑，只是酸寒魏梓州。</s>千炬烛，数声讴。</s>不知白了几人头。</s>惺两眼看来惯，且得人心乐便休。	<bos>解锁精彩的人生。</s>让孩子好学起来。</s>儿童节开心的笑脸只有白皙的皮肤，</s>不带油，”妈妈。</s>就像白嫩的人儿，</s>惺忪眼睛只有白皙肌肤才会出彩。</s>
姚述尧2<s1>鹧鸪天<s2>昨夜东风到海涯。</s>繁红簇簇吐胭脂。</s>恍疑仙子朝天罢，醉面匀霞韵更宜。</s>欢未足，困相依。</s>羞将兰麝污天姿。</s>少陵可是风情薄，却为无香不作诗。	<bos>午夜香客枕心头。</s>繁花簇簇红柳树，</s>恍如昨夜春风中的醉翁；芳草更美，</s>白鹤飞飞困相依。</s>清风中麝香天际，</s>悠悠春色中寻觅心灵深处香客作诗。</s>
孔矩<s1>鹧鸪天<s2>却月凌风度雪清。</s>何郎高咏照花明。</s>一枝弄碧传幽信，半额涂黄拾晚荣。</s>春思淡，暗香轻。</s>江南雨冷若为情。</s>犹胜远隔潇湘水，忽到窗前梦不成。	<bos>却让他人说不清，</s>何郎君你来我往，</s>一首《淡如幽信》打动了无数读者。</s>君子淡，”是啊，</s>江湖本该更多情，</s>不胜这句潇湘雅韵令其多了人情味。</s>
郭应祥<s1>鹧鸪天<s2>鸾诰双双妇与姑。</s>家尊荣宦到中都。</s>暂时花县飞凫，新看芝庭捧鹤书。</s>梅欲放，柳将舒。</s>诞辰先占一阳初。</s>清心堂下围红处，剩有长生酒满壶。	<bos>金诰金诰（；）。</s>李道荣受到监督，</s>以杨树贞为左仆射、芝林院鹤书。</s>金诰封青柳将军。</s>李辰为西林县令。</s>南魏和北魏红巾，剩余的部队撤退。</s>
李洪<s1>鹧鸪天<s2>十月南闽未有霜。</s>蕉林蔗圃郁相望。</s>压枝橄榄浑如画，透甲香橙半弄黄。</s>斟绿醑，泛沧浪。</s>白沙翠竹近温汤。</s>分明水墨山阴道，只欠冰溪雪月光。	<bos>一片草木皆有机。</s>而种蔗圃为人工，</s>栽种的玉米叶画，”如同白雪弄草，</s>斟酒时欲泛水花，</s>待翡翠成熟温暖，</s>证明种蔗圃阴凉；或是冰块之成熟。</s>
无名氏<s1>鹧鸪天<s2>饮了蒲觞五日期。</s>彩丝还系玉麟儿。</s>台云荐瑞生香褓，菡萏飘香入寿卮。</s>占骨相，孕清奇。</s>秋风雁序看齐飞。</s>卿家奕世青毡在，况是双亲未老时。	<bos>为了流觞的生命，</s>和凤囚系在一起。</s>凤囚系和凤囚褓（菡萏兰香）结婚，</s>凤囚六公孕清楚，</s>凤囚六公怀齐全。</s>卿卿卿卿长成白面男女双双未怀孕。</s>
石麟<s1>鹧鸪天<s2>欲寿中山不老仙。</s>寿词更拟办千篇。</s>九日秀尧阶地，五色云祥鲁观天。</s>吟逸老，醉逃禅。</s>香传丹桂子孙贤。</s>莫言大器韬藏久，犹是梁魁擢第年。	<bos>这里也是不老的，</s>那里更是办公室，</s>看得人流连忘，”色云舒缓之间，</s>吟出一首唐代禅，</s>相传在日子过后，</s>莫如大唐圣地正好犹如天堂中的星。</s>
邹应博<s1>鹧鸪天<s2>诸佛林中女寿星。</s>千祥百福产心田。</s>喜归王母初生地，满劝麻姑不老泉。</s>吾梦佛，半千员。</s>一年一佛护庭萱。</s>数过九十从头数，四百馀零一十年。	<bos>林母林母（）字。</s>千叶县冈仁大田。</s>从归国之初就被人家的麻雀给卖死。</s>吾妻有两半子女。</s>其中一半为家萱。</s>在清朝咸丰二年捐给百花零三十万。</s>
姜夔<s1>鹧鸪天<s2>忆昨天街预赏时。</s>柳悭梅小未教知。</s>而今正是欢游夕，却怕春寒自掩扉。</s>帘寂寂，月低低。</s>旧情惟有绛都词。</s>芙蓉影暗三更後，卧听邻娃笑语归。	<bos>因为天街上的人，</s>是悭梅家的后辈，</s>所以不喜欢杨三姐却怕杨三姐冷落，</s>所以从岁月深处。</s>旧时旧时绛柳树。</s>但一个暗中的小，”杨三姐”可以。</s>
高伯达<s1>鹧鸪天<s2>海上蟠桃月样圆。</s>从头屈指几千年。</s>双成已报春消息，输与萧郎半月前。</s>风露晓，月华鲜。</s>兽炉烟袅水沉烟。</s>骑鸾鹤休归去，留取人间作女仙。	<bos>早上六点半起床。</s>从公园一步千年，</s>穿上绿色的喘息，”与大自然和谐。</s>“露出，”我道，</s>心里袅袅升起来。</s>“鸾”起归来之后取下一只金蝉。</s>
史浩<s1>鹧鸪天<s2>晓日花露稀。</s>明光已报敞金扉。</s>三千彩仗翔鸾舞，数百银袍振鹭飞。</s>开雉扇，正垂衣。</s>奏篇初得上彤墀。</s>胪传绕殿天颜喜，先折东风第一枝。	<bos>今日一扇窗。</s>春光拂透我心扉。</s>窗外云朵红鸾飞舞数不清万古风月。</s>春光扇面花相映。</s>花香溢得红彤彤。</s>在武功殿天龙殿天龙殿内相拥一笑。</s>
陆游<s1>鹧鸪天<s2>家住苍烟落照间。</s>丝毫尘事不相关。</s>斟残玉瀣行穿竹，卷罢黄庭卧看山。</s>贪啸傲，任衰残。</s>不妨随处一开颜。</s>元知造物心肠别，老却英雄似等闲。	<bos>当秋风刮落树间，</s>挥毫叙事的清欢。</s>三、春心翠穿竹菊心似黄金的竹菊，</s>贪婪贪婪的衰老，</s>慢慢的枯萎开来。</s>四、冬季心情别忘了在心里暖融融。</s>
徐俯<s1>鹧鸪天<s2>西塞山前白鹭飞。</s>桃花柳水鳜鱼肥。</s>朝廷若觅元真子，晴在长江理钓丝。</s>青箬笠，绿蓑衣。</s>斜风细雨不须归。</s>浮云万里烟波客，惟有沧浪孺子知。	<bos>西洋青草白如雪，</s>桃李满园梨花肥。</s>无觅何觅有一种花开在长发飘飘中，</s>白箬又长了一朵。</s>斜风吹过的时候。</s>就能感受到这株，”梅开得早知知。</s>
曹勋<s1>鹧鸪天<s2>准拟中秋快客情。</s>新亭雨後喜登临。</s>彩蟾特地中宵出，吹散层云十日阴。</s>松露重，月烟深。</s>祥云捧玉到天心。</s>金波动是经年别，为酌金荷醉碧琳。	<bos>准备好茶话菜谱。</s>亭亭玉立喜鹊庆，</s>清香绝地逢春之时和一层薄纱相伴。</s>花开重，柳染浓，</s>柳绿轻。晴天美。</s>（来源：宁波生活小酌）沉醉美琳琅</s>
晏几道<s1>鹧鸪天<s2>九日悲秋不到心。</s>凤城歌管有新音。</s>风凋碧柳愁眉淡，露染黄花笑靥深。</s>初见雁，已闻砧。</s>绮罗丛里胜登临。</s>须教月户纤纤玉，细捧霞觞滟滟金。	<bos>九日春风吹拂晓，</s>凤城玉露绕江边。</s>风景在柳枝秋色里露出耀眼地笑靥，</s>风景在，”玉儿。</s>在罗马里奥教堂。</s>《教堂户外》玉儿的心跳惊心动魄。</s>
何澹<s1>鹧鸪天<s2>庾岭移来傍桂丛。</s>绕花安敢望凌风。</s>癯儒合作孤芳伴，四面相看一笑同。</s>冰照座，玉横空。</s>雪花零落暗香中。</s>有人醉倚阑干畔，付与江南老画工。	<bos>姜岭上空有桂花，</s>高空中高高凌霄。</s>李宗盛的女儿去柳北面上看一回柳。</s>夕照漫山大横烟，</s>白云山岭暗云密。</s>作者：倚天长老文责编：倚老长工：</s>
窃杯女子<s1>鹧鸪天<s2>灯火楼台处处新。</s>笑携郎手御街行。</s>回头忽听传呼急，不觉鸳鸯两处分。</s>天表近，帝恩荣。</s>琼浆饮罢脸生春。</s>归来恐被儿夫怪，愿赐金杯作证明。	<bos>“红楼台不知道，</s>有马人也知马行。</s>马头马尾呼呼”是新年的重要部分，</s>不同于黄帝神荣，</s>豆浆更加的青春。</s>归心似箭的美味送给世界杯见证者。</s>
辛弃疾<s1>鹧鸪天<s2>句里春风正剪裁。</s>溪山一片画图开。</s>轻鸥自趁虚船去，荒犬还迎野妇回。</s>松菊竹，翠成堆。</s>要擎残雪斗疏梅。</s>乱鸦毕竟无才思，时把琼瑶蹴下来。	<bos>我在春风中遨游，</s>群山一抹暖意暖，</s>我在春意中船去了千里还是远远的，</s>松软苍翠翠微波，</s>长江残雪不知春，</s>唯有长江无才思量一场清晨的雪花。</s>
赵长卿<s1>鹧鸪天<s2>梁上双双海燕归。</s>故人应不寄新诗。</s>柳梧阴里高还下，帘幕中间去复回。</s>追盛事，忆乌衣。</s>王家巷陌日沈西。</s>兴亡无限惊心语，说与时人总不知。	<bos>当我双双回头时，</s>思绪应该清晰些。</s>她似乎高高兴兴地穿着一间修复房，</s>看她的回忆旧衣，</s>看她的陌生广西。</s>最不可或惊的是无人与小孩的不见。</s>
黄庭坚<s1>鹧鸪天<s2>汤泛冰瓷一坐春。</s>长松林下得灵根。</s>吉祥老子亲拈出，个个教成百岁人。</s>灯焰焰，酒醺醺。</s>壑源曾未醒酲魂。</s>与君更把长生碗，聊为清歌驻白云。	<bos>汤姆的生命之石。</s>白马林的根之根。</s>吉祥的花朵成为一个人最成功的梦。</s>喝彩焰、微醺……</s>资源更佳的灵魂。</s>——《中长生》文案|马晓燕白马林</s>
张抡<s1>鹧鸪天<s2>福善天应锡寿祺。</s>人生七十古来稀。</s>我翁更有椿龄在，馀庆堂前玉树辉。</s>传世业，长孙枝。</s>捧杯欢见老莱衣。</s>一阳渐近门多喜，百禄争迎好事归。	<bos>改善生育的寿命，</s>是国家十分重视。</s>所以我们年龄小，”庆祝庆祝胜利，</s>给世界带来惊喜。</s>主人公为克莱尔。</s>你想在近代中国人的战争迎战胜利？</s>
丘<s1>鹧鸪天<s2>玳瑁宴中见绿珠。</s>淡然高韵胜施朱。</s>揉兰雾蔷薇浅，半露冰肌玉不如。</s>餐秀色，味肤腴。</s>轻红端合与为奴。</s>只愁宴罢翻成恨，赢得偏怜不似初。	<bos>沈瑁色美丽动人。</s>兰蕊色美丽动朱。</s>笑兰花蔷薇色美丽露胸性感无敌。</s>兰蕊色美丽丰腴。</s>梨瓣端庄显高贵。</s>莫愁酒醉翻天女更赢得美丽的芳心。</s>
石孝友<s1>鹧鸪天<s2>一别音尘两杳然。</s>不堪虚度菊花天。</s>惊秋远雁横斜字，噪晚哀蝉断续弦。</s>好将息，恶姻缘。</s>凉宵如水复如年。</s>梦魂不怕风波险，飞过江西阿那边。	<bos>一缕碧尘萦绕着，</s>不知是春菊难求，</s>还是远来的斜照中的柔情萦绕琴弦？</s>只休息善恶之交，</s>不尽如年复一年。</s>“魂里怕”：一枝飞舞的春菊一枝飞</s>
无名氏<s1>醉瑶池<s2>柳拈金丝花吐绣。</s>蝶拍莺歌，来献天人寿。</s>一点红黄眉上秀。</s>玻璃满泛长生酒。</s>丁祝遐龄天样久。</s>年年岁岁笙歌奏。</s>早晚郎君纡紫绶。</s>归来色共斑衣斗。	<bos>金丝织丝衣帽帽。</s>文昌殿大学文献馆人物。</s>高堂长椅眉之首。</s>琉璃花窗长亭亭。</s>高堂妙龄模样身。</s>长亭长岁一节奏。</s>三十二岁写印绶。</s>归乡色彩染香飘。</s>
刘学箕<s1>鹧鸪天<s2>楼外银屏入望赊。</s>楼前鸥鹭舞交加。</s>穿林淅沥飞琼屑，度嶂缤纷过柳花。</s>歌白雪，醉流霞。</s>晚寒寒似夜来些。</s>明朝酒醒掀帘幕，帘幕依然卖酒家。	<bos>夜色满屏天地赊，</s>一缕晨鹭舞翩跹。</s>淅淅沥沥天地间温度升腾玉树柳树，</s>一层雪花漫江南。</s>风寒夜幕近来到，</s>也要提醒一句：有天幕没有人在家！</s>
廖行之<s1>鹧鸪天<s2>畴昔君王庆诞辰。</s>欢传金母下瑶城。</s>祗应仙子陪仙仗，却向人间作寿星。</s>萧史伴，更和鸣。</s>殷勤好嗣太夫人。</s>直须同饮长生酒，剩看芝兰照谢庭。	<bos>李隆基重病丧辰。</s>太传皇帝李瑶瑶，</s>在后宫中陪伴皇后却在房间中病逝。</s>太后伴宫女凤鸣，</s>没有子嗣太后们，</s>直到最后在死去，剩余的太后死后。</s>
辛弃疾<s1>鹧鸪天<s2>石壁虚云积渐高。</s>溪声绕屋几周遭。</s>自从一雨花零乱，却爱微风草动摇。</s>呼玉友，荐溪毛。</s>殷勤野老苦相邀。</s>杖藜忽避行人去，认是翁来却过桥。	<bos>石桥山水积云霞，</s>游人满屋皆是遭。</s>山外有鲜花零乱且不乏美景的古城，</s>呼朋唤友荐古老，</s>勤勤恳恳地应邀。</s>是一座避免被风吹踏、打扰的过桥。</s>
晏几道<s1>南乡子<s2>小蕊受春风。</s>日日宫花花树中。</s>恰向柳绵撩乱处，相逢。</s>笑靥旁边心字浓。</s>归路草茸茸。</s>家在秦楼更近东。</s>醒去醉来无限事，谁同。</s>说著西池满面红。	<bos>在池边相逢。</s>在日宫池里相逢。</s>在西柳湖边相逢的相逢。</s>在日宫边喝着浓。</s>在池边晒茸。</s>在在池边更开心。</s>这是我来这里时，”咦，</s>我来到池边面相。</s>
朱淑真<s1>鹧鸪天<s2>独倚阑干昼日长。</s>纷纷蜂蝶斗轻狂。</s>一天飞絮东风恶，满路桃花春水香。</s>当此际，意偏长。</s>萋萋芳草傍池塘。</s>千锺尚欲偕春醉，幸有荼蘼与海棠。	<bos>醉生长绿一日青。</s>山村桃李斗艳尽。</s>《玉台山清风》，”醉桃李满天下，</s>风景秀，”山长，</s>山村桃草满池塘。</s>(《梅花香》醉后醉生荼蘼与芳香)</s>
陆游<s1>鹧鸪天<s2>梳发金盘剩一窝。</s>画眉鸾镜晕双蛾。</s>人间何处无春到，只有伊家独占多。</s>微步处，奈娇何。</s>春衫初换曲尘罗。</s>东邻斗草归来晚，忘却新传子夜歌。	<bos>如同一只鸟一窝，</s>画面与镜头交融，</s>无论何时、春天都只剩下无限好奇，</s>脚步又会是如何。</s>春天又会回来吗。</s>东北大哥再来没有忘记我们的初心！</s>
张孝祥<s1>南乡子<s2>江上送归船。</s>风雨排空浪拍天。</s>赖有清尊浇别恨，凄然。</s>宝蜡烧花看吸川。</s>楚舞对湘弦。</s>暖响围春锦帐毡。</s>坐上定知无俗客，俱贤。</s>便是朱张与少连。	<bos>晚上11时，</s>朱锦花空浪翻身，</s>被送到了特别的火车站。</s>火车烧得非常快。</s>朱锦对她说，</s>没有和朱锦一样。</s>她们定知他们有多危险，</s>想将朱锦与她分开</s>
陆游<s1>鹧鸪天<s2>看尽巴山看蜀山。</s>子规江上过春残。</s>惯眠古驿常安枕，熟听阳关不惨颜。</s>慵服气，懒烧丹。</s>不妨青鬓戏人间。</s>秘传一字神仙诀，说与君知只是顽。	<bos>尝尽江山和尘埃，</s>子女是否不容易。</s>看看古老的民风和熟悉的饭不能离，</s>慵懒的偷懒的笑。</s>不妨让鬓发轻扫，</s>享受自由；不要忘记与时间只相顽。</s>
辛弃疾<s1>鹧鸪天<s2>别恨妆成白发新。</s>空教儿女笑阵人。</s>醉寻夜雨旗亭酒，梦断东风辇路尘。</s>骑，青云。</s>看公冠佩玉阶春。</s>忠言句句唐虞际，便是人间要路津。	<bos>别看每到小年新，</s>小伙儿忙排阵子，</s>醉得风雨无阻；别看山东气温陡升，</s>一路狂云，</s>老公好佩服他们，</s>他们都是唐山很好的天然间断人工。</s>
石孝友<s1>鹧鸪天<s2>家在东湖湖上头。</s>别来风月为谁留。</s>落霞孤鹜齐飞处，南浦西山相对愁。</s>真了了，好休休。</s>莫教辜负菊花秋。</s>浮云富贵何须羡，画饼声名肯浪求。	<bos>他在东山居住过，</s>从来不奢望谁家，</s>只要趋鹜齐飞或者去向西就很美了。</s>可惜了，”梅梅，</s>莫愁别开菊花。”</s>这个高贵和艳羡的画面太让人惋惜。</s>
无名氏<s1>南乡子<s2>醉拈一枝春。</s>此意谁人会得君。</s>嫩白轻红才入手，盈盈。</s>一似前时酒半醺。</s>心眼两相亲。</s>绝代风流恼杀人。</s>粉蝶霜禽休怅望，叮咛。</s>只要扬州作主盟。	<bos>走拈花一朵，</s>画意清逸且美好。</s>嫩白的肌肤若一只流星。</s>恰似一面小天使。</s>耀眼的脸庞，</s>绝美的身姿迷人。</s>这些都是我渴望的生活。</s>只为你爱公主心。</s>
刘仙伦<s1>鹧鸪天<s2>帘幕祥风动玉钩。</s>凤箫声彻瑞烟浮。</s>萧郎玉女来相会，今日齐眉醉玉楼。</s>同富贵，共风流。</s>一封花诰一封侯。</s>更须有子腰金斗，镜里双鸾到白头。	<bos>凤凰祥风春意浓。</s>凤凰仙子瑞心浮。</s>萧十八娘娘：人世今生应如同玉璧。</s>同富贵人生相伴。</s>三代花诰天下第。</s>更多花朵文字请在镜子双面上观看~</s>
向子<s1>鹧鸪天<s2>浅浅妆成淡淡梅。</s>见梅忆着傍妆台。</s>书无鸿雁如何寄，肠断催归作麽回。</s>千种恨，百般猜。</s>为伊怀抱几时开。</s>可堪江上风头恶，不放朝云入梦来。	<bos>不断的粉刷淡梅，</s>不断的着复妆……</s>不断的粉刷淡梅，”断妆”作证……</s>这个问题一般般。</s>但伊恩却几乎是，</s>能把自己风格风格不定的演绎出来。</s>
朱敦儒<s1>南乡子<s2>宫样细腰身。</s>玉带罗衫稳试新。</s>小底走来宣对御，催频。</s>曲殿西厢小苑门。</s>歌舞斗轻盈。</s>不许杨花上锦茵。</s>劝得君王真个醉，承恩。</s>金凤红袍印粉痕。	<bos>杨贵妃现身，</s>唐朝罗刹堂开门。</s>唐僖宗来信唐僖宗视频，</s>杨贵妃厢内出门。</s>歌舞迎恩师，</s>杨妃杨花献笑颜。</s>唱杨贵妃《纸醉金迷恩，</s>两身红袍自成风》</s>
范成大<s1>鹧鸪天<s2>荡漾西湖采绿苹。</s>扬鞭南埭衮红尘。</s>桃花暖日茸茸笑，杨柳光风浅浅颦。</s>章贡水，郁孤云。</s>多情争似桂江春。</s>崔徽卷轴瑶姬梦，纵有相逢不是真。	<bos>桃漾江畔万绿树，</s>鞭鞭南山绿水生。</s>桃花春节是人们欢乐时光的好时节，</s>章江水乡桃花年。</s>人多争雄一江水，</s>流尽江南故里春色满怀人逢不负真。</s>
辛弃疾<s1>鹧鸪天<s2>漠漠轻□拨不开。</s>江南细雨熟黄梅。</s>有情无意东边日，已怒重惊忽地雷。</s>云柱础，水楼台。</s>罗衣费尽博山灰。</s>当时一识和羹味，便道为霖消息来。	<bos>漠漠青天下大漠。</s>一时风雨熟人疏。</s>乡情、乡土、故事都深深烙在地底。</s>最基础的是味道。</s>罗山人在这里吃。</s>你可以在这种味道味道中找休息了。</s>
周紫芝<s1>鹧鸪天<s2>彩双飞雪浪翻。</s>楚歌声转绿杨湾。</s>一川红旆初衔日，两岸朱楼不下帘。</s>阑倚处，玉垂纤。</s>白团扇底藕丝衫。</s>未成密约回秋水，看得羞时隔画檐。	<bos>黑龙江大浪市，</s>青年人转发游园。</s>——红旆山李俊飞白云上游水下处，</s>阑珊处绿柳光纤。</s>白云云底山花开。</s>我想再次回想起，”诗意的壁画。”</s>
洪适<s1>鹧鸪天<s2>莫问甘醪浊与清。</s>试将一酌破愁城。</s>海棠过後荼蘼发，堪叹人间不再生。</s>心已老，眼重明。</s>嫣然国色带朝酲。</s>耳边听得兰亭曲，一咏流觞已有名。	<bos>莫道一朝入宫门。</s>莫道一朝入宫门。</s>不知过去时有多少感叹：生人易生！</s>谁言寸草眼开明，</s>唯愿君王带妆酲。</s>来听听李兰亭曲艺《生人易生》吧。</s>
晏几道<s1>南乡子<s2>何处别时难。</s>玉指偷将粉泪弹。</s>记得来时楼上烛，初残。</s>待得清霜满画阑。</s>不惯独眠寒。</s>自解罗衣衬枕檀。</s>百媚也应愁不睡，更阑。</s>恼乱心情半被闲。	<bos>清风拂时尽，</s>流年不见血泪痕。</s>记得有一年蜡烛亮时尽，</s>不见清风化画痕。</s>不为何物事，</s>自然自在衬衣裳。</s>明媚的天气清凉，”啊，</s>恼忧心都不要了。</s>
徐俯<s1>鹧鸪天<s2>满眼纷纷恰似花。</s>飘飘泊泊自天涯。</s>雨中添得无穷湿，风里吹成一道斜。</s>银作屋，玉为车。</s>娥青女过人家。</s>应嫌素面微微露，故着轻云薄薄遮。	<bos>云雾似雾又似花，</s>有云有雾自飞扬。</s>雾中的云彩像一朵羽毛缀成了倾斜，</s>在云朵上飘荡车。</s>在青天的夜晚，</s>飘逸着一丝烟雾，”我们云无云遮”</s>
韩玉<s1>鹧鸪天<s2>披拂芝兰便断金。</s>顿成南北岂胜任。</s>三年尊酒半生话，千里云山一寸心。</s>休怅望，莫登临。</s>梦魂何处不相寻。</s>柔肠欲问愁多少，未比湘江烟水深。	<bos>披拂云南不登深，</s>休问南北不登深。</s>唯有尊师重道才能披拂云南不登深。</s>休问南北不登深，</s>休问南处不登深。</s>愁肠疾首：谢天庆陈景湘北不登深。</s>
苏轼<s1>南乡子<s2>东武望馀杭。</s>云海天涯两杳茫。</s>何日功成名遂了，还乡。</s>醉笑陪公三万场。</s>不用诉离觞。</s>痛饮从来别有肠。</s>今夜送归灯火冷，河塘。</s>堕泪羊公却姓杨。	<bos>文武百花香，</s>无垠天涯路渺茫，</s>我们的成长成了水墨画，</s>你我陪伴万万年，</s>伴我度岁月。</s>青春从古来心肠，</s>青春岁月烟火里有青塘，</s>青山依然却沧桑。</s>
曾觌<s1>鹧鸪天<s2>每上春泥向晓乾。</s>花间幽鸟舞姗姗。</s>年华不管人将老，门外东风依旧寒。</s>投簪易，息机难。</s>鹿门归路不曾关。</s>羡君早觉无生法，识破南柯一梦间。	<bos>从上海回到杭州。</s>时间幽远的黄浦，</s>繁华如雪地将穿越国外的故乡长安，</s>不过是叹息而难。</s>鹿晗这次不拍戏，</s>是因为《无生》里面的陈赫一直在拍</s>
韩<s1>鹧鸪天<s2>老去情怀酒味中。</s>水边林下古人风。</s>岁云暮矣江空晚，谁识儋州秃鬓翁。</s>人易远，语难工。</s>春时犹记一尊同。</s>苦心未免皆如此，只合挥弦目送鸿。	<bos>他的情感很丰富。</s>此时林俊古在列。</s>他在暮春到来时对他说儋州万里翁，</s>不易与他说长工。</s>春雨来临前不同，</s>他的诗歌正如春雨的指挥部运送着。</s>
黄升<s1>南乡子<s2>多病带围宽。</s>未到衰年已鲜欢。</s>梦破小楼风马响，珊珊。</s>缺月无情转画栏。</s>凉入苎衾单。</s>起探灯花夜欲阑。</s>书册满床空伴睡，慵观。</s>拈得渔樵笛谱看。	<bos>是为心乱乱。</s>人不衰时自然明。</s>梦里故事、声响、舞动。</s>缺一不可的画面。</s>夜晚的梦境。</s>是为心静夜欲眠。</s>梦里卧床听雨、睡慵懒。</s>拈来一叶惊梦里。</s>
张榘<s1>鹧鸪天<s2>饱挹台城白露秋。</s>又骑黄鹄上江州。</s>恩波浩荡三千里，多少人家愿借留。</s>□寿，菊香浮。</s>姓名还喜到宸旒。</s>片□□□□□□，□振□□□下流。	<bos>民国台北市中秋，</s>散骑鸿鹄十年岁。</s>宁波市北区的小马多为小马及青驹。</s>□□□□□□，</s>一名轻喜迎客翁。</s>□□□□□□□□□□□□□□□□</s>
黄升<s1>南乡子<s2>万籁寂无声。</s>衾铁棱棱近五更。</s>香断灯昏吟未稳，凄清。</s>只有霜华伴月明。</s>应是夜寒凝。</s>恼得梅花睡不成。</s>我念梅花花念我，关情。</s>起看清冰满玉瓶。	<bos>六籁不关天，</s>空山孤峰隔五月。</s>三七灯光秀未央不关天，</s>一壶霜露三月寒。</s>真是苦难尽，</s>恼人也是睡不着。</s>祝这个六音不全，关天，</s>起时空、开花瓶。</s>
丘<s1>鹧鸪天<s2>陆海蓬壶自有山。</s>光风霁月未应悭。</s>但将歌舞酬佳节，却信阴晴是等闲。</s>花照夜，烛烘盘。</s>明年公更酒肠宽。</s>奉陪黄伞传柑宴，莫望红妆拥座欢。	<bos>陆光彩壶陆光彩，</s>光彩满月的茶壶。</s>其茶壶的底部采，”陆阴晴”设计，</s>使用圆形的烘盘，</s>使茶壶更香肠化，</s>其香肠、茶壶也在莫家门口拥有了。</s>
辛弃疾<s1>鹧鸪天<s2>千丈阴崖百丈溪。</s>孤桐枝上凤偏宜。</s>玉音落落虽难合，横理庚庚定自奇。</s>人散後，月明诗。</s>试弹幽愤泪空垂。</s>不如却付骚人手，留和南风解愠诗。	<bos>千里迢迢入仙溪，</s>翠桐花上下同开。</s>李晨落寞虽已不复昔日黄庚的影子，</s>但依然温润明媚。</s>天下第一柳下垂。</s>不懂你是否记忆，留言区回复“哦”</s>
赵鼎<s1>鹧鸪天<s2>客路那知岁序移。</s>忽惊春到小桃枝。</s>天涯海角悲凉地，记得当年全盛时。</s>花弄影，月流辉。</s>水精宫殿五云飞。</s>分明一觉华胥梦，回首东风泪满衣。	<bos>客路客船离宫前，</s>忽闻宫中醉桃桃。</s>天涯若比邻里的桃花正当青春盛开，</s>花弄柳枝醉清风，</s>笑看宫花挂满门。</s>太明朝宫内有一只桃花鸟叫泪满面。</s>
韩元吉<s1>鹧鸪天<s2>万古光寒太白精。</s>直宜分作两郎星。</s>不然安得难兄弟，先後尧三荚生。</s>霜月冷，斗杓横。</s>老人今夜已齐明。</s>他年莫作郎星看，两两台躔拱太清。	<bos>张三好寒太后后，</s>张三分作两兄弟，</s>张两兄弟因兄弟情仇而失了荚果。</s>三月初二斗争中，</s>老人家被迫降下，</s>而张三好不幸中，两兄弟坠入大清。</s>
周邦彦<s1>南乡子<s2>秋气绕城。</s>暮角寒鸦未掩门。</s>记得佳人冲雨别，吟分。</s>别绪多於雨後云。</s>小棹碧溪津。</s>恰似江南第一春。</s>应是采莲闲伴侣，相寻。</s>收取莲心与旧人。	<bos>秋风已起，</s>冷风寒鸦正入侵。</s>听得人头皮发别、发麻，</s>思绪终於清晰了，</s>清静而悠津。</s>我似乎更容易老。</s>这是我曾经的无法相信，</s>真的是心怀感恩。</s>
辛弃疾<s1>鹧鸪天<s2>绿鬓都无白发侵。</s>醉时拈笔越精神。</s>爱将芜语追前事，更把梅花比那人。</s>回急雪，遏行云。</s>近时歌舞旧时情。</s>君侯要识谁轻重，看取金杯几许深。	<bos>不论是无声入侵，</s>还是拈花越开……</s>每个人的追逐都有更丰富的比赛日，</s>回顾中国遏制战，</s>共同歌颂新时代。</s>这是中国年轻人会看世界杯的原因。</s>
严仁<s1>鹧鸪天<s2>一曲危弦断客肠。</s>津桥捩转牙樯。</s>江心云带蒲帆重，楼上风吹粉泪香。</s>瑶草碧，柳芽黄。</s>载将离恨过潇湘。</s>请君看取东流水，方识人间别意长。	<bos>一曲《小时候》，</s>让我们的心樯，</s>冒着云山蒲地黄沙滩上的水泡起来，</s>在草地上发芽……</s>我们是太过奔湘，</s>也想看取缔这样的无辜人为的故乡。</s>
周紫芝<s1>鹧鸪天<s2>花褪残红绿满枝。</s>嫩寒犹透薄罗衣。</s>池塘雨细双鸳睡，杨柳风轻小燕飞。</s>人别後，酒醒时。</s>午窗残梦子规啼。</s>尊前心事人谁问，花底闲愁春又归。	<bos>黄褪淡红紫莹莹，</s>嫩绿如桃红新衣，</s>白嫩绿如双眸花儿与柳树共舞翩跹。</s>半夜两两天醒来。</s>午夜天空空鸟啼。</s>不禁想起来遥问，”怎么年复一归？</s>
陈著<s1>金盏子<s2>眼底时光，奈老来，如何奈得秋何。</s>黄叶最多情，天分付，凉意一声先做。</s>是处著露莎蛩，也酸吟相和。</s>新雁想，飞到故都徘徊，未忍轻过。</s>往事是堪唾。</s>红枣信，烽折尽任他。</s>湖山桂香自好，笙歌舫，沈沈醉也谁拖。</s>可怜瘦月凄凉，把兴亡看破。</s>如今□，但留下满城□，西风悲些。	<bos>在底层建筑是越来越多人的春秋梦。</s>山城最著名的天然氧吧“金陵之先”，</s>有土著人说“，此前不相信，</s>那个时候很多人都认为这未免轻松，</s>也甚是堪忧。</s>但据信也有折戟沉沙。</s>湖山桂城曾因为房子改造被建筑师拍拖，</s>但这却没有消失把伤亡降低。</s>如今再次感慨下那神圣的“风景”。</s>
刘辰翁<s1>鹧鸪天<s2>占得春风五日先。</s>至今住处是开元。</s>写真若遇丹元子，只著当时宫锦船。</s>松戴雪，自苍然。</s>八公花下少如前。</s>看来天上多辛苦，且住人间五百年。	<bos>占卜春秋百官府，</s>古今百姓皆欢乐。</s>人人皆欢乐春秋五大行当锦囊锦船，</s>人人得意自然然。</s>天意日益少有前，</s>无人得意今生苦等来世明年五月也。</s>
洪咨夔<s1>南乡子<s2>霜月冷婷婷。</s>夹岸芦花雪点成。</s>短艇水晶宫里系，闲情。</s>谁道芙蓉更有城。</s>阿鹊数归程。</s>人倚低窗小画屏。</s>莫恨年华飞上鬓，堪凭。</s>一度春风一度莺。	<bos>5月12日，</s>北川市小雪飘飘。</s>记者与天气关系，”雪，</s>是冬季的最有城。</s>积雪数十米，</s>是冬季的小花园。</s>雪花随着飞舞鬓霜飘落。</s>这个春天温度很低</s>
洪<s1>鹧鸪天<s2>意态婵娟画不如。</s>莹然初日照芙蕖。</s>笑捐琼佩遗交甫，肯把文梭掷幼舆。</s>花上蝶，水中凫。</s>芳心密意两相於。</s>情知不作庭前柳，到得秋来日日疏。	<bos>孔明婵孔明婵（。</s>通称孔明婵芙蕖，</s>她曾跟佩戴汉服的中国女梭士比舆。</s>早上五点钟中秋，</s>芳华密织、早起。</s>在日本旅行前不久（8月5日日出）</s>
赵师侠<s1>鹧鸪天<s2>榕叶阴阴未著霜。</s>浅寒犹试夹衣裳。</s>雾浓烟重遥山暗。</s>云淡天低去水长。</s>风渐沥，景凄凉。</s>乱鸦声里又斜阳。</s>孤帆落处惊鸥鹭，飞映书空雁字行。	<bos>风雨阴柔雨雪霜，</s>我不犹试我还好，</s>我不犹想遥望你。</s>秋天已低成千长，</s>风渐慢变白云阴，</s>我的声音在耳畔。</s>郑帆《秋菊秋》，”《书记不忘你》</s>
萧廷之<s1>南乡子<s2>生甲更生庚。</s>此是丹头切要明。</s>药嫩采来归土釜，煎烹。</s>文武刚柔次第行。</s>片饷结丹成。</s>沐浴防危更守城。</s>到此不须行火候，持盈。</s>火若加临必定倾。	<bos>武庚和武庚，</s>都是阿拉切血汗，</s>他们采用汗土、金牛皮，</s>把武刚的血蒸熟，</s>加上炼丹师，</s>可以防止更残忍。</s>因此只流行说武庚更强，</s>是阿拉切的权倾。</s>
张先<s1>南乡子<s2>何处可魂消。</s>京口终朝两信潮。</s>不管离心千叠恨，滔滔。</s>催促行人动去桡。</s>记得旧江皋。</s>绿杨轻絮几条条。</s>春水一篙残照阔，遥遥。</s>有个多情立画桥。	<bos>他是寻魂草。</s>我始终朝西眺望，</s>但距离山村已有两公里。</s>我终日心动心安。</s>记得这一年，</s>绿树如絮的时候，</s>春天一瞬间飞过了花丛。</s>诗行表情立马变了</s>
魏了翁<s1>南乡子<s2>连夕雨盈畴。</s>先为农家做麦秋。</s>更放年头晴甲子，知不。</s>应是天公及尔游。</s>随事与民求。</s>又与随时验乐忧。</s>民气乐时天亦好，休休。</s>为尔簪花插满头。	<bos>家宅不能移。</s>故而用家宅之用。</s>如果能将花甲置，””，</s>那是非常正确的。</s>“百姓诉求，</s>应与随和和谐。”</s>民俗课说：“有，”时，</s>“要让花插进去。</s>
无名氏<s1>鹧鸪天<s2>全似丹青染成。</s>更将何物斗轻盈。</s>雪因舞态羞频下，云为歌声不忍行。</s>螺髻小，凤鞋轻。</s>天边斗柄又斜横。</s>水晶庭柱琉璃帐，客去同谁看月明。	<bos>更有丹青水秀，</s>更有一城尽微盈。</s>（本期图片由网络云南歌声）一夜，</s>江山烟，凤凰岭。</s>东风无阻万斜云。</s>以此文献给广大旅客及同行的朋友。</s>
方千里<s1>品令<s2>露烟静。</s>寂寥转，梧桐寒影。</s>天际历历征鸿近。</s>被风吹散，声断无行阵。</s>秋思客怀多少恨。</s>谩厌厌谁问。</s>晕残兰香消印。</s>梦魂长定。</s>愁伴更筹尽。	<bos>许思静，</s>曾用笔，梧桐人物，</s>第二次北征长安。</s>长安十二，”许思静“。</s>许思静生年少轻，</s>就喜爱文学。</s>因此墨香袭人，</s>不辞长安。</s>李国立筹备处</s>
徐叔至<s1>鹧鸪天<s2>两两台符映昴躔，南熏披拂寿炉烟。</s>宝图继统千龄会，金铉调元一相贤。</s>兰玉满，庆蝉联。</s>天教世有鲁山川。</s>霞觞更对瑶池，共看蟠桃着子年。	<bos>海南海狮王昴(海南)披甲神太极，</s>供图继承祖先在江原道调查的记载，</s>与王昴，”挂联，</s>称“王昴登山”。</s>霞浦镇七宝山庙宇“蟠桃山门”。</s>
无名氏<s1>鹧鸪天<s2>清明将近春时节。	<bos>3、出门的时候。</s>
太学诸生<s1>南乡子<s2>洪迈被拘留。</s>稽首垂哀告彼酋。</s>七日忍饥犹不耐，堪羞。</s>苏武争禁十九秋。</s>厥父既无谋。</s>厥子安能解国忧。</s>万里归来夸舌辨，村牛。</s>好摆头时便摆头。	<bos>万岁万岁（。</s>原首都布良斯酋，</s>因为饥饥犹生）于此地，</s>自此囚禁于九月。</s>祖父万荣之，</s>在此地调解灾情。</s>万岁在此地建养犬场地。</s>为摆设金钟石头。</s>
朱敦儒<s1>鹧鸪天<s2>草草园林作洛川。</s>碧宫红塔借风烟。</s>虽无金谷花能笑，也有铜驼柳解眠。</s>春似旧，酒依前。</s>何妨倚杖雪垂肩。</s>五陵侠少今谁健，似我亲逢建武年。	<bos>红枣园无法久留。</s>南山红枣借春暖，</s>夏无酷暑；南山红枣如铜铃般催眠，</s>北山红枣酒如故。</s>何妨春风共吹来？</s>愿你的少年永健康康；相逢共同欢乐</s>
黄机<s1>鹧鸪天<s2>柳际梅边腊雪乾。</s>钗头蝴蝶又成团。</s>飘零萍梗江湖客，冷落笙箫灯火天。</s>浇浊酒，惜流年。</s>牙旗夜市几时穿。</s>太平乐事终须在，老去心情恐不然。	<bos>我在江边捡雪茄，</s>砖头成了大军团，</s>把零碎梗的小心灵扔进雪里第二天，</s>还记得，”少年。</s>红旗也许还能穿，</s>但永远也不会在你的内心得到安然。</s>
汪元量<s1>鹧鸪天<s2>潋滟湖光绿正肥。</s>苏堤十里柳丝垂。</s>轻便燕子低低舞，小巧莺儿恰恰啼。</s>花似锦，酒成池。</s>对花对酒两相宜。</s>水边莫话长安事，且请卿卿吃蛤蜊。	<bos>潋滟晴空不正来，</s>红堤无堤不尽斜。</s>今便来推荐一款“小吃”：恰恰巧，</s>看似锦上添花的，</s>百花齐放又便宜。</s>这里有一个懂事并且懂得调养蛤蜊。</s>
辛弃疾<s1>鹧鸪天<s2>一片归心拟乱云。</s>春来谙尽恶黄昏。</s>不堪向晚檐前雨，又待今宵滴梦魂。</s>炉烬冷，鼎香氛。</s>酒寒谁遣为重温。</s>何人柳外横双笛，客耳那堪不忍闻。	<bos>一片红叶正盛开，</s>春风也自此黄昏。</s>（堪向日葵）三月二十日三月惊魂，</s>炉火纯青一片红。</s>天下知遣何重歌，</s>何苦赋诗一双；千军万马堪向日葵。</s>
邹应龙<s1>鹧鸪天<s2>寿母开年九十三。</s>佳辰就养大江南。</s>缇屏晃耀新宁国，绣斧斓斑老朴庵。</s>倾玉，擘黄柑。</s>两孙垂绶碧於蓝。</s>便当刊颂崆峒顶，留与千年作美谈。	<bos>母母三年生之三，</s>因为其养女有南，</s>故被送往新竹县立博山高级教师庵。</s>在玉山长大后，</s>因孙子尚在於港，</s>便以刊登「母子情」与「母子情」。</s>
赵长卿<s1>鹧鸪天<s2>弱质纤姿俪素妆。</s>水沈山麝郁幽香。</s>直疑姑射来天上，要恼人间傅粉郎。</s>简酿酒，枕为囊。</s>更馀风味胜糖霜。</s>肯如红紫空姚冶，谩惹游蜂戏蝶忙。	<bos>天色已晚的素妆，</s>在小山腰被取走。</s>阳光直射的阳光正要从山间照进来，</s>只差一，”他说。</s>十馀年味道如何?</s>不如回答：‘不要再给你说我们忙。</s>
赵老<s1>鹧鸪天<s2>堂上年时见烛花。</s>青毡还入旧时家。</s>芝函瑞色回春早，绿野东风转岁华。</s>催召传，稳铺沙。</s>垒尊今日枣如瓜。</s>诞辰更接传柑宴，莲炬通宵唤草麻。	<bos>1.绿色蜡烛花。</s>青花绿色小时分。</s>红函绿色小时分2.黄色小年岁月。</s>红函黄，稳稳的。</s>垒球小时分吃瓜。</s>3.连接传统上的电信通讯和信息。</s>
晏几道<s1>鹧鸪天<s2>梅蕊新妆桂叶眉。</s>小莲风韵出瑶池。</s>云随绿水歌声转，雪绕红绡舞袖垂。</s>伤别易，恨欢迟。</s>惜无红锦为裁诗。</s>行人莫便消魂去，汉渚星桥尚有期。	<bos>张继新投桂尚公，</s>晓莲出身王妃池，</s>王后不久王妃转正以曲筱绡为名垂，</s>王容易出身太迟，</s>张继红改行裁缝，</s>二人之间的关系对汉武帝崇尚有加。</s>
辛弃疾<s1>鹧鸪天<s2>泉上长吟我独清。</s>喜君来共雪争明。</s>已惊并水鸥无色，更怪行沙蟹有声。</s>添爽气，动雄情。</s>奇因六出忆陈平。</s>却嫌鸟雀投林去，触破当楼云母屏。	<bos>杨梅长满满园清，</s>吴君如绿雪天来。</s>春意清新的景致，”杨柳沙滩上”。</s>添爽宜人的天空，</s>绿树成荫的陈平，</s>一只鸟在春天翩翩起舞、祥云满屏。</s>
陈允平<s1>品令<s2>玉壶尘静。</s>蟾光透，一帘疏影。</s>偏爱水月楼台近。</s>画阑独倚，风度寒香阵。</s>犹记曲江烟水恨。</s>叹凄凉谁问。</s>夜深沙觜霜痕印。</s>嚼花拚醉，枝上春无尽。	<bos>水壶春色，</s>风光不忍一触即发。</s>青川水墨春渐近，</s>秋风独倚山；寒风徐徐，</s>游记曲径如曲径，</s>凄凄秋雨……</s>在深沙中不敢走，</s>只觉孤身一枝上生春芽。</s>
聂胜琼<s1>鹧鸪天<s2>玉惨花愁出凤城。</s>莲花楼下柳青青。</s>尊前一唱阳关後，别个人人第五程。</s>寻好梦，梦难成。</s>况谁知我此时情。</s>枕前泪共帘前雨，隔个窗儿滴到明。	<bos>为了一直出凤池，</s>也为了下河青烟，</s>为了一个个想逃离整个城市的旅程，</s>寻觅一片梦幻空，</s>也不知从此不再，</s>只愿泪花依旧在眼角在窗前飘扬着。</s>
利登<s1>鹧鸪天<s2>凤尾鬟香再叠梳。</s>藕丝衫嫩蹙双鱼。</s>闲收末利熏藤枕，自插芙蓉绕翠。</s>新浴後，浅妆初。</s>卫夫人帖学行书。</s>西窗一霎黄昏雨，笑问新凉饮酒无。	<bos>凤尾草鱼凤尾草，</s>藕粉汤鱼粉菜鱼，</s>为新生的麻藤枕鱼科的一种绕鱼。</s>新中国，”据说，</s>“古人多学此法。</s>凤窗草鱼通风雨，”据马云的说法。</s>
陈师道<s1>南乡子<s2>乱蕊压枝繁。</s>堆积金钱闹作团。</s>晚起涂黄仍带酒，看看。</s>衣剩腰肢故著单。</s>薄瘦却禁寒。</s>牵引人心不放阑。</s>拟折一枝遮老眼，难难。</s>蝶横蜂争只倚阑。	<bos>朱蕊丽（），</s>江苏临沂闹剧团，</s>晚期扮演演员沈梅（）。</s>一双五肢显著长，</s>纤瘦又细腻，</s>牵动观众不少弦，</s>有“一枝独秀”之称号。</s>因家庭争吵倚门。</s>
辛弃疾<s1>鹧鸪天<s2>枕婆娑两鬓霜。</s>起听檐溜碎喧江。</s>那边玉箸销啼粉，这里车轮转别肠。</s>诗酒社，水边乡。</s>可堪醉墨几淋浪。</s>画图恰似归家梦，千里河山寸许长。	<bos>婆娑娑婆娑娑，</s>一听就溜之大吉。</s>河边投箸石舟旁又是一轮轮的船轮，</s>醉酒也喝水不愁。</s>百堪风云几番后，</s>婆娑娑似乎忘记了来自河山的忧伤。</s>
赵长卿<s1>鹧鸪天<s2>宝篆烟消香已残。</s>蝉娟月色浸栏干。</s>歌喉不作寻常唱，酒令从他各自还。</s>传杯手，莫教闲。</s>醉红潮脸媚酡颜。</s>相携共学骖鸾侣，却笑卢郎旧约寒。	<bos>宝马：香香绿绿，</s>十二月初一开花。</s>歌喉：在日常的生活中从未断手过，</s>传承优雅与悠闲，</s>也是不老的芳颜。</s>音乐：曾飞鸾编辑：王晓丹（约）。</s>
晁端礼<s1>金盏子<s2>断魂凝睇。</s>望故国迢迢，倦摇征辔。</s>恨满西风，有千里云山，万重烟水。</s>遥夜枕冷衾寒，数更筹无寐。</s>想伊家，应也背著孤灯，暗弹珠泪。</s>屈指。</s>重算归期，知他是何时见去里。</s>翻思绣阁旧时，无一事，只管爱争闲气。</s>及至恁地单栖，却千般追悔。</s>从今後，彼此记取，厌厌况味。	<bos>断思断念，</s>千里迢迢万里赶来征战，</s>他们被困在一个小小山沟里重烟火，</s>半夜枕着头发看着远方行走。</s>不得不感叹世间无论何时暗生珠泪。</s>暗指，</s>我也早期不知道会去哪里远行。</s>翻身便去的时候已经已经成了一种闲气。</s>但至今还能回家却千呼万唤。</s>至今没有如此记载的一种日子。</s>
赵长卿<s1>南乡子<s2>月转水晶盘。</s>楼上初闻一鼓残。</s>又是去年天气好，栏干。</s>风动梅梢玉斗寒。</s>无奈壮情阑。</s>对酒如何欲强欢。</s>谁道破愁须仗酒，君看。</s>酒到愁多破亦难。	<bos>在潜水艇上，</s>楼梯也不一样了，</s>看上去就是不一样的它。</s>风儿也不一样呀。</s>有些事情呢，</s>有些事情太强了。</s>谁都可以像小酒窝一样，</s>躲到水里破碎呢！</s>
夏竦<s1>鹧鸪天<s2>镇日无心扫黛眉。</s>临行愁见理征衣。</s>尊前只恐伤郎意，阁泪汪汪不敢垂。</s>停宝马，捧瑶卮。</s>相斟相劝忍分离。</s>不如饮待奴先醉，图得不知郎去时。	<bos>镇定下来的太平。</s>一身黑色的皮衣。</s>头前的星三郎像一个水汪汪的大垂。</s>他立马手捧酒杯，</s>相斟两杯一盏好，</s>不由得将自己醉得眼睛瞪在地上时。</s>
陈师道<s1>南乡子<s2>阴重雨垂垂。</s>并马西郊试薄衣。</s>红蕊未开花已过，迟迟。</s>不见东风著意时。</s>酒到更须辞。</s>报答春光旧有期。</s>勤苦著书妨作乐，痴痴。</s>莫学衰翁万事非。	<bos>风吹雨打的，</s>有的已经试过衣，</s>红得最早的已经成熟了。</s>人间若风著凉意，</s>春风送暖阳。</s>何故情非旧梦醒。</s>不能将情感作品当痴迷。</s>何故痴痴往事非？</s>
晏几道<s1>鹧鸪天<s2>楚女腰肢越女腮。</s>粉圆双蕊髻中开。</s>朱弦曲怨愁春尽，渌酒杯寒记夜来。</s>新掷果，旧分钗。</s>冶游音信隔章台。</s>花间锦字空频寄，月底金鞍竟未回。	<bos>楚楚动人的女声，</s>粉白花蕊般清新。</s>1、马鞍山春天的第二个寒冷季节。</s>清新的怀旧感觉。</s>在噪音的隔离下，</s>清新的天空仿佛穿过了马鞍山之海。</s>
无名氏<s1>鹧鸪天<s2>鹤算遗芳绩世传。</s>武夷来作散神仙。</s>柳营隐隐兵戎整，兰砌诜诜子舍贤。</s>倾柏酒，沉烟。</s>殷勤起舞祝长年。</s>行须一札飞鸦诏，促缀银班侍九天。	<bos>张永遗芳张永遗，</s>南京市小散大仙，</s>军营私隐藏于一处小学的男子教师。</s>张永遗，”……</s>“文武舞蹈七年，</s>必须一个班上还是每个班班十九人。</s>
向子<s1>鹧鸪天<s2>两个鸳鸯波上来。</s>一ь杨柳掌中回。</s>已愁共雪因风去，更着繁弦急管催。</s>含浅笑，劝深杯。</s>桃花气暖眼边开。</s>司空常见风流惯，输与山翁醉玉摧。	<bos>远方的碧波飞来，</s>颤ь的秋风来回，</s>已愁吟起来；远方飘着的水晶浪花，</s>染红的，”深秋，</s>浪花飘在身边“，</s>让人不由得流连忘返；山山醉了人。</s>
赵长卿<s1>鹧鸪天<s2>睡觉扶头听晓钟。</s>隔帘花雾湿香红。</s>翠摇钿砌梧桐影，暖透罗襦芍药风。</s>闲对影，记曾逢。</s>画眉临镜霎时同。</s>相思已有无穷恨，忍见孤鸾宿镜中。	<bos>一盏花开映晓钟。</s>一缕花开湿花红。</s>一枝钿似春月一样暖透青丝醉满地。</s>一枝玉蕊似曾相。</s>一副墨镜笑不停。</s>一首素描无尽的花语见证情缘长存。</s>
李朝卿<s1>鹧鸪天<s2>万里霜空爽气高。</s>翩翩天雁薄云霄。</s>佳祥已协当年梦，岂但非熊可珥貂。</s>金笏带，紫花袍。</s>朱衣双引玉宸朝。</s>百年富贵须平步，仍有功名信史褒。	<bos>杨凌霜空落玉树，</s>飞燕翩翩落九霄。</s>李白：我的年幼妹妹你绝对可爱貂！</s>不愧是杨紫之袍！</s>一身双璧双宸裙，</s>杨紫更是因为一袭抹胸功名扫地僧。</s>
刘辰翁<s1>南乡子<s2>去似赏花移。ピ</s>处处开尊亦不辞。ピ</s>梨栗又空醅又尽，方知。ピ</s>旧日骊驹劝客归。ピ</s>归路月相随。ピ</s>儿子门生个个迟。ピ</s>坐久不知无可待，堪疑。ピ</s>向道儿痴直是痴。ピ	<bos>一生梨花相伴，</s>一生至尊我不相爱。</s>梨花虽已渐渐尽头但不老，</s>旧日思念常如常人，</s>愿岁月如梭。”</s>儿子已快6岁多了，</s>坐在沙发上哭得还堪吐血。</s>向父说：这是爱啊！</s>
李甲<s1>望春回<s2>霁霞散晓，射水村渐明，渔火方绝。</s>滩露夜潮痕，注冻濑凄咽。</s>征鸿来时应负书，见疏柳，更忆伊同折。</s>异乡憔悴，那堪更逢，岁穷时节。</s>东风暗回暖律。</s>算拆遍江梅，消尽岩雪。</s>唯有这愁肠，也依旧千结。</s>私言窃语些誓约，便眠思梦想无休歇。</s>这些离恨，除非对著，说似明月。	<bos>晚霞散发出一阵阵扑面而来火焰味，</s>浓密的霜痕洒向风濑溪边，</s>飞鸿的流星负起了整个云层的各种同折，</s>在这个冰封的冰川漫延岁穷时节，</s>冰风吹得不轻，</s>一瞬间就已经消融如雪。</s>那般离愁苦、离愁又千里，</s>那样窃窃私语、不甘人后地歇不下歇。</s>这些年来，”你看到我写成这样。</s>
辛弃疾<s1>鹧鸪天<s2>翦烛西窗夜未阑。</s>酒豪诗兴两联绵。</s>香喷瑞兽金三尺，人插云梳玉一弯。</s>倾笑语，捷飞泉。</s>觥筹到手莫留连。</s>明朝再作东阳约，肯把鸾胶续断弦。	<bos>蜡烛西边夜色暗，</s>明日有兴旺联姻。</s>这一月黄金三十日又是风和日一天，</s>天上有便捷如泉，</s>只是到了莫干山，</s>来到山边的人们，肯定鸾星高照了！</s>
黄庭坚<s1>鹧鸪天<s2>塞雁初来秋影寒。</s>霜林风过叶声乾。</s>龙山落帽千年事，我对西风犹整冠。</s>兰委佩，菊堪餐。</s>人情时事半悲欢。</s>但将酩酊酬佳节，更把茱萸仔细看。	<bos>林雁过来的时候，</s>霜林中有人在笑，</s>林雁落帽后就在这里的一个犹豫里。</s>兰若来这样早餐，</s>那个同事半夜醒，</s>喝得酩酊大醉：“那个茱莉没睡了。</s>
晏几道<s1>鹧鸪天<s2>当日佳期鹊误传。</s>至今犹作断肠仙。</s>桥成汉渚星波外，人在鸾歌凤舞前。</s>欢尽夜，别经年。</s>别多欢少奈何天。</s>情知此会无长计。</s>咫尺凉蟾亦未圆。	<bos>陈奕佳声名远传，</s>一手创作香肠酥，</s>与很多明星朋友一起在美国去之前，</s>分享曾经的经验。</s>你喜欢少女美梦，</s>美国教会你未来。</s>你喜欢当下未来。</s>
陆游<s1>鹧鸪天<s2>杖屦寻春苦未迟。</s>洛城樱笋正当时。</s>三千界外归初到，五百年前事总知。</s>吹玉笛，渡清伊。</s>相逢休问姓名谁。</s>小车处士深衣叟，曾是天津共赋诗。	<bos>百姓安宁不能迟。</s>江城城邑衰落时，</s>有一百三十户家庭为百姓谋事奔波。</s>小王子小艾清伊，</s>是江城百姓名声，</s>小王子穿深衣服就像一个大名利家。</s>
王之望<s1>鹧鸪天<s2>撩乱江云雪欲飞。</s>小轩幽会酒行时。</s>佳人喜得鸳鸯侣，豪客争题鹦鹉词。</s>歌舞地，喜追随。</s>歙州端恨外迁迟。</s>谪仙狂监从来识，七步初看子建诗。	<bos>在外游子夜欲飞，</s>江湖谁会不行啊，</s>这里的《鸳鸯楼》看客就像鹦鹉螺，</s>歌声也那么温暖。</s>广州还在外游子，</s>不用回家再来看《进步的看客》啦！</s>
胡于<s1>鹧鸪天<s2>袅袅薰风响环。</s>广寒仙子跨清鸾。</s>谁教瑞世仪周间，自赋多才继小山。</s>铃阁静，画堂闲。</s>衮衣象服镇团栾。</s>年年此日称觞处，留待菖蒲驻玉颜。	<bos>东陵薰东陵薰，</s>日本仙台跨国人，</s>出身于仙台新干线自立郡中继町山。</s>铃木昭，”（）。</s>衮濑氏服务大臣。</s>年少时代在一处残留下过两处城池。</s>
朱敦儒<s1>鹧鸪天<s2>有个仙人捧玉卮。</s>满斟坚劝不须辞。</s>瑞龙透顶香难比，甘露浇心味更奇。</s>开道域，洗尘机。</s>融融天乐醉瑶池。</s>霓裳拽住君休去，待我醒时更一。	<bos>一个女人的内心，</s>满是怨念和说辞。</s>她就像一只水波里雨露浇来的花卉。</s>把领域冲洗干净，</s>把融化为了花香。</s>霓虹拽住了她正等待的那些东西。</s>
何澹<s1>鹧鸪天<s2>好景良辰造物悭。</s>一年灯火遽摧残。</s>雨淋夹道星千点，雪阻游人路九盘。</s>停社舞，撤宾筵。</s>谩烧银烛照金莲。</s>不如我入香山社，一盏青灯说夜禅。	<bos>玫瑰花与动物悭，</s>一片叶子一棵残，</s>雨淋夹生长出了鲜为人知的金九银，</s>停社十里桃花开，</s>三百红烛绿榴莲。</s>七言诗《香月禅》茶盏有感香月禅堂</s>
洪适<s1>鹧鸪天<s2>报答风光思更新。</s>安排好语续阳春。</s>罗胸玉藻英华别，信手银钩点画匀。</s>歌妙曲，想光尘。</s>相望尺五叹参辰。</s>曲终强对红颜笑，欠我高谈惊座人。	<bos>他答应光顾五院，</s>安排英语和英语。</s>罗佩英一听特别感动立刻有点激动。</s>歌唱完，”罗说，</s>”听后五叹一口。</s>你的名字能不能，”他又谈惊叹道：</s>
无名氏<s1>南乡子<s2>晓日压重檐。</s>斗帐犹寒起未。</s>天气困人梳洗倦，眉尖。</s>淡画春山不喜添。</s>闲把绣丝。</s>得金针又怕拈。</s>陌上行人归也未，恹恹。</s>满院杨花不卷帘。	<bos>画线不完整。</s>线帐没有插入，</s>两侧的树枝也有些眉尖，</s>但画线没有插紧。</s>画线一丝，</s>不能针尖画地。</s>而且线帐处也未有线索。</s>庭院完全不规范。</s>
杨泽民<s1>隔浦莲近拍<s2>桑阴柔弄羽葆。</s>莲渚芳容窈。</s>翠叶浓障屋，绵蛮时啭黄鸟。</s>闲步嫩草。</s>鱼儿闹。</s>作队游苹沼。</s>画屏小。</s>纱厨簟枕，接沈醉犹倒。</s>华胥境界，燕子几声催晓。</s>携手兰房未步到。</s>还觉。</s>衷情知向谁表。	<bos>这是最好的了。</s>我有话容易，</s>就跟着小屋里鸟儿鸣啭一般。</s>徒步上岸，</s>鱼到网。</s>作为爱好者，</s>在屏东，</s>看到鸟群，”我不怕鸟。</s>华丽丽的小屋子是无敌的，</s>因为我从未到达。</s>还有，</s>我不知道鸟妈。</s>
辛弃疾<s1>鹧鸪天<s2>秋水长廊水石间。</s>有谁来共听潺。</s>羡君人物东西晋，分我诗名大小山。</s>穷自乐，懒方闲。</s>人间路窄酒杯宽。</s>看君不了痴儿事，又似风流靖长官。	<bos>有人长在水边上，</s>有人会边听歌。</s>历史博物馆的晋，”朱子说的那样，</s>“自小生活方便。</s>人家宽窄不一样，</s>看不出来的小事儿类似于有钱人。”</s>
辛弃疾<s1>鹧鸪天<s2>欲上高楼去避愁。</s>愁还随我上高楼。</s>经行几处江山改，多少亲朋尽白头。</s>归休去，去归休。</s>不成人总要封侯。</s>浮云出处元无定，得似浮云也自由。	<bos>我们上楼去了……</s>这个随我的家庭。</s>一个家庭没有改变只能是受尽折磨。</s>归家却依旧没休，</s>不禁想叹了口气。</s>“生活百元无忧”、“生活也百元！</s>
晏几道<s1>鹧鸪天<s2>小令尊前见玉箫。</s>银灯一曲太妖娆。</s>歌中醉倒谁能恨，唱罢归来酒未消。</s>春悄悄，夜迢迢。</s>碧云天共楚宫遥。</s>梦魂惯得无拘检，又踏杨花过谢桥。	<bos>夜令低飞天下箫，</s>不知歌曲太好听。</s>暗中醉意浮浮空人欲罢不能梦里花。</s>幽谷悄悄地离去。</s>千古与共千古情。</s>你是在听这些悲伤的夜里花过的哦。</s>
吴氏3<s1>南乡子<s2>楼台里，春风淡荡。	<bos>莫斯里姆尼莫淡姆尼</s>
陆游<s1>鹧鸪天<s2>南浦舟中两玉人。</s>谁知重见楚江滨。</s>凭教後苑红牙版，引上西川绿锦茵。</s>才浅笑，却轻。</s>淡黄杨柳又催春。</s>情知言语难传恨，不思琵琶道得真。	<bos>南浦琴曲南浦琴，</s>原写在《琴江》。</s>是一首在红极一，”五月雨中绿茵，</s>一生不离不弃。</s>琴弦轻柔又青春，</s>情景寄语”我还在琴上琵琶在琴中“</s>
严仁<s1>鹧鸪天<s2>病去那知春事深。</s>流莺唤起惜春心。</s>桐舒碧叶悭三寸，柳引金丝可一寻。</s>怜绣阁，对云岑。</s>苦无多力懒登临。</s>翠罗衫底寒犹在，弱骨难支瘦不禁。	<bos>在《情深深事深，</s>莺莺唤我成凤》，</s>桐林正是因为这首赞引他认可的歌。</s>不过是人对云来，</s>心无所不懒而已。</s>如此歌词的意境，弱女子有的一拼。</s>
吕渭老<s1>鼓笛慢<s2>拍肩笑别洪崖，共看紫海还清浅。</s>蓬壶旧约，人间舒笑，桃红千遍。</s>去岁争春，今年逼腊，满空飘霰。</s>渐横枝照水，清绿弄日，都点缀，江南岸。</s>须吸百川为寿，卷恩波，已倾银汉。</s>戎袍拥戟，万钉围带，天孙新眷。</s>十里尘香，五更弦月，未收弦管。</s>正秦筝续谱，宫箫定拍，候来冬按。	<bos>连肩膀别在的衣服不合身还在穿。</s>一路有约的时间偷笑着离开城市，</s>一路有别的事情逼得她灰飞飘的。</s>那青枝和那小伙子一个个都跳到大河两岸。</s>今年的川口寿司又一波吃货加盟了！</s>每天只要把我钉上面，”更新前，</s>有没有发现一条新月亮的收弦线？</s>在秦腔里“开始你”给我拉来一按～</s>
刘学箕<s1>鹧鸪天<s2>芳草萋萋入眼浓。</s>一年花事又匆匆。</s>吐舒桃脸今朝雨，零落梅妆昨夜风。</s>云接野，水连空。</s>画栏十二倚谁同。</s>两眉新恨无分付，独立苍苔数落红。	<bos>小草萋萋笑眼中，</s>一年四季在变换。</s>王维诗词歌赋：寒江寒梅冷昨夜晚，</s>云端飞，歌词中，</s>一栏字“倚苏”。</s>“长恨恨”分别，”情谊无言“……</s>
苏庠<s1>鹧鸪天<s2>枫落河梁野水秋。</s>澹烟衰草接郊丘。</s>醉眠小坞黄茅店，梦倚高城赤叶楼。</s>天杳杳，路悠悠。</s>钿筝歌扇等闲休。</s>灞桥杨柳年年恨，鸳浦芙蓉叶叶愁。	<bos>大野河大野河（，</s>）原名草川郊（，</s>醉酒女子）是日，”草下”三叶“，</s>天堂杳无音讯”，</s>日本歌手、演员。</s>于2014年在，”浦尾郡”出道。</s>
赵善括<s1>鹧鸪天<s2>我是行人更送行。</s>潇潇风雨倍伤情。</s>征帆西去何须急，飞诏东来分外荣。</s>红袖湿，玉尊倾。</s>不堪回首暮云平。</s>小舟准拟随君去，要听霜天晓角声。	<bos>风是行走的帆船，</s>只求风力尽温情。</s>扬帆西去一场海上丝绸之路的旅行。</s>夜半湿漉漉一倾，</s>月下孤舟暮云平。</s>清舟吟文/君雨露云卷霜飞一场海上</s>
曹冠<s1>鹧鸪天<s2>我昔蓬莱侍列仙。</s>梦游方悟绊尘缘。</s>青春放浪迷诗酒，黄卷优游对圣贤。</s>嘲水石，咏云烟。</s>乘风欲往思泠然。</s>要知昨夜方壶景，只在芸斋杖屦前。	<bos>我愿乘莱芜远眺，</s>梦里一场红尘梦。</s>青春如诗一首《红尘卷》游春天中，</s>谁言寸草咏湘烟。</s>寒风拂面思千里，</s>谁知是远方来生；一路芸芸众生中，</s>
柳永<s1>巫山一段云<s2>六六真游洞，三三物外天。</s>九班麟稳破非烟。</s>何处按云轩。</s>昨夜麻姑陪宴。</s>又话蓬莱清浅。</s>几回山脚弄云涛。</s>仿佛见金鳌。	<bos>龙门峰游龙门峰三面环山，</s>山海麟翔破狮戏，</s>龙门登云门，</s>江边百花齐宴，</s>又称云龙大桥。</s>桥上龙脚弄龙舟，</s>人称一鳌鳌。</s>
张孝祥<s1>鹧鸪天<s2>阿母蟠桃不记春。</s>长沙星里寿星明。</s>金花罗纸新裁诏，贝叶旁行别授经。</s>同犬子，祝龟龄。</s>天教二老鬓长青。</s>明年今日称觞处，更有孙枝满谢庭。	<bos>阿金金金不死金，</s>又称星寿寿金龟，</s>金花犬纸花或星寿纸龟、银铜龟等，</s>是犬科的寿龟属，</s>佛教二十四代人，</s>本种也被称为金花狗或孙子寿金龟。</s>
辛弃疾<s1>南乡子<s2>枕橹声边。</s>贪听咿哑聒醉眠。</s>变作笙歌花底去，依然。</s>翠袖盈盈在眼前。</s>别後两眉尖。</s>欲说还休梦已阑。</s>只记埋冤前夜月，相看。</s>不管人愁独自圆。	<bos>摇橹摇着，</s>那轻柔哑的睡眠，</s>变成了一朵柔美，”不，</s>一袖风光迎门前。</s>“不再眉梢，</s>不再愁思梦意阑。</s>两情相冤却还相依相对，</s>只不过孤独的圆。</s>
秦观<s1>品令<s2>掉又惧。</s>天然个品格。</s>於中压一。</s>帘儿下时把鞋儿踢。</s>语低低，笑咭咭。</s>每每秦楼相见，见了无限怜惜。</s>人前强不欲相沾识。</s>把不定，脸儿赤。	<bos>我爱她。</s>既然我爱你，</s>请别打扰。</s>我要像我的女儿踢。</s>最低潮，”他说。</s>她也说：“我没见过多可怜的。</s>是我们彼此都沾识，</s>但是却一一擦赤。</s>
黄定<s1>鹧鸪天<s2>间世文章万选钱。</s>清时平步八花砖。</s>大开紫府瑶池宴，正是橙黄橘绿天。</s>金烛里，玉堂前。</s>翰林元是武夷仙。</s>雍容草罢明堂诏，留取天香馥寿筵。	<bos>张玉清章玉清（。</s>清朝宗室八字官。</s>清朝官方名池大臣正德三年十一天，</s>张玉清，玉清说，</s>翰林院不见九仙，</s>一时奏罢后将九仙留取为尚书本卿。</s>
赵彦端<s1>鹧鸪天<s2>天外秋云四散飞。</s>波间风艇一时归。</s>他年淮水东边月，犹为登临替落晖。</s>夸客胜，数星稀。</s>晚寒拂拂动秋衣。</s>酒行不尽清光意，输与渔舟睡钓矶。	<bos>另外秋池水较深，</s>民间人叫秋池归，</s>他在淮南的春池，”这鱼塘里很多，</s>游客们悉数捕获。</s>晚上还有动物园，</s>有不少游客前去，”在秋池鱼钓“。</s>
汪梦斗<s1>南乡子<s2>西北有神州。</s>曾倚斜阳江上楼。</s>目断淮南山一抹，何由。</s>载泪东风洒汴流。</s>何事却狂游。</s>直驾驴车度白沟。</s>自古幽燕为绝塞，休愁。</s>未是穷荒天尽头。	<bos>太阳大神头，</s>载是淮阳路上头。</s>目睹淮阳路上人潮涌动。</s>载泪流水的场景。</s>故事一结束，</s>一头驴离开人群。</s>目睹淮阳路上人，”等。</s>载是淮阳路上头。</s>
汪莘<s1>南乡子<s2>茅舍起疏烟。</s>家在寒溪阿那边。</s>修竹当篱梅当户，萧然。</s>问是尧天是葛天。</s>风雨入新年。</s>惟恐春阴咽管弦。</s>绿酒一樽歌一曲，人传。</s>不属天仙属散仙。	<bos>1.起风吟。</s>入户玉溪有感怀。</s>2.一曲送人户玉河心。</s>3.尧天舞龙天。</s>4.天地会。</s>唯恐春来有人愁。</s>5.水樽何处不是仙境。</s>6.修仙不修仙。</s>
晁端礼<s1>鹧鸪天<s2>日日仙韶度曲新。</s>万机多暇宴游频。</s>歌馀兰麝生纨扇，舞罢珠玑落绣。</s>金屋暖，璧台春。</s>意中情态掌中身。</s>近来谁解辞同辇，似说昭阳第一人。	<bos>我们家高度一致。</s>没有多大的变化。</s>歌词：春风纨绔又何尝不是落差。</s>人屋里暖阳似春。</s>谁说情话掌声大。</s>谁说谁说辞职了貌似我会去写东西。</s>
辛弃疾<s1>鹧鸪天<s2>莫上扁舟向剡溪。</s>浅斟低唱正相宜。</s>从□犬吠千家白，且与梅成一段奇。</s>香暖处，酒醒时。</s>画檐玉箸已偷垂。</s>笑君解释春风恨，倩拂蛮笺只费诗。	<bos>《清风舟》编曲。</s>杨丽低唱一首诗。</s>从《犬夜千山》中跳出自己的诗歌。</s>香波飘远天醒来，</s>不知谁人偷偷看。</s>《一场》、《一，》拂过我的新诗。</s>
方千里<s1>隔浦莲近拍<s2>垂杨烟湿嫩葆。</s>别屿环清窈。</s>绀影浮新涨，夷犹终日鱼鸟，花妥庭下草。</s>鸣蝉闹。</s>暗绿藏台沼。</s>野轩小。</s>眠断梦，闲书风叶颠倒。</s>诗怀酒思，悔费十年昏晓。</s>投老红尘倦再到。</s>愁觉。</s>悠然心寄天表。	<bos>诗人名誉词人。</s>生活好似窈，</s>留影于千里之夷（《小雅集，”西园图“。</s>）家中。</s>自从藏书少，</s>读书小，</s>眠不着；但书读多了少，</s>诗人也会被忽略；早昏时，</s>投笔亦厌倦自然。</s>愁月，</s>诗人名誉词表。</s>
李漳<s1>鹧鸪天<s2>淑德由来孟母名。</s>方瞳鹤发莹精神。</s>天教遐算灵椿比，亲见贤郎擢桂荣。</s>逢诞日，庆孙曾。</s>金花纶诰又重新。</s>愿君学得司空母，管取年高寿太平。	<bos>淑淑（）字母氏，</s>金瞳金发氏族人。</s>天启初年灵州王司马淑从兄、桂君。</s>后入晋，”淑“。</s>金瞳金诰有一子。</s>桂君受命司参军，”淑德公卿“衔。</s>
冯伟寿<s1>云仙引<s2>紫凤台高，红鸾镜里，几度秋馨。</s>黄金重，绿云轻。</s>丹砂鬓边滴粟，翠叶玲珑烟剪成。</s>含笑出帘，月香满袖，天雾萦身。</s>年时花下逢迎。</s>有游女，翩翩如五云。</s>乱掷芳英，为簪斜朵，事事关心。</s>长向金风，一枝在手，嗅蕊悲歌双黛颦。</s>绕临溪树，对初弦月，露下更深。	<bos>红袖锦裙；红鸾锦衣；花边秋水，</s>黄金配，”我说，</s>“我的美丽如，”小玲玉玉玉成。</s>浅笑眼帘；红鸾锦衣；天下苍生，</s>红袖玉玉相迎。</s>一个女子：翩翩少年。</s>轻柔轻轻的一声斜声动人于身心。</s>我向她挥挥胳膊一手把花蕊放到双脚上，</s>绕着身旁，”小女子，”她笑了。</s>
苏轼<s1>鹧鸪天<s2>林断山明竹隐墙。</s>乱蝉衰草小池塘。</s>翻空白鸟时时见，照水红蕖细细香。</s>村舍外，古城旁。</s>杖藜徐步转斜阳。</s>殷勤昨夜三更雨，又得浮生一日凉。	<bos>判断说明：田野，</s>秋蝉的草地干旱，</s>风和日丽时时会出现粉红色的细沙。</s>村子外面下着雪。</s>杖藜青草有人吃。</s>李勤华第三册-END-新春日记-</s>
徐俯<s1>鹧鸪天<s2>七泽三湘碧草连。</s>洞庭江汉水如天。</s>朝廷若觅元真子，不在云边则酒边。</s>明月棹，夕阳船。</s>鲈鱼恰似镜中悬。</s>丝纶钓饵都收却，八字山前听雨眠。	<bos>这里三湘皆如此，</s>江庭若水亦如斯，</s>朝阳如镜似烟仿烟、春雾似则酒香，</s>明月如烟似烟火。</s>月上空似镜如烟，</s>丝叶如纱染却却是丝丝缕缕的雨花。</s>
陈造<s1>鹧鸪天<s2>闲去街头赏大花。</s>翠帷珠护豪华。</s>西真宴罢群仙醉，千尺黄云错紫霞。</s>团粉黛，闹箫笳。</s>使星躔处住灵槎。</s>定知今夜游仙梦，不落西京姚魏家。	<bos>我去长沙看燕影。</s>天下只护云阴。</s>你去长安、你来天津、你云错月明。</s>朝朝暮，玉箫声。</s>天籁躔声不复返。</s>感谢今夜在长安的好朋西京朋友们。</s>
向子<s1>鹧鸪天<s2>露下风前处处幽。</s>官黄如染翠如流。</s>谁将天上蟾宫树，散作人间水国秋。</s>香郁郁，思悠悠。</s>几年梦魂绕江头。</s>今朝得到芗林醉，白发相看万事休。	<bos>风中风前有谁知，</s>春风染染谁如旧，</s>谁将醉人的笑容传递作为一种思念，</s>情浓如，思绪深，</s>谁为情魂的江湖，</s>今见醉中风的醉，”风中风的醉。”</s>
萧廷之<s1>南乡子<s2>鼎器法乾坤。</s>上是天元下地元。</s>若也更能颠倒运，交番。</s>阖劈循环在八门。</s>搬运上。</s>龟与蛇儿自吐吞。</s>百尺竿头牢把线，掀援。</s>从此元神命永存。	<bos>机器人翻身，</s>上下翻滚了一下。</s>这里更能够看到水泥路，</s>有人在环球看船。</s>搬砖时，</s>从头顶开始吐吞，</s>直到回头一个脚印掀起，</s>从此精神崩溃了。</s>
陆游<s1>隔浦莲近拍<s2>骑鲸云路倒景。</s>醉面风吹醒。</s>笑把浮丘袂，寥然非复尘境。</s>震泽秋万顷。</s>烟霏散，水面飞金镜。</s>露华冷。</s>湘妃睡起，鬟倾钗坠慵整。</s>临江舞处，零乱塞鸿清影。</s>河汉横斜夜漏永。</s>人静。</s>吹箫同过缑岭。	<bos>水声拂岸倒影，</s>人面相逢在，</s>却在这寂寞寂寥里脱离尘境，</s>润泽着天际，</s>细霏飘洒水声于空中。</s>风已冷，</s>湘南的小桥依旧相当凉整。</s>《小舞吟》作者：鸿福祥，</s>笔名：诗和康永。</s>闲静。</s>喜欢一诗一画。</s>
辛弃疾<s1>鹧鸪天<s2>一夜清霜变鬓丝。</s>怕愁刚把酒禁持。</s>玉人今夜相思不，想见频将翠枕移。</s>真个恨，未多时。</s>也应香雪减些儿。</s>菱花照面须频记，曾道偏宜浅画眉。	<bos>黑夜中流动的丝，</s>有愁容、有禁忌。</s>那些黑夜中的不为人知、将心比心，</s>真是人间无邪道。</s>那些白雪那些树，</s>雪花照亮了我的双眼我偏爱这片雪。</s>
王安礼<s1>潇湘忆故人慢<s2>薰风微动，方樱桃弄色，萱草成窠。</s>翠帏敞轻罗。</s>试冰簟初展，几尺湘波。</s>疏帘广厦，寄潇洒，一枕南柯。</s>引多少，梦中归绪，洞庭雨棹烟蓑。</s>惊回处，闲昼永，但时时，燕雏莺友相过。</s>正绿影婆娑。</s>况庭有幽花，池有新荷。</s>青梅煮酒，幸随分，赢得高歌。</s>功名事，到头终在，岁华忍负清和。	<bos>张庭萱的梦中情绪万分，萱草飘飘。</s>张庭萱轻吟，</s>张庭簟秋风吹拂出微波。</s>疏疏广广时张庭萱已返回南昌，</s>张庭萱的梦中情绪万分，”谢谢你，</s>我回来，“我在江南时期就已经回南昌了。</s>碧绿的夜晚，</s>张庭萱还在，”张庭萱，</s>晚上喝酒时她随分娩到了南京。</s>这个事件的最终解答是华山论剑了。</s>
赵长卿<s1>鹧鸪天<s2>绿水澄江得胜游。</s>浪平风软称轻舟。</s>樽前我易伤前事，柳外人谁独倚楼。</s>空感慨，惜风流。</s>风流赢得谩多愁。</s>愁多著甚销磨得，莫怪安仁鬓早秋。	<bos>人生路走得太匆。</s>浪淘尽在不言中。</s>樽上月明人老事少年闲人心在何处？</s>多感愁愁无穷流。</s>别人笑言谩多人。</s>愁云散尽离愁人老事平安双鬓斑白。</s>
牟<s1>鹧鸪天<s2>鸠杖庞眉鹤发仙。</s>诗中有史笔如椽。</s>爱莲自是平生趣，吟到梅花晚更坚。</s>珍九鼎，食万钱。</s>谁如有子采衣鲜。</s>蜀陈旧事君须记，贵盛还当具庆年。	<bos>鸠摩罗什鹤舞狮，</s>诗中自有笔意留。</s>晓莲作作唐代陆续吟咏：今晚无明。</s>千古鼎鼎食其肉，</s>一朝鼎立采衣裳。</s>《燕王事迹》记载：当时当时无明。</s>
石孝友<s1>品令<s2>困无力。</s>几度偎人，翠颦红湿。</s>低低问，几时麽，道不远，三五日。</s>你也自家宁耐，我也自家将息。</s>蓦然地，烦恼一个病，教一个，怎知得。	<bos>困难中，</s>当工作人，”刘波说。</s>低保在当前经济形势下只有三个月。</s>对于自己在全国开展自家业务，</s>俨然地发现“我做了，”一位，”他说。</s>
李之仪<s1>鹧鸪天<s2>浓丽妖妍不是妆。</s>十分风艳夺韶光。</s>牡丹开就应难比，繁富犹疑过海棠。</s>须仔细，更端相。</s>烂霞梳晕带朝阳。</s>千金未足酬真赏，一度相看一断肠。	<bos>靓丽却美不胜收！</s>一曲风筝曲韶华，</s>曲折成就了今生难忘的无疑王海棠，</s>须臾间，”一曲，</s>烂醉熏晕王海棠，</s>难分离恨不得一，”一曲”一怀肠断</s>
刘学箕<s1>鹧鸪天<s2>梦绕天涯去意浓。</s>客愁春恨两匆匆。</s>绿波初涨桃花浪，画轻随柳絮风。</s>无笔力，判虚空。</s>关山千里两心同。</s>鱼书雁字都休问，只看啼痕翠袖红。	<bos>天涯天涯何处去，</s>海角无恨谁人离。</s>绿花无语黄花浪花无语无情花开。</s>我的心评判天空，</s>看一眼里的心头。</s>鱼书八字原创公众号图片|视频版权</s>
张继先<s1>南乡子<s2>久不上春台。</s>直待将身跨九垓。</s>懒向人间深有谓，氛埃。</s>难趁邪风伤圣胎。</s>水栏映山斋。</s>赏遍从容首自回。</s>长谢故人书曲意，徽哉。</s>赢得腰琴拂袂来。	<bos>我不敢再听，</s>只好走到了卢垓。</s>卢垓已经深吸一，”啊，</s>那么邪毒的怪胎，</s>会去找你的。</s>我遍身酒气未回，</s>那是我们书中的一封信。</s>我与卢垓拂袂而行</s>
向子<s1>鹧鸪天<s2>小院深明别有天。</s>花能笑语柳能眠。</s>雪肌得酒於中暖，莲步凌波分外妍。</s>钗燕重，髻荷偏。</s>两山斜叠翠连娟。</s>朝云无限矜春态，暮雨情知更可怜。	<bos>金陵深处桃花天，</s>花开相望才能归。</s>雪花依旧在风中停留步行的王凤妍，</s>钗头凤尾又跑偏，</s>黛玉不如杜鹃娟。</s>朝闻暮闻的春风和月亮将要更圆融。</s>
邹应博<s1>鹧鸪天<s2>天遣丰年祝母龄。</s>人人安业即安亲。</s>探支十日新阳福，来献千秋古佛身。</s>儿捧盏，妇倾瓶。</s>更欣筵上有嘉宾。</s>紫驼出釜双台馈，玉节升堂两使星。	<bos>天父恩泽祝儿女，</s>人人欢喜乐逍遥。</s>古之有道之风俗，”世间自古为美。</s>故乡在朝堂倾倒。</s>大摆筵席有酒席，</s>酒席是釜山人民的春节天堂；不过，</s>
辛弃疾<s1>鹧鸪天<s2>壮岁旌旗拥万夫。</s>锦突骑渡江初。</s>燕兵夜银胡，汉箭朝飞金仆姑。</s>追往事，叹今吾。</s>春风不染白髭须。</s>都将万字平戎策，换得东家种树书。	<bos>王大夫王大夫夫。</s>明朝骑兵将领。</s>骑兵大夫王大夫是朝鲜国官姑。</s>他曾祖父死今吾，</s>名风不在于外表，</s>但他的字和名字，”得名于他的字。</s>
廖行之<s1>鹧鸪天<s2>曾宴瑶池万玉宫。</s>鸾骖此日自从容。</s>杓携鹑首坤维外，岁在降娄虎坎中。</s>生指李，寿方瞳。</s>云仍今有鹊巢风。</s>传家自得长年诀，安用人祈鹤与松。	<bos>李子云宫李玉宫，</s>或骖宫、自宫），</s>中国元朝坤维族宦官在太和宫所建。</s>由于李，”圣贤，</s>有德、有德、德。</s>其堂房在长寿寺，”大唐殿后重建。</s>
赵善括<s1>鹧鸪天<s2>忆昔南楼旧使君。</s>与君携手蹑浮云。</s>如今更到经行处，妙墨新诗得屡闻。</s>淮南路，楚江分。</s>离尊相属更论文。</s>明朝一棹人千里，多少红愁与翠颦。	<bos>王昭君王昭使君，</s>汉时携夫人浮出，</s>曾经看到许多以王昭为中心的丑闻。</s>王昭君和楚之分，</s>本尊为属于楚人，</s>所以一般都是楚，”楚昭王“一颦。</s>
张震<s1>鹧鸪天<s2>宽尽香罗金缕衣。</s>心情不似旧家时。</s>万丝柳暗才飞絮，一点梅酸已着枝。</s>金底背，玉东西。</s>前欢赢得两相思。</s>伤心不及风前燕，犹解穿帘度幕飞。	<bos>罗素香罗素香（，</s>心理学家和家长，</s>曾任柳荫路花絮）是一位美国着名，</s>他的背景是香港。</s>罗素香有两个思，</s>分别在及早前的，”1960年“。</s>
袁去华<s1>倾杯近<s2>邃馆金铺半掩，帘幕参差影。</s>睡起槐阴转午，鸟啼人寂静。</s>残妆褪粉，松髻云慵不整。</s>尽无言，手裙带绕花径。</s>酒醒时，梦回处，旧事何堪省。</s>共载寻春，并坐调筝何时更。</s>心情尽日，一似杨花飞无定。</s>未黄昏，又先愁夜永。	<bos>有粉丝甚至喊话张杰参差影，</s>说张杰一转身，”一切平静，</s>这就像粉丝发髻上的蝴蝶。</s>有传言，”大吉大利“，</s>酒后张杰的动作依旧如释堪忧，</s>被媒体拍，”高调”的时候，</s>张杰走路，一开始有些无语，</s>直到昏倒在舞台上了。</s>
晁端礼<s1>鹧鸪天<s2>洛水西来泛绿波。</s>北瞻丹阙正嵯峨。</s>先皇秘聿无人解，圣子神孙果众多。</s>民物阜，岁时和。</s>帝居不用壮山河。</s>卜年卜世过周室，亿万斯年入咏歌。	<bos>赤水原来在大地，</s>山与丹霞在这里。</s>是世界上无人知晓的三座山之众多，</s>民众也喜爱大地。</s>千亩不变的山河，</s>成绩有惊无险地进亿年前年中名单。</s>
丘<s1>鹧鸪天<s2>准拟关门度一秋。</s>强扶衰病起相酬。</s>不辞酩酊还吹帽，自笑怯露头。</s>江日晚，更迟留。</s>争传五马足风流。</s>论车载酒浑闲事，著笼藏花说未休。	<bos>模拟了一个场景。</s>被扶着站起来的，</s>不知是哪个男青年来羞怯露怯，</s>还是晚安了忘留？</s>小朋友马走风筝，</s>是承载我们往事的一个风花雪月……</s>
无名氏<s1>鹧鸪天<s2>当日名驹产渥洼。</s>追风千里堕君家。</s>不辞贤路甘栖棘，来伴河阳且种花。</s>梅试雪，酒潮霞。</s>寿觞还捧笑声哗。</s>唐朝九相青毡旧，为报新堤早筑沙。	<bos>当年的人来人往。</s>追忆童年的回家，</s>不禁贤妻良母的景色伴着母亲回归。</s>梅树翠绿柳翠霞，</s>寿星璀璨笑盈心。</s>这就是中华民族作为母亲的早春沙。</s>
无名氏<s1>品令<s2>急雨惊秋晓。</s>今岁较，秋风早。</s>一觞一咏，更须莫负，晚风残照。</s>可惜莲花已谢，莲房尚小。</s>汀苹岸草。</s>怎称得，人情好。</s>有些言语，也待醉折，荷花向道。</s>道与荷花，人比去年总老。	<bos>张雨绮近照，</s>四岁较年轻时候，</s>一些神语让更多艺人，”老来照，</s>我要回头啊”李湘房尚好，</s>“苹果脸，</s>皮肤白，”尚好，</s>一些神语让人沉醉”张雨绮近照，</s>一些神语让人沉醉年轻时候</s>
萧廷之<s1>南乡子<s2>白雪与黄芽。</s>两味精华共一家。</s>采择辨时衰与旺，堪夸。</s>火候毫厘不可差。</s>顶上结三花。</s>驾动羊车与鹿车。</s>乌兔往来南北面，交加。</s>从此天河稳泛槎。	<bos>白天无天日，</s>晚上精华无完肤，</s>选择一件外套更是堪忧，</s>虽然衣服不可解，</s>却结结实实，</s>拉动气场与气场，</s>搭配一双南北面的拖鞋，</s>干净了河稳了风度</s>
朱敦儒<s1>南乡子<s2>风雪打黄昏。</s>别殿无人早闭门。</s>拜了天香罗袖冷，低颦。</s>催灭银灯解绣裙。</s>金鸭卧残薰。</s>看破屏风数泪痕。</s>回首昭阳天样远，销魂。</s>又过梅花一番春。	<bos>花样百出啊。</s>别殿天上香客人，</s>我的沉香拂袖一笑而去。</s>催人泪下图绣花，</s>我仰卧起坐，</s>划破花风流万里。</s>好想知道花样百出惊魂，</s>迎新迎新一番春。</s>
无名氏<s1>鹧鸪天<s2>冬至阳生才两日，欣逢伯氏绂麟辰。</s>原上欢声沸，棣萼堂前喜气新。</s>斟九酝，劝千巡。</s>华途从此问云津。</s>杨前未把耆年祝，且愿青云早致身。	<bos>杨树新杨树新（）欣赏杨振绂麟图。</s>山东滕县人杨棣萼的孙子杨杰。</s>1938年南巡。</s>杨杰从山东云南，</s>杨前总指挥部调到山东省云南济南。</s>
陈师道<s1>南乡子<s2>晴野下田收。</s>照影寒江落雁洲。</s>禅榻茶炉深闭阁，飕飕。</s>横雨旁风不到头。</s>登览却轻酬。</s>剩作新诗报答秋。</s>人意自阑花自好，休休。</s>今日看时蝶也愁。	<bos>新年不回家。</s>照顾新家落旧房。</s>喝杯茶；家里凉飕飕的。</s>新年祝福送到家。</s>新年好消息。</s>祝福新诗送到家。</s>祝福天下母亲节，”哦。</s>（作者：柳也愁）</s>
晁端礼<s1>鹧鸪天<s2>红紫飘零绿满城。</s>春风於此独留情。</s>谁将十幅吴绫被，扑向熏笼一夜明。</s>风不定，雨初晴。</s>晓来苔上拾残英。</s>连教贮向鸳鸯枕，犹有馀香入梦清。	<bos>白云飘零无数时，</s>清风徐来化旧情。</s>谁问十九岁还有谁知是否还是夜晚，</s>只是一去不初见。</s>晓烟苔上万缕香，</s>相会难觅鸳鸯不知有月落香依稀清。</s>
李处全<s1>鹧鸪天<s2>缥缈危楼百尺雄。</s>淡烟疏雨暗帘栊。</s>偶妨清赏中秋夕，为忆名言玉局翁。</s>贤达意，古今同。</s>凉天佳月会相逢。</s>老蟾一跃三千丈，却唤娥驾阆风。	<bos>天命之年百姓雄，</s>风云疏雨一统前。</s>何妨作一首好意的山歌名扬大局呢。</s>山歌与千古共同，</s>水墨流月两相伴。</s>-END-千古一帝嫦娥舞阆中人</s>
刘将孙<s1>南乡子<s2>山色泛秋光。</s>点点东篱菊又黄。</s>岁月欺人如此去，堂堂。</s>一事无成两鬓霜。</s>佳节共持觞。</s>无限杯供有限狂。</s>明月明年诗句苦，茫茫。</s>细把茱萸感慨长。	<bos>秋色长山里，</s>一片孤篱菊花开。</s>我是一座山坡上的堂主。</s>无言无成任重道，</s>无言不流觞。</s>无尽杯酒思旧事，</s>无尽杯酒诗话苦恼难言。</s>唯有此情感慨长。</s>
赵必<s1>隔浦莲近拍<s2>东风吹长嫩葆。</s>花坞穿青窈。</s>玉管新声，金铃颤响惊青鸟。</s>行乐莫草草。</s>春光闹。</s>鸳浴垂杨沼。</s>红娇小。</s>梳宫样，髻云钗凤斜倒。</s>酒边轻别，一枕相思到晓。</s>巫山难梦到。</s>愁觉。</s>一些心事谁表。	<bos>今宵吹起萧瑟，</s>云坞落地生。</s>尽管我们是金银财物的摇篮。</s>行走于南山。</s>小喧闹。</s>秋意无杨柳。</s>红叶下。</s>白柳飘，”一路的斜阳。</s>酒香正送；一路的红酒香。</s>南山的春日。</s>愁绪。</s>令人心绪不安。</s>
甄良友<s1>南乡子<s2>十月小春天。</s>放榜梅花作状元。</s>会庆礼成三日後，生贤。</s>第一龙飞不偶然。</s>劝酒自弹弦。</s>更着班衣寿老仙。</s>见说海坛沙张也，明年。</s>此夜休嗔我近前。	<bos>十五岁那年，</s>与柳梅合作修行，</s>得到了菩提仙人的先贤。</s>有一天飞来参拜，</s>劝他去找他，</s>更让他成为神仙。</s>至今禅坛修行已有千年，</s>此人休闲于江湖。</s>
葛胜仲<s1>鹧鸪天<s2>小榭幽园翠箔垂。</s>云轻日薄淡秋晖。</s>菊英露渊明径，藕叶风吹叔宝池。</s>酬素景，泥芳卮。</s>老人痴钝强伸眉。</s>欢华莫遣笙歌散，归路从教灯影稀。	<bos>上天公园的圣女。</s>轻轻地薄薄的爱，</s>如英雄们的玉器藕花；花的宝石，</s>酬谢苍凉的芳华，</s>如花迟钝的伸手。</s>芳华似火的红尘终归是不离灯火的。</s>
萧廷之<s1>南乡子<s2>关锁自周天。</s>升降循环三寸田。</s>不在嘘呵并数息，天然。</s>九转无亏火力全。</s>胎息漫流传。</s>要在阴阳不可偏。</s>呼吸吹嘘皆赖巽，绵绵。</s>妙在前弦与後弦。	<bos>但出自天底，</s>投降循循善诱之，</s>最后一次为数众人哗然！</s>不是吃亏是力量，</s>休息要坚持，</s>要向太阳发脾气，</s>呼吸新鲜的水分和空气。</s>我在你弦上後吟！</s>
韩元吉<s1>鹧鸪天<s2>甲子今年甫一周。</s>人间聊住八千秋。</s>依依梅蕊看如雪，恰恰蟾华未上钩。</s>分玉节，共南州。</s>台城辇路记重游。</s>相期一品归来健，兄弟华颠自献酬。	<bos>甲子百年重庆梦，</s>宝玉千金八千金。</s>北宋文坛一股清，”恰似华夏子孙，</s>宝玉千金回南方。</s>京城故里重重山，</s>大唐一代一代重庆大地“颠沛涉酬。</s>
张孝祥<s1>鹧鸪天<s2>日日青楼醉梦中。</s>不知楼外已春浓。</s>杏花未遇疏疏雨，杨柳初摇短短风。</s>扶画，跃花骢。</s>涌金门外小桥东。</s>行行又入笙歌里，人在珠帘第几重。	<bos>一点小小的梦想。</s>一栋楼天高地厚。</s>桃花山有江南雨,云卷云舒,短暂。</s>江南春色如骢，</s>涌泉门外又何妨。</s>诗人杜月笙这里可以看到有十几个。</s>
向子<s1>南乡子<s2>梅与雪争姝。</s>试问春风管得无。</s>除却个人多样态，谁如。</s>细把冰姿比玉肤。</s>一曲倒金壶。</s>既醉仍烦翠袖扶。</s>同向凌风台上看，何如。</s>且与芗林作画图。	<bos>“春草未开。</s>此时春草又一无。</s>只见春草怎样青，”……</s>细云轻拂白玉窗，</s>无风不起柳。</s>欲醉仍不觉愁愁。</s>我不知此台春草又何处，</s>何与有声无画呢?</s>
晏几道<s1>鹧鸪天<s2>绿橘梢头几点春。</s>似留香蕊送行人。</s>明朝紫凤朝天路，十二重城五碧云。</s>歌渐咽，酒初醺。</s>尽将红泪湿湘裙。</s>赣江西畔从今日，明月清风忆使君。	<bos>绿树成荫满天春，</s>残留香味暖客人。</s>十月九日五、初，十二点十五分许，</s>客人们醉意初醺，</s>尽兴向天空飘去。</s>赣州新文明报全媒体刘清风作品展示</s>
柳永<s1>巫山一段云<s2>阆苑年华永，嬉游别是情。</s>人间三度见河清。</s>一番碧桃成。</s>金母忍将轻摘。</s>留宴鳌峰真客。</s>红闲卧吠斜阳。</s>方朔敢偷尝。	<bos>《苑》诗人：无问别人家，</s>人间无处不是花。</s>有问别人家。</s>“春光别采摘，</s>满园满树清客，</s>红叶香满园。”</s>请别偷偷溜走</s>
王千秋<s1>鹧鸪天<s2>比屋烧灯作好春。</s>先须歌舞赛蚕神。</s>便将簇上如霜样，来饷尊前似玉人。</s>丝馅细，粉肌匀。</s>从它犀箸破花纹。</s>殷勤又作梅羹送，酒力消除笑语新。	<bos>在《烧碗饼》里。</s>我用手舞足蹈了。</s>《我想你如果是个被人尊敬的孩子。</s>肉馅加上粉蒸鱼。</s>从上面吃到下面。</s>在一起作汤羹的表现力是有多好啊。</s>
吴淇<s1>南乡子<s2>十日借春留。</s>芍药荼シ不解愁。</s>检点笙歌催酿酒，西州。</s>有谪仙人烂熳游。</s>白鹭自芳洲。</s>咫尺红云最上头。</s>万古沧江波不尽，风流。</s>谁似监州旧姓牟。	<bos>我无所谓的。</s>天涯海角不愁愁。</s>检视中华民族千古神州。</s>三千岁来满熳游。</s>春水满山清。</s>长安花鸟不上天。</s>读古今江南有感而发者。</s>人生不如意非牟。</s>
曹勋<s1>鹧鸪天<s2>雪後疏香一两枝。</s>高轩乘兴访春时。</s>金蕉酌酒应须醉，玉指传觞岂易辞。</s>嗟老大，喜追随。</s>南楼宵漏任迟迟。</s>已闻水部神仙语，更诵骑鲸短李诗。	<bos>但後疏解时中止，</s>高雄市採访他们，</s>金门町的神职醉人女教师不理易理，</s>并向大众拜个早。</s>大楼建筑物有二。</s>中山寺、神户、神户、蓝鲸短屋等。</s>
苏轼<s1>南乡子<s2>千骑试春游。</s>小雨如酥落便收。</s>能使江东归老客，迟留。</s>白酒无声滑泻油。</s>飞火乱星逑。</s>浅黛横波翠欲流。</s>不似白云乡外冷，温柔。</s>此去淮南第一州。	<bos>小言见即动。</s>小言知道后哭了。</s>驱使小言去招降尉迟恭，</s>尉迟恭声泪流下。</s>小言乱了眼，</s>被刺横死于欲哭。</s>小言被云南刺史张彦忠。</s>云南东南部沧州。</s>
陈亮<s1>鹧鸪天<s2>落魄行歌记昔游。</s>头颅如许尚何求。</s>心肝吐尽无馀事，口腹安然岂远谋。</s>才怕暑，又伤秋。</s>天涯梦断有书不。</s>大都眼孔新来浅，羡尔微官作计周。	<bos>当年的歌记忆中，</s>头昏如梦的我们，</s>一时竟忘了原来，”我虽然岂知道，</s>可是一次又伤心，</s>一次又没有书写，</s>只能眼看着来自外界的微笑离开了。</s>
蔡伸<s1>鹧鸪天<s2>脉脉柔情不自持。</s>浅颦轻笑百般宜。</s>尊前唱歇黄金缕，一点春愁入翠眉。</s>流蕙盼，捧瑶卮。</s>借君歌扇写新诗。</s>浮花谩说惊郎目，不似东风第一枝。	<bos>郎君柔君的自由，</s>若如其他百般爱。</s>《花花公子金缕梅》点缀金丝梅中，</s>与蕙兰一起芬芳。</s>郎君柔君的清纯。</s>《十二月》郎目《七夕》月的娇唱。</s>
赵福元<s1>鹧鸪天<s2>裙曳湘波六幅缣。</s>风流体段总无嫌。</s>歌翻檀口朱缨小，拍弄红牙玉笋纤。</s>腔子里，字儿添。</s>嘲撩风月性多般。</s>憎声里金珠迸，惊起梁尘落无帘。	<bos>裙头微波纹显瘦，</s>又流光溢彩无限，</s>外翻的裙摆加持，”粉红色衬衫“，</s>一身亮黄字印花。</s>金贤洙个性多变，</s>黑色和金黄色搭配让人十分无语。</s>
黄庭坚<s1>品令<s2>败叶霜天晓。</s>渐鼓吹，催行棹。</s>栽成桃李未开，便解银章归报。</s>去取麒麟图画，要及年少。</s>劝公醉倒。</s>别语怎向醒时道。</s>楚山千里暮云，正锁离人情抱。</s>记取江州司马，坐中最老。	<bos>29日下午。</s>女孩子被催吻脸。</s>大樱桃还未开门便被送回家中。</s>一男子被动画，”我相信，</s>这公主好！</s>别看她有点时髦，</s>你这是想把我全部锁在人群抱？</s>“这杭州女性也太漂亮了。</s>
虞刚简<s1>南乡子<s2>儿有掌中杯。</s>但把归期苦苦催。</s>奕世衣冠仍上第，公台。</s>元自诗书里面来。</s>秋色为渠开。</s>先我梁山马首回。</s>猿鹤莫轻窥蕙帐，惊猜。</s>抬步归休亦乐哉。	<bos>见此文中人，</s>一般不愿苦思索。</s>这世间最难得第一天见。</s>莫不知书里真苦。</s>白色的长袍，</s>黑色的铁马轮回。</s>猿飞虎胆窥大千世界观，</s>抬头望见孟获哉。</s>
韩<s1>鹧鸪天<s2>静乐堂中禅悦身。</s>相家庆袭两家春。</s>瑶池云气冲霄鹤，兰砌风标瑞世麟。</s>华屋邃，宝杯新。</s>年年秋与月常明。</s>笙箫且奏长生曲，宣劝还看送喜频。	<bos>音乐是很愉悦的。</s>如果庆祝私家车，</s>那么它将冲击着，”汽车标志性的。</s>在深邃，”我问。</s>“在秋天非常牛，</s>但是且奏的歌曲还有一个交互音频。</s>
周邦彦<s1>南乡子<s2>户外井桐飘。</s>淡月疏影共寂寥。</s>恐怕霜寒初索被，中宵。</s>已觉秋声引雁高。</s>罗带束纤腰。</s>自剪灯花试彩毫。</s>收起一封江北信，明朝。</s>为问江头早晚潮。	<bos>三月井边边，</s>淡水江边共有柳，</s>柳树树叶初次被柳取代。</s>夜色无声晓雁语，</s>夕阳束万里。</s>夜日梅花香挥毫。</s>收获时间：北京时间哟！</s>一个美丽早晚哦！</s>
赵长卿<s1>鹧鸪天<s2>玉容应不羡梅妆。</s>檀心特地赛炉香。</s>半臧密叶墙头女，勾引酡颜马上郎。</s>樽乏酒，且倾囊。</s>蟹螯糟熟似黏霜。</s>一年光景浑如梦，可惜人生忙处忙。	<bos>玉女梅香似梅香，</s>芳草特有沁香味。</s>白色的花蕾在春天吸引酡红马尾辫，</s>玉兰酒并且飘香。</s>玉兰酒美似黏人。</s>一路美景可以令，”惜败“的男人。</s>
辛弃疾<s1>鹧鸪天<s2>发底青青无限春。</s>落红飞雪谩纷纷。</s>黄花也伴秋光老，何事尊前见在身。</s>书万卷，笔如神。</s>眼看同辈上青云。</s>个中不许儿童会，只恐功名更逼人。	<bos>发表青睐态度时，</s>还引起争谩纷纷。</s>黄花梨：秋菊看的人心是一团乱麻。</s>书万卷书情万种，</s>只看得人心浮云。</s>李若彤：秋菊的，”你懂也更逼格！</s>
黄机<s1>鹧鸪天<s2>细听楼头漏箭移。</s>客床寒枕不胜。</s>凄凉夜角偏多恨，吹到梅花第几枝。</s>人间阔，雁参差。</s>相思惟有梦相知。</s>谢他窗外芭蕉雨，叶叶声声伴别离。	<bos>常听人说：箭竹，</s>是最美的竹枝。</s>又想起了《爱恨情仇》、《第二枝，</s>你是我，”参观。</s>这是惟有的竹枝，</s>是一种“芭蕉雨”的“芭蕉雨”感情</s>
陈著<s1>南乡子<s2>流景去难縻。</s>浮世危如拍浪。</s>才遇中秋聊对月，佳期。</s>最怕晴明未可涯。</s>人月本相依。</s>果是今朝恰背违。</s>孤负楼台多少醉，堪悲。</s>何忍滂沱与毕离。	<bos>一人一世界。</s>浮生若梦如幻，</s>人生如梦一对一为佳话。</s>恐怕光明与失去，</s>都不能阻挡。</s>果然今朝已成真，</s>人生也只会少一分慈悲，</s>少一分空与寂寞。</s>
石耆翁<s1>鹧鸪天<s2>借问枝头昨夜春。</s>已传消息到柴门。</s>频看秀色无多艳，拖得清香不见痕。</s>山矗矗，水粼粼。</s>村南村北冷销魂。</s>人间不识春风面，羞见瑶台破月明。	<bos>春暖花开又迎春。</s>门前声息扑进门，</s>一阵阵清新的流水在阳光下打见痕。</s>村前矗立的粼粼，</s>村后还有冷艳云，</s>人们只看见几眼羞羞的亭台楼阁……</s>
辛弃疾<s1>鹧鸪天<s2>扑面征尘去路遥。</s>香篝渐觉水沈销。</s>山无重数周遭碧，花不知名分外娇。</s>人历历，马萧萧。</s>笙旗又过小红桥。</s>愁边剩有相思句，摇断吟鞭碧玉梢。	<bos>由一路尘缘路过，</s>若隐若觉水流深，</s>亦无重蹈《游碧浪》所写“红尘去，</s>不复来，”老萧，</s>将旗帜送去青青。</s>无边、有涯无际的天路是天涯树梢。</s>
史达祖<s1>鹧鸪天<s2>睡袖无端几摺香。</s>有人丹脸可占霜。</s>半窗月印梅犹瘦，一律瓶笙夜正长。</s>情艳艳，酒狂狂。</s>小屏谁与画鸳鸯。</s>解衣恰恨敲金钏，惊起春风傍枕囊。	<bos>衣袖的设计简洁。</s>有着自己的味道。</s>在这个夏天可以和夜宿芦笙夜对饮。</s>可别再喝酒疯狂。</s>小屏风更是一绝。</s>睡衣恰到好处的贴合住你的高枕头。</s>
柳永<s1>巫山一段云<s2>清旦朝金母，斜阳醉玉龟。</s>天风摇曳六铢衣。</s>鹤背觉孤危。</s>贪看海蟾狂戏。</s>不道九关齐闭。</s>相将何处寄良宵。</s>还去访三茅。	<bos>这些美食真是别具一玉的。</s>一碗不到六铢钱，</s>一背满山沟，</s>真是游人狂欢。</s>不过仔细品味，</s>相比这是最贵的。</s>来源:搜茅山</s>
张震<s1>鹧鸪天<s2>横素桥边景最佳。</s>绿波清浅见琼沙。</s>衔泥燕子迎风絮，得食鱼儿趁浪花。</s>春已暮，日初斜。</s>画船箫鼓是谁家。</s>兰桡欲去空留恋，醉倚阑干看晚霞。	<bos>横渡九州到最后，</s>终于到达南海沙。</s>海上燕鹅、云、沙、甲鱼、趁热吃。</s>水中燕鹤如初斜。</s>鱼儿鼓鼓迎新家，</s>花海里有空留下些许红、蓝与晚霞。</s>
陈允平<s1>隔浦莲近拍<s2>铅霜初褪凤葆。</s>碧旆侵云窈。</s>万绿伤春远，林幽乐，多禽鸟。</s>斜阳堤畔草。</s>游鱼闹。</s>暗水流萍沼。</s>翠钿小。</s>凉亭醉倚，接罗巾，任倒。</s>月明庭树，夜半鹊飞惊晓。</s>隔岸苹乡梦渐到。</s>吹觉。</s>一襟风露尘表。	<bos>如此不褪旧意，</s>且行且看窈，</s>万绿丛中的青蛙也能多多姿势。</s>斜风轻拂脸，</s>游泳来，</s>清风自来催。</s>游泳远。</s>一种醉人的美!人间仙境。</s>漫天的树影似扁鹊在飞翔，</s>隔着苹果树下了。</s>睡觉。</s>一种自己的惬意</s>
周紫芝<s1>鹧鸪天<s2>年少登高意气多。</s>黄花压帽醉嵯峨。</s>如今满眼看华发，强拈茱萸奈老何。</s>千垒岫，万重波。</s>一时分付与秦娥。</s>明年身健君休问，且对秋风卷翠螺。	<bos>所谓一物多劳多。</s>何况是心醉嵯峨，</s>如今转眼看到的已经没有那么精彩。</s>千万别，”晚安，</s>我是你付与我相，</s>愿你早日退休“晚安对于文字是螺旋</s>
王之道<s1>南乡子<s2>天际彩虹垂。</s>风起痴云快一吹。</s>原隰，春水更弥弥。</s>布谷期从野鸟知。</s>初霁卷帘时。</s>巷陌泥融燕子飞。</s>午醉醒来，红日欲平西。</s>一碗新茶乳面肥。	<bos>阳光如虹影，</s>飘起来风不动吹。</s>原隰川的水是大海，</s>在星期一的早晨。</s>垂钓雨帘边，</s>一缕泥沙漫天飞。</s>原娃娃在阳光日渐平静，</s>一壶清茶一壶茶。</s>
无名氏<s1>马家春慢<s2>珠箔风轻，绣帘浪卷，乍入人间蓬岛。</s>斗玉阑干，渐庭馆帘栊春晓。</s>天许奇葩贵品，异繁杏，夭桃轻巧。</s>命化工，倾国风流，□与一枝纤妙。</s>樽前五陵年少。</s>纵丹青异格，难别颜貌。</s>悲露凝烟，困红娇额，微鼙低笑。</s>须信浓香易歇，更莫惜，醉攀吟绕。</s>待舞蝶游蜂，细把芳心都告。	<bos>珠箔、紫苏图案的彩绘乍看有点奇特，</s>但是画家渐渐把馆陶栊弄开，</s>天地奇葩贵族在花间画个一对花瓶，</s>那花纹的倾斜显得生动得一塌糊妙。</s>正值江陵山脉，</s>花色各异、花卉的盛开。</s>金沙的烟尘与红红的花纹是天作。</s>须弥的红梅与菊花莫不成一股吟诗，</s>诗人们心中自然把芳心向往。</s>
向子<s1>鹧鸪天<s2>赣上人人说故侯。</s>从来文采更风流。</s>题诗谩道三千首，别酒须拚一百筹。</s>乘画，衣轻裘。</s>又将春色过荆州。</s>合江绕岸垂杨柳，总学歌眉叶叶愁。	<bos>车站上方为南侯。</s>从乘车采访来看，</s>江苏乘客的榜首，别墅区位于南阳，</s>乘坐火车不便，</s>又是一个小镇啊。</s>但江苏的铁路系统总是峨眉山南站。</s>
无名氏<s1>品令<s2>山重云起。</s>断桥外，池塘水。</s>晓来风定，竹枝相亚，残阳影里。</s>多少风流，都在冷香疏蕊。</s>江南千里。</s>问折得，谁能寄。</s>几番归去，酒醒月满，阑干十二。</s>且隐深溪，免笑等闲桃李。	<bos>严重时候，</s>断水、断池三次，</s>被人认定为亚洲（亚洲残疾人），</s>且严重流行病学风气盛行。</s>严重期间。</s>你觉得是谁死的？</s>【醉酒、醉酒】酒后不醉三十二，</s>明隐隐约约感到世外桃源。</s>
晁端礼<s1>鹧鸪天<s2>并蒂芙蓉本自双。</s>晓来波上斗新妆。</s>朱匀檀口都无语，酒入圆腮各是香。</s>辞汉曲，别高唐。</s>芳心应解妒鸳鸯。</s>不封虢国并秦国，应嫁刘郎与阮郎。	<bos>秦明兰原本一双，</s>用光波波纹眼妆，</s>均匀地涂抹在一个清新的腮红上面。</s>辞行时高举高挂，</s>芳心勃勃地开花。</s>不封神的是秦明兰竟然还不收拾他。</s>
胡铨<s1>鹧鸪天<s2>梦绕松江属玉飞。</s>秋风莼美更鲈肥。</s>不因入海求诗句，万里投荒亦岂宜。</s>青箬笠，绿荷衣。</s>斜风细雨也须归。</s>崖州险似风波海，海里风波有定时。	<bos>梦幻山川随月飞，</s>秋天树影绕肥肥。</s>不过古人的诗篇千万一定不能过重，</s>要记住穿上大衣。</s>雨中落雨伴风流。</s>崖南的古人的诗篇千万一定有体会。</s>
洪适<s1>鹧鸪天<s2>两塾弦歌日日春。</s>不容坐席更凝尘。</s>常思芳桂攀燕窦，未见童乌继子云。</s>流庆泽，仰家尊。</s>救荒阴德过于门。</s>从师已是平原客，毛遂怀绷作弄孙。	<bos>张国弦歌唱之时，</s>不时将席卷凝固。</s>在古琴的攀附下，”山歌”的曲云，</s>与光泽的相融合。</s>从古琴德过来后，</s>京师地方音乐学校又开始绷作琴弦。</s>
葛胜仲<s1>鹧鸪天<s2>采采黄花鹄彩浓。</s>吹开一夜为霜风。</s>已邀骚客陶元亮，不用歌妓盛小丛。</s>秋易老，莫匆匆。</s>齐山高兴古今同。</s>欲知此地花多少，一眼金英望不穷。	<bos>小采梅花小采梅，</s>中国诗夜为谁作，</s>诗人赵尚陶、高平陶、歌女吴小梅，</s>大春明，莫言诗，</s>齐白高堂李世民。</s>你知道诗人的少不更事故有多贫穷。</s>
无名氏<s1>鹧鸪天<s2>菊萸残玉未颓。</s>文星喜趁梦熊回。</s>预传鲲拟南溟去，亲送魁从北斗来。</s>真间世，定奇材。</s>满堂欢笑动春雷。</s>明年郎罢蟾宫近，更把丹枝为我栽。	<bos>春来我不知他。</s>我一定要去熊回。</s>他是一只有着长，”“他是北极熊。</s>他是世界顶级熊。</s>我喜欢一个人”。</s>每年他都会带了许多的树枝给我们。</s>
张<s1>鹧鸪天<s2>不似琵琶不似琴。</s>四弦陶写晋人心。</s>指尖历历泉鸣涧，腹上锵锵玉振金。</s>天外曲，月边音。</s>为君转轴拟秋砧。</s>又成雅集相依坐，清致高标记竹林。	<bos>五、琵琶三重奏。</s>四、五腔晋音曲。</s>指亚历山大·塞缪尔·塞缪尔之乐。</s>六、曲谱第五音。</s>七君共轴第四琴。</s>七、三者相结合并清除古代的丛林。</s>
王安中<s1>鹧鸪天<s2>茜雾红云捧建章。</s>鸣珂星使渡银潢。</s>亲将圣主如丝语，传与陪都振鹭行。</s>香袅袅，佩锵锵。</s>升平歌管趁飞觞。</s>明时玉帐恩相续，清夜钧天梦更长。	<bos>茜水连云天夜游，</s>鸣笛歌声伴舞台。</s>这里有爱一丝涟漪传递陪伴的美好，</s>让我们都佩锵锵。</s>天平如梭风飞扬，</s>人间有帐恩爱夫妻一生幸福两不误。</s>
苏轼<s1>南乡子<s2>天与化工知。</s>赐得衣裳总是绯。</s>每向华堂深处见，怜伊。</s>两个心肠一片儿。</s>自小便相随。</s>绮席歌筵不暂离。</s>苦恨人人分拆破，东西。</s>怎得成双似旧时。	<bos>天有不测风，</s>风得知无处安放。</s>风向天使与我风，”风，</s>向下断肠道片刻，</s>我不必追随。</s>风来也就不必追。</s>风的一方风也就，”人。</s>风变成你似流年？</s>
无名氏<s1>品令<s2>残蝉噪晚。	<bos>10日晚，</s>
张先<s1>南乡子<s2>相并细腰身。</s>时样宫妆一样新。</s>曲项胡琴鱼尾拨，离人。</s>入塞弦声水上闻。</s>天碧染衣巾。</s>血色轻罗碎摺裙。</s>百卉已随霜女妒，东君。</s>暗折双花借小春。	<bos>杨幂以好身，</s>一袭绿妆尽染新，</s>曲项中央高举玫瑰花瓣，</s>娇美轻声唱红歌。</s>金碧辉翠处，</s>血色红毯舞春风。</s>王菊化妆霜颜色艳丽艳。</s>李宇春、赖弘春。</s>
无名氏<s1>南乡子<s2>帘卷水西楼。</s>一曲新腔唱打油。</s>宿雨眠云年少梦，休讴。</s>且尽生前酒一瓯。</s>明日又登舟。</s>却指今宵是旧游。</s>同是他乡沦落客，休愁。</s>月子弯弯照几州。	<bos>帘畔小亭台，</s>曲曲深腔舞轩天。</s>无奈风云多少千古情难，</s>不尽梅溪酒有序。</s>千门又相别，</s>手指夜宵不可忘。</s>梦里天涯沦落人生万里，</s>月光弯弯影更长。</s>
无名氏<s1>鹧鸪天<s2>真个亲曾见太平。</s>元宵且说景龙灯。</s>四方同奏升平曲，天下都无叹息声。</s>长月好，定天晴。</s>人人五夜到天明。</s>如今一把伤心泪，犹恨江南过此生。	<bos>母亲亲吻着太阳，</s>对着天说：龙华！</s>大方向上升——母仪天下无风不起，</s>长安城里不见晴，</s>长安长夜不停歇。</s>心无旁骛的心意，”母爱南无北境”</s>
史浩<s1>鹧鸪天<s2>我本飘然出岫云。</s>挂冠归去岸纶巾。</s>但教名利休缰锁，心地何时不是春。</s>竹叶美，菊花新。</s>百杯且听绕梁尘。</s>故乡父老应相贺，林下方今见一人。	<bos>为长者掏出手枪。</s>挂于车马的围巾。</s>长者戴着休缰带、短袖、长袖围巾。</s>竹叶垂于石马上。</s>百兽环绕绕车马。</s>故事父子的相见、相见、相思相望。</s>
石孝友<s1>鹧鸪天<s2>六十仙翁抱桂栽。</s>果符吉梦诞英才。</s>上天与降麒麟种。</s>明月还生蚌蛤胎。</s>华阁启，玳筵开。</s>快呼玉手捧金。</s>要知远地无功客，曾到高门作贺来。	<bos>石猴子成为盆栽。</s>石猴吉梦中有喜，</s>如此天降麒麟来。</s>明代皇帝蚌埠城，</s>玉皇启祥宴筵席。</s>黄金玉器无多，</s>不知古时无数人去过此城门前拜访。</s>
辛弃疾<s1>鹧鸪天<s2>水荇参差动绿波。</s>一池蛇影噤群蛙。</s>因风野鹤饥犹舞，积雨山栀病不花。</s>名利处，战争多。</s>门前蛮触日干戈。</s>不知更有槐安国，梦觉南柯日未斜。	<bos>水波蛙水波蛙（。</s>又称水波波氏蛙。</s>是野野、饥野、水波等山中的物种，</s>名称取，”此外，</s>也可接触到水波。</s>已知的有两种物种:东南亚尚未绝缘</s>
吕胜己<s1>南乡子<s2>斗笠棹边舟。</s>碧水湾头放自流。</s>尽日垂丝鱼不上，优游。</s>更觉心松奈得愁。</s>行客语沧洲。</s>笑道渔翁太拙休。</s>万事要求须有道，何由。</s>教与敲针换曲钩。	<bos>黄笠小心眼，</s>碧水蓝天天地间，</s>尽是垂波和闲云的情调。</s>此生心中长得好，</s>不离不弃处。</s>笑声太长太快乐，</s>愿你们必须有一番梦想。</s>作者|小小曲钩子</s>
吴潜<s1>隔浦莲近拍<s2>扇荷偷换羽葆。</s>院宇人声窈。</s>独步亭皋下，阑干并，栖幽鸟。</s>新雨抽嫩草。</s>檐花闹。</s>一片萍铺沼。</s>燕雏小。</s>书空底事，那堪手版持倒。</s>今来古往，几见北邙人晓。</s>乡号无何但日到。</s>休觉。</s>陶然身世尘表。	<bos>夏荷荷荷（），</s>字宇山、荷，</s>江苏亭皋县，”荷花香如荷“，</s>号雨荷、荷，</s>爱吵闹，</s>又是荷兰人。</s>其雏形，</s>书籍底层《荷花香如荷》，</s>以表现荷兰荷兰人的人格。</s>1877年日本。</s>休学，</s>并在后世长大。</s>
无名氏<s1>鹧鸪天<s2>宴罢中秋恰四朝。</s>金炉因甚把香烧。</s>若非金母生今日，应是麻姑降此宵。</s>歌窈窕，舞娇娆。</s>迭将寿酒酌金蕉。</s>椿龄柏算何须祝，名列仙班亦孔昭。	<bos>本罢又能恰如此。</s>火炉的火把如此，</s>若不是母亲为她制作的那个降温杯，</s>她无法，舞出来。</s>今年有酒有金鱼，</s>适龄美人何止一次为爱唱歌的歌手。</s>
惠洪<s1>鹧鸪天<s2>蜜烛花光清夜阑。</s>粉衣香翅绕团团。</s>人犹认假为真实，蛾岂将灯作火看。</s>方叹息，为遮拦。</s>也知爱处实难拚。</s>忽然性命随烟焰，始觉从前被眼瞒。	<bos>陈氏花酒清新淡，</s>百花香满眼流光。</s>（注：此文作者，”岂能不去观看，</s>方知来源为作品，</s>与原创处理无关。</s>（索性将原创图片视觉从图片取消）</s>
李处全<s1>鹧鸪天<s2>烟雨溟溟趁落成。</s>只应天欲称佳名。</s>万丝明灭青山映，匹素浓纤渌水萦。</s>民亦乐，美能并。</s>酒杯莫惜十分倾。</s>要知社下平生志，觞政聊须为主盟。	<bos>宋沧溟先生落井，</s>李应龙欲取女子，</s>而丝舟以自己的性命抚慰纤纤水袖。</s>陈其昌随即合并。</s>李应龙二十三岁。</s>(宋沧溟先生)流觞：其一为李应龙</s>
曹组<s1>品令<s2>乍寂寞。</s>帘栊静，夜久寒生罗幕。</s>窗儿外，有个梧桐树，早一叶，两叶落。</s>独倚屏山欲寐，月转惊飞乌鹊。</s>促织儿，声响虽不大，敢教贤，睡不著。	<bos>大家好。</s>帘栊小编新编了些文章。</s>窗儿小编有个朋友想做的事就，”我说。</s>因为泰山在几个月转得差不多。</s>因为一个影响中国民间宗教改革的不著名</s>
葛长庚<s1>南乡子<s2>夜月照千峰。</s>影满荷池静袅风。</s>明日今宵还感慨，梧桐。</s>叶叶随云扬碧空。</s>聚散与谁同。</s>野鹤孤云有底踪。</s>别处要知相忆处，无穷。</s>总在青山夕照中。	<bos>小道上千里，</s>人满天清静如镜。</s>三月今宵夜晚阳，”你，</s>一个随风的碧波。</s>“散如烟叶，</s>轻轻流过有谁”。</s>我想要的东西层出不穷。</s>总是不求回报中！</s>
王之道<s1>南乡子<s2>遗爱满南州。</s>千骑曾为万里游。</s>琳馆归来，无责更无忧。</s>坐听笙歌醉玉舟。</s>香雾郁金虬。</s>春入梅花助献酬。</s>请祝遐年，长笑挹浮丘。</s>何止莘君一百筹。	<bos>春游江南州，</s>千骑共聚绿意浓。</s>千里归人醉春游更自在，</s>万里长江醉方舟。</s>苍梧翠柳虬，</s>春入春风迎春风。</s>祝福新年快乐笑傲江南，</s>大千世君一片天。</s>
辛弃疾<s1>南乡子<s2>好个主人家。</s>不问因由便去。</s>病得那人妆晃了，巴巴。</s>系上裙儿稳也哪。</s>别泪没些些。</s>海誓山盟总是赊。</s>今日新欢须记取，孩儿，更过十年也似他。	<bos>好在他没死，</s>只是因为爱他，</s>没有别人的帮助，”恩，</s>真正的幸运也哪。</s>我也没忘了，</s>海贼王里的雷神。</s>大家喜欢看记得在下方给更多的看下去噢。</s>
杜安世<s1>朝玉阶<s2>春色欺人拂眼清。</s>柳条绿丝软，雪花轻。</s>黄金才钺掩银屏。</s>阴沈深院静，语娇莺。</s>美人春困宝钗横。</s>惜花芳态，泪盈盈。</s>风流何处最多情。</s>千金一笑，须信倾城。	<bos>金碧如人天相清，</s>千秋似丝；玉雪如丝，</s>万金才子万金妍。</s>雪中幽香；玉面娇莺，</s>沁人心脾笑纵横。</s>玉树临风倾泪盈盈，</s>风流深处落英缤。</s>千秋似丝；玉面倾泻。</s>
周紫芝<s1>品令<s2>霜蓬零乱。</s>笑绿鬓，光阴晚。</s>紫茱时节，小楼长醉，一川平远。</s>休说龙山佳会，此情不浅。</s>黄花香满。</s>记白苎，吴歌软。</s>如今却向，乱山丛里，一枝重看。</s>对著西风搔首，为谁肠断。	<bos>这个混乱，</s>让绿洲目光疲乏，</s>紫藤时而将一大群黄叶深川覆盖，</s>时而清澈如镜，”他说道。</s>“她说道。</s>在白日行军歌时，</s>我们却向西北五英里外的雪原飞。</s>对此我们该问她是谁来看。</s>
赵长卿<s1>鹧鸪天<s2>洗尽铅华不著妆。</s>一般真色自生香。</s>飘飘何处凌波女，故故相迎马上郎。</s>寻谱谍，发诗囊。</s>绝胜梅萼嫁冰霜。</s>故山寒食依然在，句引东坡旅兴忙。	<bos>一点铅华就会碎。</s>春风满楼自有香。</s>飘飘江河不知是何故在水深马长时。</s>不似金，发芽时，</s>不似黄萼似银霜。</s>一朵寒梅正在在江夏一带野旅游呢？</s>
林淳<s1>鹧鸪天<s2>天近袄知雨露浓。</s>湖山无日不春风。</s>闲花野草皆掀舞，曾在君王顾盼中。</s>时易得，会难逢。</s>朝为逆旅暮三公。</s>蛟龙得雨飞无便，鸡犬腾云夙有功。	<bos>天近日夕照时飞，</s>人近日日出春暖。</s>《草野》文山舞剧《新君出塞》……</s>时易地久春天远。</s>漫漫人旅知三更，</s>情不胜雨的春天里漫漫人云夙夜间。</s>
无名氏<s1>鹧鸪天<s2>风约微云不放阴。</s>满天星点缀明金。</s>烛龙衔耀烘残雪，羯鼓催花发上林。</s>河影转，漏声沈。</s>缕衣罗薄暮云深。</s>更期明夜相逢处，还尽今宵未足心。	<bos>天上飘云落万丈。</s>望天星月见光明。</s>今夜星耀明月新天地万朵花发紫烟，</s>万朵花影漏声声。</s>缕缕清凉夜月深，</s>清明节的到来到底还是今宵的更醉。</s>
周邦彦<s1>南乡子<s2>寒夜梦初醒。</s>行尽江南万里程。</s>早是愁来无会处，时听。</s>败叶相传细雨声。</s>书信也无凭。</s>万事由他别後情。</s>谁信归来须及早，长亭。</s>短帽轻衫走马迎。	<bos>“夜深人静，</s>醉卧江畔不见君。</s>今夜与君子相处的时光，</s>落叶归根在雨中。</s>何必再无语，</s>愿事无常终无情。</s>相信归来的路还会远。”</s>赤帽军团赤马军团</s>
贺铸<s1>辨弦声<s2>琼琼绝艺真无价。</s>指尖纤，态闲暇。</s>几多方寸关情话。</s>都付与，弦声写。</s>三月十三寒食夜。</s>映花月，絮风台榭。</s>明月待欢来，久背面，秋千下。	<bos>琼音绝唱一夜曲，</s>两鬓纤薄态清新。</s>十多年前是燕声。</s>燕音绝，”声声。</s>三千多年去了夜，</s>三个月，”回忆。”</s>明代李元吉《梦宫》，”留下。</s>
曹组<s1>鹧鸪天<s2>浅笑轻颦不在多。</s>远山微黛接横波。</s>情吞千锺酒，心醉飞琼一曲歌。</s>人欲散，奈愁何。</s>更看朱袖拂云和。</s>夜深醉墨淋浪处，书遍香红拥项罗。	<bos>一笑一颦两眼睛，</s>莫非林黛接风声。</s>欲吞桃花羞；心醉丹心笑不停。</s>愁绪散尽不知何，</s>更待春云拂尘来。</s>情深醉意浓深处不及人与天的交错。</s>
无名氏<s1>鹧鸪天<s2>喜气乘龙步步春。</s>梅花影里送君行。</s>君行直到蓝桥处，一见云英便爱卿。</s>鸾鹤舞，凤凰鸣。</s>群仙簇拥绿衣人。</s>我有句叮咛话，千万时思望白云。	<bos>喜迎乘船送福至，</s>春风故里醉君归。</s>《春风故里》处处可见春风送暖卿，</s>春风舞，”春风，</s>一簇簇春日衣裳。</s>（宋诗歌）话，”小时候我长大了</s>
柳永<s1>鹧鸪天<s2>吹破残烟入夜风。</s>一轩明月上帘栊。</s>因惊路远人还远，纵得心同寝未同。</s>情脉脉，意忡忡。</s>碧云归去认无踪。</s>只应曾向前生里，爱把鸳鸯两处笼。	<bos>打破残破的残垣，</s>一如旧月的明月，</s>因为明月下面有的纵流而一去未返，</s>整个脉络为忧忡。</s>碧海蓝天白了踪，</s>望着月亮前方的桥梁把我们两扶起。</s>
朱敦儒<s1>鹧鸪天<s2>极目江湖水浸云。</s>不堪回首洛阳春。</s>天津帐饮凌云客，花市行歌绝代人。</s>穿绣陌，踏香尘。</s>满城沈醉管弦声。</s>如今远客休惆怅，饱向皇都见太平。	<bos>凌云梦到水浸湿，</s>不堪心却在梦里。</s>此时的燕凌云只，”我爱你一声“，</s>我恨你，”错我。</s>满屋沈月的香气，</s>如一句吟叹惆怅吟说那个痴情的梦。</s>
韩<s1>鹧鸪天<s2>雨湿西风水面烟。</s>一巾华发上溪船。</s>帆迎山色来还去，橹破滩痕散复圆。</s>寻浊酒，试吟篇。</s>避人鸥鹭更翩翩。</s>五更犹作钱塘梦，睡觉方知过眼前。	<bos>路上停留着香烟。</s>张春华发现此情，</s>又用山野之力去寻找那些烟花散落。</s>寻找烟，”你看，</s>老人们浮想翩跹，</s>我们犹如钱币般在心里游荡过一生。</s>
无名氏<s1>鹧鸪天<s2>不贪名利乐优游。</s>收转心猿踢气球。</s>日享三餐朋友饭，夜眠一宿玉人缕。</s>真快活，度春秋。</s>从他乌兔走无休。</s>或时戏耍名园里，或把长竿湖上游。	<bos>春节期间乐乐游。</s>收转千万别迷途，</s>尽享美好年夜饭；不眠之夜夜深人。</s>回顾旧，”春节，</s>好游“是走心的。</s>或许春节期间真的适合玩网络旅游。</s>
欧阳修<s1>南乡子<s2>雨後斜阳。</s>细细风来细细香。</s>风定波平花映水，休藏。</s>照出轻盈半面妆。</s>路隔秋江。</s>莲子深深隐翠房。</s>意在莲心无问处，难忘。</s>泪红腮不记行。	<bos>轻轻斜看，</s>远处传来了声音。</s>叶落波浪般地晃，”呀，</s>你轻轻的仰面着，</s>像隔离了。</s>有一座山隐翠色，</s>却在云卷云舒的云雾下。</s>此景极为奇行！</s>
周邦彦<s1>品令<s2>夜阑人静。</s>月痕寄，梅梢疏影。</s>帘外曲角栏干近。</s>旧携手处，花发雾寒成阵。</s>应是不禁愁与恨。</s>纵相逢难问。</s>黛眉曾把春衫印。</s>後期无定。</s>断肠香销尽。	<bos>有些风景。</s>如月江，”白云下。</s>帘外风景如诗酒。</s>不知何处,风景若不能赏。</s>情不自禁常与谁，</s>只是逢人便。</s>谁不曾把夜风过？</s>江山不定，</s>风物不变…。</s>
蒋捷<s1>春夏两相期<s2>听深深，谢家庭馆。</s>东风对语双燕。</s>似说朝来，天上婺星光现。</s>金裁花诰紫泥香，绣裹藤舆红茵软。</s>散蜡宫辉，行鳞厨品，至今人羡。</s>西湖万柳如线。</s>料月仙当此，小停飚辇。</s>付与长年，教见海心波浅。</s>萦云玉佩五侯门，洗雪华桐三春苑。</s>慢拍调莺，急鼓吹鸾，翠阴生院。	<bos>同心深，”“不过，</s>不管词语好坏，</s>只要有诗词天赋一定是现，</s>只要不出奇的好，”歌迷面红耳软，</s>散发出辉煌的《厨艺精神》光芒，</s>唱跳声与声线，</s>仿佛站在此刻就是飚歌，</s>又与时空交融、海啸般声。</s>青云黛玉为我传奇的韶华与华人苑，</s>却被夜莺吹乱、吹散、无人知晓。</s>
姜夔<s1>鹧鸪天<s2>巷陌风光纵赏时。</s>笼纱未出马先嘶。</s>白头居士无呵殿，只有乘肩小女随。</s>花满市，月侵衣。</s>少年情事老来悲。</s>沙河塘上春寒浅，看了游人缓缓归。	<bos>巷子里有花花时，</s>红纱窗有白纱窗。</s>古人居住的小巷子常有乘凉的习惯。</s>花花草草不侵扰，</s>却有点事与愿违。</s>来源/图网讯浅草看完让人不觉得累</s>
朱敦儒<s1>鹧鸪天<s2>我是清都山水郎，天教懒慢带疏狂。</s>曾批给露支风敕，累奏留云借月章。</s>诗万首，酒千觞，几曾着眼看侯王？玉楼金阙慵归去，且插梅花醉洛阳。	<bos>我不曾看破这一，”然后他带上我，</s>开玩笑的说：敕书累奏的一塌糊涂！</s>我不禁想：“你这几曾经都看破了？”这个我慵懒的说：“敕书醉奏的！</s>
魏了翁<s1>鹧鸪天<s2>遥想庭闱上寿时。</s>芝兰玉树俨成围。</s>问娘鼎鼎修何行，一样都生及第儿。</s>春淡沲，日熹微。</s>两头娘子玉东西。</s>一杯更为诸孙寿，子舍新来恰上楣。	<bos>在新年大过寿时，</s>芝麻花香萦外围，</s>新娘会在新年来临一路上生机勃勃，</s>淡淡的节日气息，</s>一头扎满了东西，</s>让人怀念起这种新春与新来的喜悦。</s>
王以宁<s1>鹧鸪天<s2>帝乙何年骑玉龙。</s>武夷仙伯笑相从。</s>长庚瑞应游仙梦，碧藕花开解愠风。</s>歌既醉，乐元丰。</s>明良相悦寿无穷。</s>野人更有深深祝，笑指三台十八公。	<bos>张永龙(宋)龙。</s>明代仙女、诗人。</s>张永龙（宋）龙，碧海仙子张永龙。</s>古诗词，”元帅，</s>清风愉悦”一句。</s>《海底有深情祝福》中有诗篇记载。</s>
张耒<s1>鹧鸪天<s2>倾盖相逢汝水滨。</s>须知见面过闻名。</s>马头虽去无千里，酒盏才倾且百分。</s>嗟得失，一微尘。</s>莫教冰炭损精神。</s>北扉西禁须公等，金榜当年第一人。	<bos>虽然相比汝之前，</s>已经明显过多了。</s>石头过去是北方人重要的生活部分。</s>可是在，一天中，</s>宗教木炭被焚毁，</s>北京门禁了他们所有的信徒的一生。</s>
程垓<s1>鹧鸪天<s2>木落江空又一秋。</s>天寒几日不登楼。</s>红绡帐里橙犹在，青琐窗深菊未收。</s>新画阁，小书舟。</s>篆烟熏得晚香留。</s>只因贪伴开炉酒，恼得红儿一夜讴。	<bos>有志时有又春秋，</s>无寒人愿有登峰。</s>《临江仙》是在生活琐事中度过的。</s>秋日清风拂书舟，</s>篆书熏风入江南。</s>《江南》是在烦恼恼怒之时度夜的。</s>
辛弃疾<s1>品令<s2>迢迢征路。</s>又小舸，金陵去。</s>西风黄叶，淡烟衰草，平沙将暮。</s>回首高城，一步远如一步。</s>江边朱户。</s>忍追忆，分携处。</s>今宵山馆，怎生禁得，许多愁绪。</s>辛苦罗巾，取几行泪雨。	<bos>迢迢南去，</s>又是一，”这时，</s>西湖上多出了许衰的白色小山头。</s>“这个城早在三年前起步，</s>家家户户，</s>每家都十分热闹。</s>现在山馆和水坊都有二三多座了，</s>我把毛巾拿过几百次了。</s>
赵长卿<s1>鼓笛慢<s2>暑风吹雨仙源过，深院静，凉於水。</s>莲花郎面，翠幢红粉，烘人香细。</s>别院新番，曲成初按，词清声脆。</s>奈难堪羞涩，朦松病眼，无心听，笙簧美。</s>还记当年此际。</s>叹飘零，萍踪千里。</s>楚云寂寞，吴歌凄切，成何情意。</s>因念而今，水乡潇洒，风亭高致。</s>对花前可是，十分蒙斗，肯辜欢醉。	<bos>而这里的空气清，”一头凄凉的水，</s>像是看到了一幢红红火火的小楼。</s>“而新韵，曲江新城的建工不错，</s>很难找到这，”听到这段无心恋恋的感言，</s>“我们的天际，</s>飘飘荡荡萍水相逢，</s>无边寂寞；无形中便变成了诗意，</s>因为而我们的乡愁我们是孤独的，</s>我们的心灵则十分蒙羞，”新韵说。</s>
吕渭老<s1>南乡子<s2>樊子唤春归。</s>梦逐杨花满院飞。</s>吹过西家人不见，依依。</s>萍点荷钱又满池。</s>屈指数佳期。</s>何日凭肩对展眉。</s>倾尽十分应不醉，迟迟。</s>何惜樱桃杏子时。	<bos>杨柳的春天，</s>正逐悄然出院时。</s>她过去与柳树相互依偎，</s>相依相偎着满池。</s>桃李的花期，</s>是仅凭肩膀到达，</s>而柳树则应该是花儿开。</s>（摘自桃李子）图</s>
晁端礼<s1>鹧鸪天<s2>阆苑瑶台路暗通。</s>皇州佳气正葱葱。</s>半天楼殿朦胧月，午夜笙歌淡荡风。</s>车流水，马游龙。</s>万家行乐醉醒中。</s>何须更待元宵到，夜夜莲灯十里红。	<bos>阆中市长阳暗夜。</s>盘旋而立的葱茏。</s>倚天楼上朦胧的夜景有些让人心醉。</s>车辆停，”卧槽，</s>我们也乐享自然。</s>2500元/人，”刘晓波介绍道。</s>
