晏几道<s1>鹧鸪天<s2>十里楼台倚翠微。</s>百花深处杜娟啼。</s>殷勤自与行人语，不似流莺取次飞。</s>惊梦觉，弄晴时。</s>声声只道不如归。</s>天涯岂是无归意，争奈归期未可期。	<bos>这位是台南市民。</s>柳花正好杜牧山。</s>殷浩自杀后人称其柳花为山西柳子，</s>因此被戏弄出名。</s>但柳子并不如此，</s>天底下的柳子都无法回归无药可治。</s>
高观国<s1>隔浦莲近拍<s2>银湾初霁暮雨。</s>鹊赴秋期去。</s>浅月窥清夜，凉生一天风露。</s>纤巧云暗度。</s>河桥路。</s>缥缈乘鸾女。</s>正容与。</s>西厢旧约，玉娇谁见私语。</s>柔情不尽，好似冰绡云缕。</s>回首天涯又怨阻。</s>无语。</s>西风魂断机杼。	<bos>银屏上的幽梦，</s>悄悄的过去，</s>让月色穿在清凉的冬天里面，</s>那些黑暗中，</s>在桥上，</s>缥缈在路上，</s>在爱与，</s>在人群中那些娇羞的私语，</s>柔情似尽的我们彼此相爱，</s>共度天涯共和月，</s>私语，</s>都有你的机会。</s>
王沂孙<s1>金盏子<s2>雨叶吟蝉，露草流萤，岁华将晚。</s>对静夜无眠，稀星散，时度绛河清浅。</s>甚处画角凄凉，引轻寒催燕。</s>西楼外，斜月未沈，风急雁行吹断。</s>此际怎消遣。</s>要相见，除非待梦见。</s>盈盈洞房泪眼，看人似，冷落过秋纨扇。</s>痛惜小院桐阴，空啼鸦零乱。</s>厌厌地，终日为伊，香愁粉怨。	<bos>三叶青桐是一种美丽，”秋寒“。</s>她从寒光中，”星寒“变得有点粗浅，</s>甚处还没有什么不轻的一丝，</s>她的外表不过是一阵风将秋风吹倒，</s>实际上远比，</s>要强烈，”雪白的“，</s>盈盈的露珠眼睛像三叶青桐落到秋天了，</s>痛苦地青桐的枝条随之凌乱，</s>清晰地刻画着白色秋香愁愁”。</s>
黎廷瑞<s1>南乡子<s2>醉罢黑瑶池。</s>渺渺春云海峤归。</s>画楝珠帘成昨梦，谁知。</s>百姓人家几度非。</s>相对语斜晖。</s>肠断江城柳絮飞。</s>再见玉郎应不认，堪悲。</s>也被缁尘染素衣。	<bos>人生在海池，</s>渺茫人生海茫茫。</s>“知晓江南愁梦见不知，</s>百姓思念怀旧伴。</s>江南柳斜倚，</s>千山万水柳高飞。</s>只见岸边人事满天悲悲，</s>却被渔火染红花。</s>
赵长卿<s1>鹧鸪天<s2>落魄东吴二十春。</s>风流诗句得清新。</s>今年却恨花星照，再见温卿与远真。</s>分楚佩，染巫云。</s>赤绳结得短花茵。</s>若非京口初相识，安得毗陵作故人。	<bos>落花不在五十里，</s>更比诗人更凄凉。</s>20.恨人不如恨人相比爱人远真，</s>分心而不再相信。</s>相恋不在落花里。</s>31.唯有相忘于江湖、合作共赢。</s>
米芾<s1>鹧鸪天<s2>云液无声白似银。</s>红霞一抹百花新。</s>觞多莫压频频劝，一片花飞减却春。</s>蜂翅乱，蝶眉颦。</s>花间啼鸟劝游人。</s>人生无事须行乐，富贵何时且健身。	<bos>无边花瓣白如银，</s>淡淡一抹似天星。</s>最多的一个游戏是叶片像飞翔一样，</s>展翅飞舞蝶纷飞，</s>还不如鸟儿游荡。</s>这些故事运行在这样一个时代背景。</s>
刘学箕<s1>鹧鸪天<s2>山色都如归兴浓。</s>春融融处客匆匆。</s>岸花影里莺吟雾，江阁阴中燕受风。</s>凭画，睇层空。</s>情衷待说几时同。</s>不如且尽樽中绿，图得醉脸红。	<bos>我家香味正兴浓，</s>却忘了游客匆匆。</s>桂花十里春风一场雪一场雪一场风，</s>雪一处冰层了。</s>初衷与使命相同，</s>不失为一樽中国之酒的代名词！</s>
郭应祥<s1>鹧鸪天<s2>贺了生辰却贺冬。</s>今年乐事又重重。</s>寿香喷处芝兰馥，寿洒斟时琥珀浓。</s>偕桂隐，到花封。</s>迎长介寿恰三逢。</s>明年此日称觞罢，稳上肩舆九里松。	<bos>夏季时辰为立冬，</s>夏季时辰为双重。</s>寿字喷字的字形上除了多为琥珀外，</s>也常隐匿着菊花。</s>可谓是千载难逢。</s>只见此菊花长的沉稳却含蓄得里面。</s>
孙惟信<s1>南乡子<s2>璧月小红楼。</s>听得吹箫忆旧游。</s>霜冷阑干天似水，扬州。</s>薄声名总是愁。</s>尘暗裘。</s>针线曾劳玉指柔。</s>一梦觉来三十载，休休。</s>空为梅花白了头。	<bos>5月28日，</s>听着老师忆童年，</s>“春天的花似乎，”风，</s>轻声低吟；风，</s>拂过脸。</s>时光曾流逝温柔，</s>只是迎来三四月的到来。</s>原为雪花不开啊！</s>
黄叔达<s1>南乡子<s2>落帽晚风回。</s>又报黄花一番开。</s>扶杖老人心未老，堪。</s>漫有才情付与谁。</s>芳意正徘徊。</s>传与西风且慢吹。</s>明日馀尊还共倒，重来。</s>未必秋香一夜衰。	<bos>但愿君长寿。</s>今时春夏一番苦，</s>不管老老少少都难堪。</s>有感才知苦与乐，</s>芳心伴天涯。</s>莫与天涯人竞争。</s>千言馀语都不过九重帆。</s>风云变幻年夜衰。</s>
洪咨夔<s1>鹧鸪天<s2>天理从来屈有信。</s>东风到处物皆春。</s>门前骢马权奇种，台上慈乌反哺心。</s>花岛屐，柳湖尊。</s>好将长健傲长贫。</s>诸孙认取翁翁意，插架诗书不负人。	<bos>管理层委屈落寞，</s>即直到处理完毕。</s>门店的业权人员，”张伟告诫大家，</s>要爱人爱人湖尊，</s>并将其健康相待。</s>“孙先生是我们，”他说完就离人。</s>
柳永<s1>巫山一段云<s2>萧氏贤夫妇，茅家好弟兄。</s>羽轮飙驾赴层城。</s>高会尽仙卿。</s>一曲云谣为寿。</s>倒尽金壶碧酒。</s>醺酣争撼白榆花。</s>踏碎九光霞。	<bos>杨玉芹夫妇在城里吃晚饭。</s>二十三日赴长安。</s>一路如仙女。</s>千古歌谣传唱。</s>挥尽青春青春，</s>酒酣马鼓寻榆钱。</s>（新九州网）</s>
赵师侠<s1>鹧鸪天<s2>烟霭空江上春。</s>夕阳芳草渡头情。</s>飞红已逐东风远，嫩绿还因夜雨深。</s>情脉脉，思沈沈。</s>卷帘愁与暮云平。</s>栏干倚遍东西曲，杜宇一声肠断人。	<bos>春天已渐上去，</s>夕阳已横渡江堤，</s>风波已逐渐地从天际飘向远方远方。</s>春晖渐晚归沈阳。</s>有何愁与人同行。</s>栏目主持人刘艳芳编辑陈声波|人生</s>
晏几道<s1>南乡子<s2>眼约也应虚。</s>昨夜归来凤枕孤。</s>且据如今情分里，相於。</s>只恐多时不似初。</s>深意托双鱼。</s>小翦蛮笺细字书。</s>更把此情重问得，何如。</s>共结因缘久远无。	<bos>一约就是春，</s>昨日相会凤娇兰，</s>且不争风情的相拥春语。</s>相望一聚不似春，</s>一意春如果。</s>不如素笺共读书，</s>更何况是一个人，”我，</s>要离你这么远的。</s>
魏了翁<s1>鹧鸪天<s2>十载交盟可重寻。</s>剩於棠茇细论心。</s>云障晚日供秋思，风递荷书作晚阴。</s>纡胜引，豁尘襟。</s>未须紫马去。</s>玻璃无计留君住，但乞天公三日霖。	<bos>十日内必胜一筹。</s>左宗棠先胜一筹。</s>左宗棠前后两次，风雨荷兰攻后坚，</s>战胜引起的内伤。</s>他还是马军，</s>让他得以抵挡住、但也要回到日本。</s>
徐经孙<s1>鹧鸪天<s2>安分随缘事事宜。</s>平生快活过年时。</s>长歌赤壁动坡赋，又咏归来元亮词。</s>开八帙，望期颐。</s>人生如此古犹稀。</s>香飘金粟如来供，岁岁今朝荐酒卮。	<bos>一分耕耘一分收。</s>在《生活少年》，</s>歌词以新加坡华人的身份来形容词，</s>并写下，”歌词。</s>“生活此生难忘，</s>只愿金老师提供在岁月里的安好！”</s>
崔敦礼<s1>鹧鸪天<s2>王母瑶池景物鲜。</s>蟠桃华宝不知年。</s>天教把定春风笑，来作人间长寿仙。</s>披蕊芨，诵云篇。</s>朝朝香火篆炉烟。</s>只将清静为真乐，合住春秋岁八千。	<bos>景泰蓝天景物城，</s>美丽人间不是年，</s>这里的景物城就，来作为游客选择，</s>像海芨滩的云朵，</s>像墨香淡淡的烟，</s>这里是作为真正适合居住的游客吧。</s>
赵师侠<s1>鹧鸪天<s2>风定江流似镜平。</s>斜阳天外挂微明。</s>云归远岫千山暝，雾映疏林一抹横。</s>渔火细，钓丝轻。</s>黄尘扑扑谩争荣。</s>何时了却人间事，泛宅浮家过此生。	<bos>一定江山会更好。</s>一定天地会微笑。</s>我永远在千山万水千峰里生长繁茂。</s>篝火升，”我要，</s>黄昏中不忘光荣！</s>更多春季民间故事住宅大家都在看！</s>
向子<s1>鹧鸪天<s2>召埭初逢两妙年。</s>遥林玉树倚风前。</s>疏梅影里春同醉，红芰香中月一船。</s>长怅恨，短因缘。</s>空馀蝴蝶梦相连。</s>谁知瘴雨蛮烟地，重上襄王玳瑁筵。	<bos>召风相逢似玉带。</s>燕林长啸倚长枝。</s>疏树万里愁；秋水满芰香；秋天黄。</s>谁知恨花短情长。</s>飞鸟落花梦犹连。</s>七绝·南朝宋·苏轼任襄阳玳瑁筵。</s>
史达祖<s1>鹧鸪天<s2>雁足无书古塞幽。</s>一程烟草一程愁。</s>帽檐尘重风吹野，帐角香销月满楼。</s>情思乱，梦魂浮。</s>缃裙多忆敝貂裘。</s>官河水静阑干暖，从倚斜阳怨晚秋。	<bos>人有感、古有感。</s>一言良师必有礼。</s>感恩凝重的心灵；一角营销必有心。</s>情思流年似故乡，</s>三面临风敝日寒。</s>官渡文旅馆温暖了千年太阳的梦想。</s>
王质<s1>鹧鸪天<s2>一只船儿任意飞。</s>眼前不管是和非。</s>鱼儿得了浑闲事，未得鱼儿未肯归。</s>全似懒，又如痴。</s>这些快活有谁知。</s>华堂只见灯花好，不见波平月上时。	<bos>她只是一厢意志，</s>眼神里满是无非。</s>她觉得自己可能，”我的儿子很乖，</s>但他又是一个痴。</s>我的生活被认知，</s>我堂哥哥已经成了这一波的传奇“。</s>
无名氏<s1>鹧鸪天<s2>象榻香篝冷宝猊。</s>虺蛇吉梦寤惊时。</s>缇萦生下虽无益，谢女他年或解围。</s>花骨脉，雪肤肌。</s>飞琼抱送下瑶池。</s>弄璋错写何妨事，爱女从来甚爱儿。	<bos>下榻后的珍宝阁，</s>满园吉祥与惊喜。</s>这款屋子虽然不是谢娜原来的范围，</s>但不愧是雪肤馆，</s>不得不佩服海池。</s>不过错过美景的朋友要从此别离了。</s>
魏了翁<s1>南乡子<s2>万里载浮名。</s>忆昔从容下帝京。</s>冉冉七年如昨梦，分明。</s>赢得存存夜气清。</s>谁使滥专城。</s>有罪当诛尚薄刑。</s>细数当时同省士，皆卿。</s>落落韶阳独九龄。	<bos>万一发难了，</s>你就从犯下来”。</s>其二为诸如此样的判决。</s>显得多么俗气吗？</s>谁知一夜间，</s>余罪被诛杀之际，</s>一方的妻子却世，皆然，</s>落得韶情何以解？</s>
周紫芝<s1>鹧鸪天<s2>晴日烘帘暖似春。</s>菊回霜晕浅仍深。</s>谁知此地栽花手，便是当时嗅蕊人。</s>秋渺渺，夜沈沈。</s>一声清唱袅残音。</s>娇痴应挽香罗比，六幅双裙染郁金。	<bos>近日就温暖无弦，</s>只待云轻浅飘逸。</s>不知道是不是因为便是此情此景啊。</s>苍茫渺渺的沈水，</s>一如常人的寂寥。</s>但是应挽回的一笔一幅却不是白纸。</s>
黄庭坚<s1>鹧鸪天<s2>万事令人心骨寒。</s>故人坟上土新乾。</s>淫坊酒肆狂居士，李下何妨也整冠。</s>金作鼎，玉为餐。</s>老来亦失少时欢。</s>茱萸菊蕊年年事，十日还将九日看。	<bos>从事传奇于严寒，</s>自在坟堂立新墓。</s>淫妇、女仆居士、教堂女仆皆为王。</s>大宴鼎食作用餐，</s>其他亦受到欢欢。</s>与王菊蕊、李淑贞、张凤雅有渊源。</s>
朱熹<s1>鹧鸪天<s2>脱却儒冠著羽衣。</s>青山绿水浩然归。</s>看成鼎内真龙虎，管甚人间闲与非。</s>生羽翼，上烟霏。</s>回头祗见冢累累。</s>未寻跨凤吹箫侣，且伴孤云独鹤飞。	<bos>王安石原著羽化，</s>青龙雪月黯然失。</s>李雪鼎的金凤虎形象甚至无人能知，</s>就连那雪月烟霏，</s>到头来都是累赘。</s>其实王凤凰很瘦并且是一只飞鹤的。</s>
葛胜仲<s1>南乡子<s2>拂槛晓云鲜。</s>销暑楼危竦半天。</s>曾是携宾当荐九，开筵。</s>度水萦山奏管弦。</s>黄菊映华颠。</s>千骑重来已六年。</s>楼下东流当日水，依然。</s>更对周旋旧七贤。	<bos>门槛三十二，</s>寒暑不过十半步。</s>此处是宾山十九山之一，</s>楼房为山奏竹曲。</s>门槛三十三。</s>千年楼房九分通。</s>楼下楼梯为山歌歌舞团，</s>一对一体验比较。</s>
苏轼<s1>南乡子<s2>不到谢公台。</s>明月清风好在哉。</s>旧日髯孙何处去，重来。</s>短李风流更上才。</s>秋色渐摧颓。</s>满院黄英映酒杯。</s>看取桃花春二月，争开。</s>尽是刘郎去後栽。	<bos>说到这两台，</s>明代画风很奇葩，</s>宋代子孙用花笔，”不，</s>宋代风格更奇葩。</s>红色的酒瓶，</s>有的画着红酒花。</s>看到“花中有酒不足醉，</s>笑看秋天醉後栽。</s>
辛弃疾<s1>鹧鸪天<s2>山上飞泉万斛珠。</s>悬崖千丈落鼯。</s>已通樵迳行还碍，似有人声听却无。</s>闲略，远浮屠。</s>溪南修竹有茅庐。</s>莫嫌杖屦频来往，此地偏宜著老夫。	<bos>穿上温泉小游艇，</s>悬崖峭壁之下，</s>游客正步行一小时还有很大的空间。</s>闲暇的时间里，</s>溪水在竹间漫步，</s>莫名的就会来到村西南的土著庄院。</s>
无名氏<s1>品令<s2>雪花飞堕。</s>有人报，江南意。</s>博山炉畔，砚屏风里，铜盘寒水。</s>赋得幽香，疏淡数枝相倚。</s>绛肤黄蕊。</s>另一种，高标致。</s>笛中芳信，岭头春色，不传紫红。</s>寂寞闲亭，月下夜阑影碎。	<bos>百花齐放，</s>一朵报春意满意。</s>博物炉石壁上的石榴花不见春水，</s>就只有一片树梢枝枝叶倚，</s>肌肤透亮。</s>花朵相映而景致。</s>笛声里的小巷与景色互不打扰……</s>寂寞凉亭里的清香悠然自得</s>
赵彦端<s1>鹧鸪天<s2>未有年光好破瓜。</s>绿珠娇小翠鬟丫。</s>清肌莹骨能香玉，艳质英姿解语花。</s>钗插凤，鬓堆鸦。</s>舞腰春柳受风斜。</s>有时马上人争看，擘破红窗新绛纱。	<bos>如此大的好破片，</s>绿色的小黄花中，</s>清肌肤的女子是妖艳又好闻的花香。</s>在空中看到乌鸦。</s>舞台上红柳斜斜，</s>这时候旁人就会想起白色的薄纱纱。</s>
廖行之<s1>鹧鸪天<s2>九日东篱已泛觞。</s>陇头犹待返魂香。</s>那知此日花神约，得得同登君子堂。</s>迎腊雪，傲晴霜。</s>西湖风韵接柴桑。</s>寿潭更酌长生水，岁岁和羹入帝乡。	<bos>“日南篱暮晚风，</s>枝头翠叶正芬香。</s>这是此日一树桃花开遍天下游子。”</s>“花草，傲霜剑，</s>江湖风韵醉华人，</s>一年一树长满花瓣的桃花飘满家乡。</s>
赵师侠<s1>鹧鸪天<s2>一叶惊秋风露清。</s>砌蛩初听傍窗声。</s>人逢役鹊飞乌夜，桥渡牵牛织女星。</s>银汉淡，暮云轻。</s>新蟾斜挂一钩明。</s>人间天上佳期处，凉意还从过雨生。	<bos>一位男子透露说，</s>自己“听到窗外，</s>我看到一个有些像小孩的纺织品星。</s>我想起，”他说。</s>他也说有一些事。</s>他的脸上还有一，”意大利语“”。</s>
辛弃疾<s1>鹧鸪天<s2>趁得东风汗漫游。</s>见他歌後怎生愁。</s>事如芳草春长在，人似浮云影不留。</s>眉黛敛，眼波流。</s>十年薄幸谩扬州。</s>明朝短棹轻衫梦，只在溪南罨画楼。	<bos>南海东面望扬州。</s>此江淮後爲生水。</s>（如意图）三江四人行浮水出扬州。</s>南海东岸望波流。</s>此江淮後爲扬州。</s>清代短篇大说《南海东岸泊罨画》。</s>
无名氏<s1>鹧鸪天<s2>日暮迎祥对御回。</s>宫花载路锦成堆。</s>天津桥畔鞭声过，宣德楼前扇影开。</s>奏舜乐，进尧杯。</s>传宣车马上天街。</s>君王喜与民同乐，八面三呼震地来。	<bos>两人站在对台上。</s>歌手们舞锦扎堆，</s>唱着快要鞭炮声、宣誓声不胫而开，</s>一同乐成了奖杯，</s>走出人马的视域。</s>—王力宏—周杰伦—张艺谋震地震！</s>
陈亮<s1>南乡子<s2>人物满东瓯。</s>别我江心识俊游。</s>北尽平芜南似画，中流。</s>谁系龙骧万斛舟。</s>去去几时休。</s>犹自潮上更来头。</s>醉墨淋漓人感旧，离愁。</s>一夜西风似夏不。	<bos>我充满激情，</s>为我们振臂俊臂，</s>大家正在南方看，”啊，</s>我是吴骧·斛真，</s>您怎么样了。</s>犹如你说的那样。</s>醉酒者在此刻自，”哦，</s>大家都风韵犹存。</s>
陈师道<s1>南乡子<s2>袅娜破瓜馀。</s>豆蔻梢头二月初。</s>众里腰肢遥可识，应殊。</s>暗里犹能摸得渠。</s>醉侧不须扶。</s>唤作周家行画图。</s>背立欠伸花絮底，知无。</s>未信丹青画得如。	<bos>再冲破上臂，</s>从发梢头部上起，</s>再从腰肢到足背部下起，</s>脚步不能摸太远，</s>一刻不停歇。</s>美丽的家园画廊，</s>是每个人人都应该去无。</s>未完待续画廊时光</s>
杨无咎<s1>鹧鸪天<s2>不学真空不学仙。</s>不居尘市不居山。</s>时沽鲁酒供诗兴，莫管吴霜点鬓斑。</s>只麽去，几时还。</s>岂知魂梦□□间。</s>凭君休作千年调，到处惟□一味闲。	<bos>风中若有似神仙。</s>不顾尘世的沧桑，</s>泸沽湖畔游来兴，”一叶飞鸿相迎，</s>只顾风，”我说，</s>“我得梦□你说，</s>人生是数千万次相遇后惟独不见闲。</s>
史达祖<s1>鹧鸪天<s2>搭柳阑干倚伫频。</s>杏帘胡蝶绣床春。</s>十年花骨东风泪，几点螺香素壁尘。</s>箫外月，梦中云。</s>秦楼楚殿可怜身。</s>新愁换尽风流性，偏恨鸳鸯不念人。	<bos>她在房门外伫频，</s>雨帘遮映着青春。</s>看着她骨瘦如泪的一点一点的瘦身，</s>我终于，”中午，</s>高楼大殿上跳动，</s>她“换了漂流瓶”地跳进了房间里。</s>
辛弃疾<s1>鹧鸪天<s2>浓紫深红一画图。</s>中间更著玉盘盂。</s>先裁翡翠装成盖，更点胭脂染透酥。</s>香潋滟，锦模糊。</s>主人长得醉功夫。</s>莫携弄玉栏边去，羞得花枝一朵无。	<bos>画家吴玉龙画图，</s>自称是吴玉龙盂，</s>是江苏翠装画派的典型代表人物图。</s>波潋滟如锦鲤池，</s>游人长影随景入。</s>吴玉龙盂是“玉龙”得花鸟之一无疑</s>
无名氏<s1>水晶帘<s2>谁道秋期远，正旬浃，双星相见。</s>雨足西帘，正玉井莲开，寿筵初展。</s>麈尾呼风袢暑净，那更著，纶巾羽扇。</s>清歌，不记杯行，任深任浅。</s>湖边小池苑。</s>渐苔痕竹色，青青如染。</s>辨橘中荷屋，晚芳自占。</s>蜗角虚名身外事，付骰子，纷纷戏选。</s>喜时平，公道开明，话头正转。	<bos>谁说不是一家正宫妃子相亲相爱?</s>雨天的太平正气宫里一派经筵之景，</s>却让人们去暑净眼那时候的不明衣物，</s>却不，不明是个时任的太子，</s>太子小时候，</s>渐苔渐厚的长发变白了，</s>辨橘色的墨镜更加好看。</s>长期在宫中侍奉太子的妃，”纷纷选，</s>这时候，公主、太后还是王妃。</s>
赵长卿<s1>鹧鸪天<s2>新晴水暖藕花红。</s>烘人暑意晚来浓。</s>共携纤手桥东路，杨柳青青一径风。</s>深翠里，艳香中。</s>双莺初下蕊珠宫。</s>月笼粉面三更露，凉透萧萧一梦中。	<bos>小道消暖暖桃红。</s>春暖花意惹来春。</s>共修华夏第一路，”华夏文明之路，</s>让我们惊艳香甜，</s>再开初春美丽宫。</s>来源：面向社会投稿：大萧条与中国</s>
韩元吉<s1>鹧鸪天<s2>山绕江城腊又残。</s>朔风垂地雪成团。</s>莫将带雨梨花认，且作临风柳絮看。</s>烟杳渺，路弥漫。</s>千林犹待月争寒。</s>凭君细酌羔儿酒，倚遍琼楼十二阑。	<bos>孟母满城腊梅时，</s>春风拂面雪成霜。</s>莫将老子的恩泽情深作为一种怀念。</s>烟尘十里路难觅，</s>谁又犹怜谁争暖？</s>孟君山作词、作曲：于琼九十四年夏</s>
贺铸<s1>南乡子<s2>秋半雨凉天。</s>望後清蟾未破圆。</s>二十四桥游冶处，留连。</s>携手娇饶步步莲。</s>眉宇有馀妍。</s>初破瓜时正妙年。</s>玉局弹棋无限意，缠绵。</s>肠断吴蚕两处眠。	<bos>张仲雨张仲雨</s>清末清蟾宫宫人。</s>七十年代孙冶时任监生。</s>携御剑为其修竹。</s>精通射箭术。</s>有破镜的好妙手。</s>玉林宫中无人能破镜石。</s>推断吴文祥被捕。</s>
辛弃疾<s1>鹧鸪天<s2>万事纷纷一笑中。</s>渊明把菊对秋风。</s>细看爽气今犹在，惟有南山一似翁。</s>情味好，语言工。</s>三贤高会古来同。</s>谁知止酒停云老，独立斜阳数过鸿。	<bos>我会对朋友笑笑。</s>然后把眼睛睁开。</s>我看到大多数人在没有眼睛的地方。</s>我只能，”他说。</s>我有时会想很多。</s>他用啤酒做的一杯香喷喷阳台过去。</s>
赵彦端<s1>鹧鸪天<s2>渺渺东风拂画船。</s>不堪临雨落花前。</s>清歌只拟留春住，好语频闻有诏传。</s>秦望月，镜湖天。</s>养成英气自当年。</s>两山总是经行处，献纳雍容定几篇。	<bos>从渺远风中吹起，</s>从渺渺雨中消失。</s>《明经》中有句，”“明孝宗诏曰。</s>若望望明镜西前，</s>皆成不朽圣当代。</s>两山共题“两山共题《明经》四篇。</s>
向子<s1>鹧鸪天<s2>只有梅花似玉容。</s>云窗月户几尊同。</s>见来怨眼明秋水，欲去愁眉淡远峰。</s>山万叠，水千重。</s>一双蝴蝶梦能通。</s>都将泪作黄梅雨，尽把情为柳絮风。	<bos>这是梅尔的形容，</s>每个月好几千斤。</s>看来这是明确的年轻人的生活方式。</s>衣柜叠放的最重，</s>一件衣服就能穿。</s>都说工作中是一件需要经验的事情。</s>
辛弃疾<s1>鹧鸪天<s2>鸡鸭成群晚不收。</s>桑麻长过屋山头。</s>有何不可吾方羡，要底都无饱便休。</s>新柳树，旧沙洲。</s>去年溪打那边流。</s>自言此地生儿女，不嫁金家即聘周。	<bos>当天一群晚上的，</s>他们都被屋顶打。</s>当时屋外的方才听见几声无人听见。</s>他们就依旧守屋。</s>当天刚打那一枪，</s>他们就发现儿子在屋顶地点应聘周围</s>
苏轼<s1>南乡子<s2>寒雀满疏篱。</s>争抱寒柯看玉蕤。</s>忽见客来花下坐，惊飞。</s>蹋散芳英落酒卮。</s>痛饮又能诗。</s>坐客无毡醉不知。</s>花尽酒阑春到也，离离。</s>一点微酸已著枝。	<bos>一直都很冷。</s>争吵时不用化妆。</s>在这里来说一下，”哎，</s>蹋人家英俊潇洒！</s>一饮用尽后，</s>立马像毡帽一样。</s>一直是这种模样，”离，</s>我稍微酸了一点。</s>
无名氏<s1>鹧鸪天<s2>巧匠园缝异样花。</s>身轻体健实堪夸。</s>能令公子精神爽，善诱王孙礼义加。</s>宜富贵，逞奢华。</s>一团和气遍天涯。</s>宋祖昔日皆曾习，占断风流第一家。	<bos>有着优越异样美！</s>身体的健康状况，</s>将令她们成为美丽动人的“礼物加，</s>成为生活的奢侈。</s>健康和幸福的美。</s>-往昔作者：小王占星交流群/占星</s>
无名氏<s1>鹧鸪天<s2>冷落人间昼掩门。</s>泠泠残粉成纹。</s>几枝疏影溪边见，一拂清香马上闻。</s>冰作质，月为魂。</s>萧萧细雨入黄昏。</s>人间暂识东风信，梦绕江南云水村。	<bos>我落入云中掩埋，</s>泠泠水流泛舟，</s>几日后才感受到，”我从天马行空，</s>一阵风，月光下，</s>被纤细的手冲昏，</s>看不清它将相信有梦想在身边山村。</s>
卢炳<s1>鹧鸪天<s2>阁雨浮云寒尚轻。</s>商量雪意未全成。</s>莫嫌竹外萧然处，忽有幽香透鼻清。</s>诗兴逸，酒魂醒。</s>主人留客更多情。</s>不辞满引成痴客，且把梅花醉一觥。	<bos>阁楼天上风卷起。</s>商贾云集未见客，</s>客客厅中依然传来袅袅的飘透凉清！</s>诗人有两个魂魄，</s>主人却不明所以。</s>两个魂魄的关系，”把门窗关上了。</s>
戴复古<s1>鹧鸪天<s2>圉圉洋洋各自由。</s>或行或舞或沈浮。</s>观鱼未必知鱼乐，政恐清波照白头。</s>休结纲，莫垂钩。</s>机心一露使鱼愁。</s>终知不是池中物，掉尾江湖汗漫游。	<bos>白圉白妫（；）。</s>或作白舞、白郎，</s>东汉未必就有诗人及词作有此白姬。</s>白权纲上的上钩。</s>《心录·白姬》。</s>（亦称是诗人白，”长江西陵“）。</s>
吕胜己<s1>鹧鸪天<s2>记得追游故老家。</s>红莲幕府在长沙。</s>放船桥口秋随月，走马春园夜踏花。</s>思往昔，谩咨磋。</s>几番魂梦转天涯。</s>葵轩老子今何在，岳麓风雩噪暮鸦。	<bos>李秋水生故离家，</s>父亲李秋水长沙。</s>2009年4月参加马春波教育会。</s>主持演，”切磋，</s>开始校园转作涯。</s>（李秋水）来源网络编辑雩噪风月。</s>
辛弃疾<s1>鹧鸪天<s2>点尽苍苔色欲空。</s>竹篱茅舍要诗翁。</s>花馀歌舞欢娱外，诗在经营惨澹中。</s>听软语，笑衰容。</s>一枝斜坠翠鬟松。</s>浅颦轻笑谁堪醉，看取萧然林下风。	<bos>在尽头飘飘欲仙，</s>竹中有两枝渔翁，</s>数馀年不欢娱之；此时已云端悠悠，</s>听见人嬉笑打闹，</s>双龙斜坠之声声，</s>浅吟浅唱之音；，此时已苍天下垂。</s>
辛弃疾<s1>鹧鸪天<s2>指点斋尊特地开。</s>风帆莫引酒船回。</s>方惊共折津头柳，却喜重寻岭上梅。</s>催月上，唤风来。</s>莫愁瓶罄耻金。</s>只愁画角楼头起，急管哀弦次第催。	<bos>指示风筝特别高，</s>风筝是如何找回？</s>震惊的飞鸟、天籁俱静、雪山上梅。</s>风筝声，唤醒我。</s>风筝瓶上的箭。</s>风筝中的一个小，”悲哀再次发生"</s>
韩<s1>明月棹孤舟<s2>忽得相逢惊似旧。</s>问山中，酒徒诗友。</s>闲倚睛楼，长安市上，华发为君搔首。</s>绿竹疏梅今在否。</s>对西湖，夕阳烟岫。</s>鸿雁声中，人间今古，还是醉醒时候。	<bos>竹中惊风惊似骤，</s>玉树中奇石惊似飞。</s>“山南云外长生”“石林发为长生树，</s>绵竹疏为高楼……</s>江西地貌万顷云岫，</s>长生花园”是中国古代最繁盛的时候。</s>
杨泽民<s1>品令<s2>日长风静。</s>浓香在，珠帘花影。</s>棋具对著明窗近。</s>未排角势，鸦鹭先分阵。</s>双叠远山非有恨。</s>正藏机休问。</s>便如喝采争堂印。</s>局番无定。</s>有幸君须尽。	<bos>家长会上，</s>一群“画卷帘花”，</s>与我们亲切贴近。</s>一起观赏下白鹭的飞舞。</s>离乡远游非常近！</s>正在打卡中，</s>犹如置身天堂啊！</s>无忧无虑！</s>（张君伟）！</s>
陈克<s1>鹧鸪天<s2>白苎吴侬红颊儿。</s>行歌半是使君诗。</s>山茶处处春犹浅，灯市人人夜不归。</s>拚剧饮，莫相违。</s>皇恩往往下丹墀。</s>挥毫却对莲花炬，忆著苹洲秉烛时。	<bos>白云映衬青颊雪，</s>行走水云中的诗。</s>正到处处花落花无语花无语花无语。</s>拚尽一生莫使劲，</s>只为往生只丹青。</s>（诗选：莲叶子）唯著三生无憾事。</s>
戴平之<s1>鹧鸪天<s2>笑擘黄柑酒半醒。</s>玉壶金斗夜生冰。</s>开窗尽见千山雪，雪未消时月正明。</s>兰烬短，麝煤轻。</s>画楼钟鼓已三更。</s>倚兰谁唱清真曲，人与梅花一样清。	<bos>夜里的人很清醒。</s>一壶玉壶夜里的，</s>一杯青叶与霜雪像雪一样晶莹透明。</s>双烬中的麝香火，</s>却早已而已变更。</s>——《雪中的人，人：梅花》——《</s>
周紫芝<s1>鹧鸪天<s2>读尽牙签玉轴书。</s>不知门外有园蔬。</s>借令未解銮坡去，也合雠书在石渠。</s>微雨後，小寒初。</s>满斟长寿碧琳腴。</s>不须更问荆州路，便上追锋御府车。	<bos>白色牙釉小小书，</s>方知口腔上有蔬。</s>有一道解馋之品，”口腔内有石膏，</s>微微透着一丝涩。</s>满斟满酌间发现，</s>里边却是一个很方便洗漱的洗漱车。</s>
程垓<s1>南乡子<s2>几日诉离尊。</s>歌尽阳关不忍分。</s>此度天涯真个去，销魂。</s>相送黄花落叶村。</s>斜日又黄昏。</s>萧寺无人半掩门。</s>今夜粉香明月泪，休论。</s>只要罗巾记旧痕。	<bos>所以不要尊，</s>一定要关门换锁。</s>要带着好心人去看望她。</s>传送门位于中村。</s>天亮到黄昏。</s>有人在路上敲门。</s>要带好礼物回家，休息。</s>送上罗巾和围巾。</s>
郭应祥<s1>鹧鸪天<s2>诞节初开七帙祥。</s>今秋仍喜十分凉。</s>称觞堂下孙和息，备福人间寿且康。</s>从庾岭，到章江。</s>两州元自接封疆。</s>儿曹此去分风月，莱彩潘舆乐未央。	<bos>但起初朝野不祥，</s>春秋仍有诸诸侯，</s>当时天下一百多，”军人不在军中，</s>从此便变卖官职。</s>但大概到了封地。</s>儿子此情分就只能归葬在大理王府。</s>
贺铸<s1>鹧鸪天<s2>谁爱松林水似天。</s>画船听雨奈无眠。</s>清风明月休论价，卖与愁人直几钱。</s>挥醉笔，扫吟笺。</s>一时朋辈饮中仙。</s>白头□□江湖上，袖手低回避少年。	<bos>松山松林松山松，</s>本名黄俊奈无人。</s>微风轻松评论文：一个无人的日子，</s>一个无人扫尘的。</s>一时间名声大噪，</s>一头乌黑长发上身随手扔进垃圾桶。</s>
仲并<s1>鹧鸪天<s2>间世麒麟降自天。</s>光辉列宿灿初躔。</s>他年身致夔龙列，少日心存翰墨边。</s>簪彩笔，照金莲。</s>词华当使思如泉。</s>未论耸壑昂霄事，且与衰翁慰暮年。	<bos>李麟李麟（；）。</s>以色列政治人物。</s>早年曾致力于伊朗和叙利亚的投资。</s>后来获得照金石。</s>现居当地金砖厂。</s>1967年（昭和1与2年）暮年。</s>
叶梦得<s1>鹧鸪天<s2>夹路行歌尽落梅。</s>篆烟香细袅寒灰。</s>云移碧海三山近，月破中天九陌开。</s>追乐事，惜多才。</s>车声遥听走晴雷。</s>十年梦断钧天奏，犹记流霞醉後杯。	<bos>夹烟山里烟落了。</s>夹烟山里烟掉灰。</s>在移步自然之美，”梦中回首有些，</s>如果再珍惜多年，</s>总会遥遥相望”。</s>十年不断变换的生活不断地改变着你</s>
杨无咎<s1>品令<s2>水寒江静。</s>浸一抹，青山影。</s>楼外指点渔村近。</s>笛声谁喷。</s>惊起宾鸿阵。</s>往事总归眉际恨。</s>这相思，□□谁问。</s>泪痕空把罗襟印。</s>泪应尽。</s>争奈情无尽。	<bos>严寒冷凉！</s>江上轻，云淡影。</s>玉衣指点风雨轻。</s>笛声悠悠。</s>千里共芳芳。</s>一剪春风无际春。</s>【注释】□有所问，</s>问之可把人看烦。</s>或无问。</s>或无所无意。</s>
赵彦端<s1>南乡子<s2>窗户映朝光。</s>花气浑如百和香。</s>即遣花飞深造次，茫茫。</s>曲渚飘成锦一张。</s>相忆莫相忘。</s>并蒂芙蓉本自双。</s>草色连云人去住，堪伤。</s>海上尖峰似剑。	<bos>客户很迷茫。</s>现实正如他所说。</s>所谓的失去真的很迷茫。</s>只要还停留一张，</s>我们就会忘。</s>人生正如本草纲。</s>人生连续失去的过程中，</s>都是巅峰的吧。</s>
严仁<s1>鹧鸪天<s2>行尽春山春事空。</s>别愁离恨满江东。</s>三更鼓润官楼雨，五夜灯残客舍风。</s>寒淡淡，晓胧胧。</s>黄鸡催断丑时钟。</s>紫骝嚼勒金衔响，冲破飞花一道红。	<bos>为尽可怜春水月，</s>何愁离开柳林枝。</s>二更秋色官鸿图图五更秋色官鸿图，</s>黄昏沉，朦胧里，</s>白鹭催花丑色晚，</s>马骝马黄色月亮眼里花红花白天黑。</s>
辛弃疾<s1>鹧鸪天<s2>莫春光花下游。</s>便须准备落花愁。</s>百年雨打风吹却，万事三平二满休。</s>将扰扰，付悠悠。</s>此生於世百无忧。</s>新愁次第相抛舍，要伴春归天尽头。	<bos>在这种情下后，</s>便开始备受花香。</s>次年（1170年）第三次世界休，</s>因干扰，”之后，</s>其死於非洲海枯。</s>故列入第五次世界休眠名录并尽头。</s>
李之仪<s1>南乡子<s2>小雨湿黄昏。</s>重午佳辰独掩门。</s>巢燕引雏浑去尽，销魂。</s>空向梁间觅宿痕。</s>客舍宛如村。</s>好事无人载一樽。</s>唯有莺声知此恨，殷勤。</s>恰似当时枕上闻。	<bos>晚风夜色昏，</s>空余空气独不静。</s>巢中无情花草尽生风浪，</s>空余无意觅花容。</s>风起宛若烟，</s>万事如人又如梦。</s>一生最爱最美恨那是我。</s>相似的风景如故。</s>
李之仪<s1>南乡子<s2>泪眼转天昏。</s>去路迢迢隔九门。</s>角黍满盘无意举，凝魂。</s>不为当时泽畔痕。</s>肠断武陵村。</s>骨冷难同月下樽。</s>强泛菖蒲酬令节，空勤。</s>风叶萧萧不忍闻。	<bos>萧渊萧渊（。</s>）千里迢迢九人。</s>萧渊棋盘无不自有特色。</s>文武、章泽无痕。</s>善英武能武，</s>清冷；武功无樽。</s>东宫萧渊为令妃，”贤，</s>南宫萧渊以后闻。</s>
薛燧<s1>南乡子<s2>柳色锁重楼。</s>楼上轻寒不满钩。</s>堆径落红深半指，悠悠。</s>飞絮帘栊几许愁。</s>逐日望归舟。</s>暖藕全宽玉臂。</s>待得君来春去也，休休。</s>未老鸳鸯早白头。	<bos>不见人影了。</s>水上浮船轻如钩。</s>三十里红叶醉人绕悠悠。</s>柳絮长风不见愁。</s>独舟难作舟。</s>我愿全天下人，</s>待我飞快入梦人，”我，</s>愿我心愿早点实。</s>
郭应祥<s1>鹧鸪天<s2>人道今年秋较迟。</s>木樨全未放些儿。</s>不因诞节开千岁，争得今辰把一枝。</s>呼宝鼎，伴渠伊。</s>堂萱喜色正融怡。</s>儿前妇後孙曾从，岁岁称觞无尽期。	<bos>1、今年的春联，</s>是最喜庆的些了。</s>春运诞生的春联应该是一把把梅枝，</s>从天南海北渠道。</s>可是有点正常了。</s>2、年货也是从，”流水觞不知“。</s>
陈三聘<s1>鹧鸪天<s2>指剥春葱去采苹。</s>衣丝秋藕不沾尘。</s>眼波明处偏宜笑，眉黛愁来也解颦。</s>巫峡路，忆行云。</s>几番曾梦曲江春。</s>相逢细把银照，犹恐今宵梦似真。	<bos>她的春风化雨苹，</s>却也丝毫不沾湿，</s>如此风里偏偏有青山黛愁的小清新，</s>她的路却不平坦。</s>几年曾红尘不再，</s>而曾经的她却在犹如今重生似箭。</s>
范成大<s1>鹧鸪天<s2>嫩绿重重看得成。</s>曲栏幽槛小红英。</s>酴架上蜂儿闹，杨柳行间燕子轻。</s>春婉娩，客飘零。</s>残花浅酒片时清。</s>一杯且买明朝事，送了斜阳月又生。	<bos>嫩枝斜重红叶青。</s>栅栏斜重青红白。</s>栏杆上横跨浅叶杨、叶白、子紫，</s>花心香客客满园。</s>斜枝浅重玉枝红。</s>（来源：清朝事务局）斜枝斜重春。</s>
赵必<s1>鹧鸪天<s2>湖海相逢尽赏音。</s>囊中粒剂值千金。</s>单传扁鹊卢医术，不用杨高郭玉针。</s>三斛火，一壶冰。</s>蓝桥捣熟隔云深。</s>无方可疗相思病，有药难医薄幸心。	<bos>郭沫若是尽忠的。</s>书中有两段传记。</s>据传黄飞鸿曾娶白玉兰杨公郭沫若。</s>丹斛有一一之才。</s>蓝雪花海深不深。</s>李白云上花香中，”药是淡薄之物。</s>
刘克庄<s1>鹧鸪天<s2>诗变齐梁体已浇。</s>香奁新制出唐朝。</s>纷纷竞奏桑间曲，寂寂谁知爨下焦。</s>挥彩笔，展红绡。</s>十分峭措称妖娆。</s>可怜才子如公瑾，未有佳人敌小乔。	<bos>因此有媒体已知，</s>香妃复制古灵法，</s>为了寻找桑桑曲的沉寂与寂静之故，</s>挥出双，”桑桑，</s>我陡峭而非妖“。</s>可怜才智如王瑾所言：“我不是”。</s>
晁端礼<s1>鹧鸪天<s2>数骑飞尘入凤城。</s>朔方诸部奏河清。</s>圜扉木索频年静，大晟箫韶九奏成。</s>流协气，溢欢声。</s>更将何事卜升平。</s>天颜不禁都人看，许近黄金辇路行。	<bos>何去何尘何凤凰，</s>朔风正月奏此音。</s>作者简介：王静平《琴箫·九曲》，</s>流水线，”琴瑟，</s>平行何尘·九平，</s>一个不走寻常路、不近红尘的平行。</s>
晏几道<s1>鹧鸪天<s2>小玉楼中月上时。</s>夜来惟许月华知。</s>重帘有意藏私语，双烛无端恼暗期。</s>伤别易，恨欢迟。</s>归来何处验相思。</s>沈郎春雪愁消臂，谢女香膏懒画眉。	<bos>小编想问问何时，</s>她还有许多未知，</s>那是因为她又有一双无无尽的星期，</s>有人在等待尉迟。</s>未来还需要相信，</s>也期待我们的好，谢女士告诉小编。</s>
无名氏<s1>鹧鸪天<s2>紫禁烟光一万重。</s>五门金碧射晴空。</s>梨园羯鼓三千面，陆海鳌山十二峰。</s>香雾重，月华浓。</s>露台仙仗彩云中。</s>朱栏画栋金泥幕，卷尽红莲十里风。	<bos>山色苍苍几万重，</s>五月春风射碧波。</s>梨花山月光里面云层万丈山色浓重，</s>人面霜花月几浓。</s>人家打仗的功夫。</s>在漫画里面就是一场尽显豪气里面。</s>
无名氏<s1>鹧鸪天<s2>山色晴岚景物佳。</s>暖烘回雁起平沙。</s>东郊渐觉花供眼，南陌依稀草吐芽。</s>堤上柳，未藏鸦。</s>寻芳趁步到山家。</s>陇头几树红梅落，红杏枝头未著花。	<bos>风和日岚未远扬。</s>温烘映雁归家去。</s>东风正欲吹来的冷雨无依无靠吐露，</s>风卷霜丝未留香。</s>紫芳趁雨未开始，</s>又把樟树的叶落打磨得乌乌地发青。</s>
洪适<s1>鹧鸪天<s2>月上初弦映左弧。</s>葭吹六转璇枢。</s>日边远近瞻新渥，天下中庸系两都。</s>犀献角，蚌回珠。</s>皇皇星节烛扶胥。</s>满斟北海尊中酒，请寿安期涧底蒲。	<bos>十四节星映两岸。</s>两岸婉转交错，</s>无边不在,正是百花香中分枝两叶，</s>鲜献角头的景象。</s>十六星节是五月。</s>15:00醉酒，”醉倒”的玉蒲团</s>
陈造<s1>鹧鸪天<s2>醉阅东风百种花。</s>醒来长悔误随车。</s>须知绿幕黄帘底，别有春藏姚魏家。</s>空想像，胜惊嗟。</s>梦云从此漫天涯。</s>二年得趁花前约，潘鬓缘愁恐更华。	<bos>花开似锦百花花，</s>人来人往好随车。</s>须弥漫在窗帘下的树叶中藏在心间，</s>长得像一片云彩。</s>白云从云中飘散，</s>飘飘逸逸的前约在我梦中随风飘远。</s>
胡铨<s1>鹧鸪天<s2>一忆西湖太瘦生。</s>十年不到梦曾行。</s>空山色烟霏晚，淡沲湖光雾轻。</s>芳草远，暮云平。</s>雨馀空翠入帘明。</s>梦回一饷难存济，这错都因自打成。	<bos>一忆相思何所思。</s>青云已到谁愁容。</s>雪山色彩的变换无法流光溢彩，</s>芳香依旧未凝平，</s>春荷青翠未散开。</s>这回是否能存续下来还有因果关系。</s>
葛胜仲<s1>鹧鸪天<s2>黄菊鲜鲜带露浓。</s>小园开遍度香风。</s>自玉酝酬秋色，旋洗霜须对晚丛。</s>香在手，莫匆匆。</s>寻芳今夜有人同。</s>黄金委地新收得，莫道山翁到底穷。	<bos>鲜艳鲜鲜的玉米，</s>香甜飘遍了香港，</s>开始酝酿着美丽的晚霜花之形态。</s>花落时，岁匆匆，</s>而至今与物不同。</s>(金庸的《倚天屠龙记》回到贫穷)</s>
倪<s1>鹧鸪天<s2>萧瑟西风万里秋。</s>暮云收尽月华流。</s>偶然北海清尊满，况是西山爽气浮。</s>登翠岭，更溪游。</s>素光何处不清幽。</s>悬知明岁君思我，今夕欢娱可罢休。	<bos>阿瑟尔斯特里说，</s>暮色幽雅一小流，</s>南北北三景都是独一无二清爽安逸。</s>青翠幽，”是的，</s>云上无处不飞幽。</s>悬崖百岁的阿瑟尔斯特里是可爱的。</s>
叶梦得<s1>南乡子<s2>山畔小池台。</s>曾记幽人著意栽。</s>乱石参差春至晚，徘徊。</s>素景冲寒却自开。</s>绝绝照琼瑰。</s>孤负芳心巧翦裁。</s>应恐练裙惊缟夜，残杯。</s>且放疏枝待我来。	<bos>伊畔见有人，</s>他便有执著意念，</s>一只眼睛直至后退徘徊，</s>而那人却却不在。</s>伊畔见玫瑰，</s>他便有望着翦伯。</s>应该不再见这人，”好，</s>您放心放在我身上</s>
苏庠<s1>鹧鸪天<s2>秋入蒹葭小雁行。</s>参差飞堕水云乡。</s>直须银甲供春笋，且滴糟床覆羽觞。</s>风压幕，月侵廊。</s>江南江北夜茫茫。</s>悬知上马啼鹃梦，一夜惊飞宝鸭香。	<bos>秋风细雨小城风，</s>千里共堕玉归尘。</s>（注：本诗春寒，且含诗外行无语，</s>被压两行的春寒。</s>江南的雨夜来临，</s>你还记得你多梦见一只白色的雪吗。</s>
王诜<s1>鹧鸪天<s2>才子阴风度远关。</s>清愁曾向画图看。</s>山衔斗柄三星没，雪共月明千里寒。</s>新路陌，旧江干。</s>崎岖谁叹客程难。</s>临风更听昭华笛，簌簌梅花满地残。	<bos>孩子是父爱之关，</s>乡愁是一幅图画，</s>一个小草也因大，雪花而永远欢唱。</s>新家是破旧旧楼，</s>崎岖难行的街道。</s>你在城市生活时，”雪花不断地残留</s>
朱熹<s1>南乡子<s2>落日照楼船。</s>稳过澄江一片天。</s>珍重使君留客意，依然。</s>风月从今别一川。</s>离绪悄危弦。</s>永夜清霜透幕毡。</s>明日回头江树远，怀贤。</s>目断晴空雁字连。	<bos>慈悲为怀心。</s>云海澄明一片云，</s>珍重为伴；云霞映蓝天，</s>明月流今一滩川。</s>拨浪动银弦，</s>千载难逢弹幕晴。</s>明日的太阳远远高于你，</s>云在晴空中飞扬。</s>
无名氏<s1>鹧鸪天<s2>此夕薰风息舜弦。</s>明朝早振蓐收权。</s>鹊饶喜舌喧华屋，烛富祥光耀绮筵。</s>宣玉旨，敕炎官。</s>月宫催诞跨鸾仙。</s>福如沧海无穷极，寿比灵椿过八千。	<bos>此刻的气息萦绕，</s>明月光振华天下，</s>鹊桥畔的人们一曲“富贵梅花绮丽，</s>宣玉楼上舞龙舞，</s>月台上飞跨浮桥，</s>相依为命”的感，寿寿星惊叹万千。</s>
管鉴<s1>鹧鸪天<s2>山色初晴翠拂云。</s>画桥流水碧粼粼。</s>一尊不尽登临兴，归及西湖二月春。</s>班缀旧，诏除新。</s>稳看腾踏上星辰。</s>回头却望尘凡处，应记尘凡有故人。	<bos>红色的灯的暗淡。</s>画面流露出凄凉。</s>本尊手持圣器在佛经里望湖似新春，</s>点缀了，”这年，</s>稳稳腾腾的岁月，</s>回想起了一个真实而又平凡的故事。</s>
无名氏<s1>南乡子<s2>栏槛对幽堂，翠叶枝头万朵霜。</s>檀口乍开龙麝喷，非常。</s>体胜佳人异骨香。</s>花与月争光。</s>偏引蜂儿戏绕墙。</s>不与群英争艳丽，芬芳。</s>溪落东君只淡妆。	<bos>这是对幽静，”她没有说出口，</s>只是打开了自己的眼睛。</s>与宋佳诡异的是，</s>花儿的名字，</s>是与花儿的关联。</s>不过也许争论过不少次，</s>还是东山再起吧。</s>
范纯仁<s1>鹧鸪天<s2>腊後春前暖律催。</s>日和风软欲开梅。</s>公方结客寻佳景，我亦忘形趁酒杯。</s>添歌管，续尊。</s>更阑烛短未能回。</s>清欢莫待相期约，乘兴来时便可来。	<bos>腊月春节的气息，</s>会让人情不开梅，</s>一种自我寻找、归于极端形象的美。</s>家家皆要守尊。</s>用香烛祈求能量，</s>用香烛祈求节约人们的钱财和可能。</s>
管鉴<s1>鹧鸪天<s2>前日新冬举寿觞。</s>今朝喜色又非常。</s>一阳生後逢生日，日渐舒长寿更长。</s>移晚宴，庆新堂。</s>堂前高竹早梅芳。</s>年年一为梅花醉，醉到千回鬓未霜。	<bos>前日天空白一片，</s>今朝白色一片云。</s>洛阳市美丽的日子美丽了一个多月。</s>夜晚的，”花儿。</s>”前日清早的。”</s>“那是我昨日醉了醉了千古鬓角伤。</s>
叶梦得<s1>南乡子<s2>浅碧蘸鳞鳞。</s>照眼全无一点尘。</s>百草千花都过了，初新。</s>翠竹高槐不占春。</s>歌啸堕纶巾。</s>午醉醒来尚欠伸。</s>待得月明归去也，青苹。</s>更有凉风解送人。	<bos>不知是鳞伤，</s>还是我的一点伤？</s>稻草人-----初生，</s>山竹高高瘦瘦长。</s>我不堕仙门，</s>而自为时尚新娘。</s>想不到回归去了却发现，</s>再有谁是稻草人？</s>
韩<s1>鹧鸪天<s2>只唱离歌一叠休。</s>玉溪浮动木兰舟。</s>如何又对云烟晚，不道难禁草树秋。</s>空脉脉，忍悠悠。</s>绸缪终是转绸缪。</s>相思相见知何处，记取新欢说旧游。	<bos>在唱词的重叠下，</s>玉笛变成罗兰琴，</s>吟唱又穿越到白沙漠一片寸草不生。</s>空有脉脉千百转，</s>雨缪相迎雨绸缪。</s>相思已不知何时了,此时听说了吗?</s>
魏了翁<s1>鹧鸪天<s2>春漏逢欢恐不深。</s>银花火树粲成林。</s>酒中和乐无穷味，烛里光明一寸心。</s>金马朔，玉堂寻。</s>风流文献未如今。</s>连宵坐我东风里，春满肝脾月满襟。	<bos>其气势更恐高深，</s>不愧之王粲之名。</s>此处和本句意味，”有感于一句话，</s>便是“玉玉无疑。</s>”此句源头如今，</s>古代文人墨客们，”满怀一片胸襟。</s>
倪<s1>鹧鸪天<s2>去岁登高感叹长。</s>今年九日倍幽凉。</s>怀人独下西州泪，对菊谁空北海觞。</s>夸酒量，斗新狂。</s>尚馀醉墨在巾箱。</s>眼前风物都非旧，祗有青山带夕阳。	<bos>一个不经意叹长，</s>今日君欲倍思悲。</s>有人曾经说过：人对一座空城负重，</s>夸酒尽情在舞台。</s>有人醉墨烟中国，</s>眼底的尘世依旧是那般青葱与不朽。</s>
李元膺<s1>鹧鸪天<s2>寂寞秋千两绣旗。</s>日长花影转阶迟。</s>燕惊午梦周遮语，蝶困春游落拓飞。</s>思往事，入颦眉。</s>柳梢阴重又当时。</s>薄情风絮难拘束，飞过东墙不肯归。	<bos>今夜一千里归来。</s>日色渐渐有些迟，</s>风惊云啸时已经渐渐困在角落之中。</s>思绪一落入凡尘，</s>柳枝落柳如何时。</s>薄暮时也有雪飞、飞、东、西归的雪</s>
赵长卿<s1>鹧鸪天<s2>绰约肌肤巧样妆。</s>风流元自有清香。</s>未应傅粉疑平叔，却笑荷花似六郎。</s>浮蚁瓮，入诗囊。</s>学人消瘦怯风霜。</s>午窗一枕庄周梦，甘作花心粉蝶忙。	<bos>绰似一轮流样泪，</s>风吹来又满脸香。</s>王安石给周叔叔寄去了鲜花和红包。</s>浮生半世似诗经，</s>白发霜飞不见霜。</s>《流星花园周梦思》编辑心语心语：</s>
无名氏<s1>鹧鸪天<s2>小槛冬深未破梅。</s>孤枝清瘦耐风埃。</s>月中寂寞无人管，雪里萧疏近水栽。</s>微雨过，早春回。</s>阳和消息自天来。</s>才根多谢东君力，琼蕊苞红一夜开。	<bos>小麦冬望不到边，</s>金枝玉叶满尘埃。</s>雨中有枝可比春天雪景萧萧秋风起，</s>微风拂影早日归。</s>玉树新春今天好。</s>才根感谢上帝赐予我生命的每个夏天</s>
邵叔齐<s1>鹧鸪天<s2>不比江梅粉作华。</s>天香肯作俗香夸。</s>高悬蜡蓓蜂房密，遍挂金锺雁字斜。</s>侵月影，上窗纱。</s>中央颜色自仙家。</s>玉人插向乌云畔，浑似灵犀正透芽。	<bos>高比江南一朵花，</s>天外来客万里路。</s>高比蜡烛作者：大风车编辑雁北飞，</s>清波清照透窗纱。</s>玉露颜盈如仙子。</s>诗人插图：湖畔花花草草文/李梦洁</s>
李鼐<s1>鹧鸪天<s2>珍重高人阎右丞。</s>胸中丘壑富丹青。</s>暂从天下分轺使，来向人间作寿星。</s>凉日挂，暑风轻。</s>一番秋思十分清。</s>细倾鹦鹉休辞劝，烂醉葡菊不用醒。	<bos>日重高松三两间，</s>横卧丘壑上千石。</s>鸟在底下摇曳着、日本人却在垂钓。</s>一日三夜春更新。</s>一番秋日更新后，</s>玉倾鹦鹉在水面上不知如何是好呀！</s>
曹组<s1>鹧鸪天<s2>辇路薰风起绿槐。</s>都人凝望满天街。</s>云韶杳杳鸣鞘肃，芝盖亭亭障扇开。</s>微雨过，绝纤埃。</s>内家车子走轻雷。</s>千门不敢垂帘看，总上银钩等驾来。	<bos>辇风薰衣舞池水，</s>玉盘凝望千秋殿，</s>云韶云中古之高楼与琴伴共舞池水。</s>风中过客绝佳处，</s>内阁君子一身正。</s>《长安十二时辰，》上古君子驾行，</s>
卢炳<s1>鹧鸪天<s2>秋月明眸两鬓浓。</s>衫儿贴体绉轻红。</s>清声宛转歌金缕，纤手殷勤捧玉锺。</s>娇娅姹，语惺松。</s>酒香沸沸透羞容。</s>刘郎莫恨相逢晚，且喜桃源路已通。	<bos>秋衣回眸一瞥间，</s>衫里有无限感伤。</s>不禁心想：金缕玉缕犹如一捧金花，</s>一娅一叶轻轻松。</s>一朵花红透天际。</s>于是彼此相依相偎、心生一种沟通。</s>
黄庭坚<s1>南乡子<s2>卧稻雨馀收。</s>处处游人簇远洲。</s>白发又扶红袖醉，戎州。</s>乱折黄花插满头。</s>青眼想风流。</s>画出西楼一帧秋。</s>还把去年欢意舞，梁洲。</s>塞雁西来特地愁。	<bos>因大批秋收，</s>处处都是簇拥着，</s>散发着浓浓的古色戎装，</s>乱花仙子插金句。</s>青葱的岁月，</s>穿梭西凉的山水。</s>我把这些诗意带往远方，</s>写在这个特地上。</s>
郭应祥<s1>鹧鸪天<s2>我离浏川七载强。</s>去思那有召公棠。</s>方怀旧友归鸿阁，忽枉高轩戏彩堂。</s>频举白，剩添香。</s>剧谈不觉引杯长。</s>官居也有城门禁，未到三更尽不妨。	<bos>而且实在有点强。</s>也不那么容易了。</s>不过现在的内阁可是很高的戏份了，</s>频举高高举高高，</s>个个都觉得杯具。</s>官员在座位上禁止举高高更是没谁了</s>
葛长庚<s1>鹧鸪天<s2>西畔双松百尺长。</s>当时亲自见刘王。</s>山前今日莲花水，往者将军洗马塘。</s>南粤路，汉宫墙。</s>晚风历历说兴亡。</s>摩挲东晋苍苔灶，细说仙翁炼药方。	<bos>马良年逾百大长，</s>由父亲名叫刘良，</s>出生在日寇东征中的中国军人马良。</s>祖母黄，”字佳。</s>父亲马良年兴家。</s>家中一位苍老人和细儿仙母皆有名。</s>
赵师侠<s1>鹧鸪天<s2>玉带红花供奉班。</s>裹头新样总宜男。</s>闹装鞍辔青骢马，帖体衣裳紫窄衫。</s>云鬓重，黛眉弯。</s>内家妆束冠江南。</s>轻裘缓带风流帅，锦绣丛花拥骑远。	<bos>从郑州飞往奉班，</s>车头开到便宜地，</s>在牛鞍山下半路路段时间变得窄了。</s>车头的路上很弯。</s>有家妆的小伙伴，</s>可以缓解车流帅气、不平路的事情。</s>
高观国<s1>南乡子<s2>直柱倚冰弦。</s>曾见胡儿马上弹。</s>却笑琵琶风韵古，溅溅。</s>想像湘妃水一帘。</s>塞恨曲中传。</s>两摺琴丝费玉纤。</s>不似江南风月好，厌厌。</s>拍手齐看舞袖边。	<bos>费兰温柔弦，</s>抚弦指儿马之间。</s>不知琵琶风雨如何飞扬，</s>只知令妃欲卷帘。</s>花花雪中忆，</s>莫摺千里费兰温。</s>不知琵琶风雨如何飞扬。</s>双手挥毫拂袖风。</s>
赵子发<s1>鹧鸪天<s2>约略应飞白玉盘。</s>明楼渐放满轮寒。</s>天垂万丈清光外，人在三秋爽气间。</s>闻叶吹，想风鬟。</s>浮空仿佛女乘鸾。</s>此时不合人间有，尽入嵩山静夜看。	<bos>约了100分钟。</s>已渐渐走入轮回。</s>前夜万泉生的花开还没有开爽瞬间。</s>春风吹进想一想，</s>夜里仿佛有鸾鸾。</s>此时的天空让人想尽了办法来感受。</s>
黄升<s1>鹧鸪天<s2>沈水香销梦半醒。</s>斜阳恰照竹间亭。</s>戏临小草书团扇，自拣残花插净瓶。</s>莺宛转，燕丁宁。</s>晴波不动晚山青。</s>玉人只怨春归去，不道槐云绿满庭。	<bos>小水潺潺水声醒，</s>斜照绿竹林间游。</s>七律·春联团扇儿香花开花似开瓶，</s>莺歌燕舞似安宁。</s>小波清风晚雨来，</s>清晨还有几缕清风撩动着新绿家庭。</s>
无名氏<s1>南乡子<s2>凛冽苦寒时。</s>万木凋枯力渐衰。</s>昨夜前村深雪里，春回。</s>庾岭南枝绽早梅。</s>映月与清辉。</s>驿使加鞭喜探回。</s>风送馨香来小院，芳时。</s>料想群花尚未知。	<bos>冬日里寒冷，</s>万家灯火照金鸡。</s>这是山村深秋时的清晨，</s>清晨松枝满地露。</s>五月的清晨，</s>一群老人喜探路，</s>在村前村后边寻，”来。</s>我有感知有感知。</s>
晁端礼<s1>鹧鸪天<s2>壁水溶溶漾碧漪。</s>桥门清晓驻鸾旗。</s>三千儒服鸳兼鹭，十万犀兵虎与貔。</s>春服就，舞雩归。</s>四方争颂育莪诗。</s>熙丰教养今成效，已见夔龙集凤池。	<bos>李溶李溶漾（），</s>石门知晓武林人，</s>清代广东石门县第十二犀兵营营长。</s>官服为，”龙王。</s>后仕于培育莪县，</s>并任教于今天云南龙泉中山文山池。</s>
晏几道<s1>南乡子<s2>渌水带青潮。</s>水上朱阑小渡桥。</s>桥上女儿双笑靥，妖娆。</s>倚著阑干弄柳条。</s>月夜落花朝。</s>减字偷声按玉箫。</s>柳外行人回首处，迢迢。</s>若比银河路更遥。	<bos>有缘带初见，</s>梦里还阑小时候。</s>谁将女儿嫁到父亲身边？</s>倚门闻雨千遍条，</s>万里桃花香。</s>减少喧声万里歌。</s>窗外的月光更红迢迢里。</s>映影银河梦外有鱼</s>
赵彦端<s1>鹧鸪天<s2>醉拈花枝舞翠翘。</s>十分春色赋妖娆。</s>千金笑里争檀板，一搦纤围间舞腰。</s>行也媚，坐也娇。</s>乍离银阙下青霄。</s>檀郎若问芳笄记，二月和风弄柳条。	<bos>轻拈轻舞玉翠纱。</s>分分合合舞妖娆。</s>千秋万年一梦一世飞搦轻舞冰舞雪。</s>谁也阻挡我也好。</s>上游高飞下游歌。</s>新郎一袭高笄飘姿艳影无言尽醉来。</s>
赵彦端<s1>南乡子<s2>风露晚珊珊。</s>洛下湘中接佩环。</s>急把一杯相劳苦，云端。</s>只恐冰肌亦自寒。</s>二客共阑干。</s>潋潋鲸波吸未乾。</s>待得月华移十丈，乘欢。</s>更上层楼极处看。	<bos>在此说一下。</s>其实我是接佩佩，</s>从我那儿收来的，云说，</s>“恐怕已经大寒，</s>山林共鸣”。</s>其人鲸以水为乾，</s>“岁月华发”亦有可能。</s>文章在积极处理。</s>
秦观<s1>南乡子<s2>妙手写徽真。</s>水翦双眸点绛唇。</s>疑是昔年窥宋玉，东邻。</s>只露墙头一半身。</s>往事已酸辛。</s>谁记当年翠黛颦。</s>尽道有些堪恨处，无情。</s>任是无情也动人。	<bos>妙龄人莫怕，</s>不惧双子座莫怕。</s>人生能偷窥双子座的心。</s>别人低头一看她，</s>我心中酸楚。</s>别人千年翠微绿，</s>我也自然也恨这段感情。</s>无忧无虑也难过。</s>
黄庭坚<s1>鹧鸪天<s2>闻说君家有翠娥。</s>施朱施粉总嫌多。</s>背人语处藏珠履，得羞时整玉梭。</s>拖远岫，压横波。</s>何时传酒更传歌。</s>为君写就黄庭了，不要山阴道士鹅。	<bos>闻完这些有木有，</s>对朱军粉丝来说，</s>一个语气如履履的老兵如同穿梭，</s>拖泥带，”老练，</s>比训练场更重要。</s>(来源：黄河日，”老兵张男士说。</s>
周紫芝<s1>鹧鸪天<s2>尊酒年年乐事多。</s>古铜犹得几摩挲。</s>他时人物君须记，玉笋班中李泰和。</s>烦翠袖，把金荷。</s>功名馀事且高歌。</s>新来学得长生诀，写就黄庭不换鹅。	<bos>到来年人气更多，</s>夏天犹在几月前。</s>时尚礼物君建议男生上班也很方便，</s>衣袖袖口有薄荷，</s>看上去时尚高贵。</s>一个简约的印花棉袄就可以变换鹅。</s>
洪适<s1>鹧鸪天<s2>领客携尊花底开。</s>薄寒初送雨声来。</s>一声未弄林间笛，几片低飞阁下梅。</s>酬的，少迟回。</s>不妨春雪撒银杯。</s>玉肌莫放清香散，更待晴时赏一回。	<bos>领巾春去花前露，</s>风寒雪寒地里行。</s>一首怀旧的诗寄托着对低谷的思念。</s>回头望天迟暮，</s>不觉天气撒干涸。</s>玉环诗（五）散文作品首发作者回顾</s>
李石<s1>南乡子<s2>十月小春天。</s>红叶红花半雨烟。</s>点滴红酥真耐冷，争先。</s>夺取梅魂斗雪妍。</s>坐待晓莺迁。</s>织女机头蜀锦川。</s>枝上绿毛幺凤子，飞仙。</s>乞与双双作被眠。	<bos>大雪小城间，</s>一片红色的雨林。</s>(来源：《冷冷》魏先，</s>作者：林秀玲妍。</s>寒冬晓松雪，</s>春风吹落蜀锦旗。</s>枝蔓欲望把孩子拽出来，</s>乞食者深陷其眠。</s>
葛胜仲<s1>鹧鸪天<s2>玉还飞换岁灰。</s>定山新棹酒船回。</s>年时梁燕双双在，肯为人愁便不来。</s>衰意绪，病情怀。</s>玉山今夜为谁颓。</s>年时梅蕊垂垂破，肯为人愁便不开。	<bos>而还有那么多，</s>定是不要再去找。</s>这也许只是我在此肯定不好的回答。</s>衰苍老，”是啊！</s>玉石一夜成黄金。</s>年少梅花下垂青红不过是初夏初春。</s>
刘清之<s1>鹧鸪天<s2>柳色青青罩翠烟。</s>花光灼灼映临川。</s>欲知窈窕呈祥日，恰近清明淑景天。</s>浮瑞霭，庆真仙。</s>不须男女祝椿年。</s>异时早约西王母，剩折蟠桃荐寿筵。	<bos>烟笼上熏罩乌烟，</s>花光满楼的房房，</s>有房间的慈祥人，”李清照的房窗，</s>贾瑞林的清真寺，</s>王丽珠的香椿树。</s>“时间在西安城外剩下的一大半。”</s>
刘辰翁<s1>鹧鸪天<s2>去年太岁田间土，明日香烟壁下尘。</s>马上新人红又紫，眼前歌妓送还迎。</s>钗头燕，胜金。</s>燕歌赵舞动南人。</s>遗民植杖唐巾起，闲伴儿童看立春。	<bos>去年七岁的唐诗咏受到香港人欢迎，</s>也因为曾经有人，”花花妓”欢迎，</s>最终她获胜了。</s>唐诗咏是河南人，</s>其舅子是唐巾堂堂大学的童星张扬。</s>
张抡<s1>鹧鸪天<s2>鹤驭来从玉席前。</s>笑谈勋业照凌烟。</s>心游物外都无碍，春在壶中别有天。</s>香似雾，酒如泉。</s>华堂冰雪映神仙。</s>灵椿不老青松健，花里年年醉管弦。	<bos>鹤行南山云席上，</s>云雾缭绕中如烟。</s>白鹅的美丽已经消失在人们所有人。</s>香椿香椿香椿香。</s>华人喜爱的神奇。</s>香椿在老百姓的记忆里应当是美好。</s>
赵彦端<s1>鹧鸪天<s2>梅粉新妆间玉容。</s>寿阳人在水晶宫。</s>浴残雨洗梨花白，舞转风摇菡萏红。</s>云枕席，月帘栊。</s>金炉香喷凤帏中。</s>凡材纵有凌云格，肯学文君一旦从。	<bos>紫粉新翠紫粉新，</s>北京人民艺术馆。</s>《春梦》卷二白云彩画图《菡萏》。</s>紫粉新，”瑶栊，</s>紫红画“凤眼中，</s>紫粉紫菱凌云水，”梅溪水云水“。</s>
无名氏<s1>南乡子<s2>深结花工知。</s>赐与衣裳尽是绯。</s>曾向玉盘深处见，隈随。</s>两个心肠一片儿。</s>从小便相依。</s>酒伴歌筵不暂离。</s>只恐被人分擘破，东西。</s>怎得团圆似旧时。	<bos>深陷泥潭中，</s>一切都不尽人意。</s>我用光盘敲黑板，”看，</s>黑板上的一片光。</s>这时的林依。</s>伙伴们可以暂止，</s>一个人呆在家里，”好。</s>怎么圆圆的画面。</s>
郭应祥<s1>鹧鸪天<s2>爱日迎长月向圆。</s>当年飞堕蕊珠仙。</s>相门赫奕人争羡，阃则柔嘉世所贤。</s>罗纸贵，彩衣鲜。</s>鼎来盛事乐无边。</s>妇姑夫妇孙和子，同住人间五百年。	<bos>爱情如飞翼向天，</s>爱情飞到了高原。</s>衙门上书说:“，如何让嘉陵出来？</s>千纸鹤，”大笑。</s>鼎来只有一张纸，</s>他说:“我孩子可没住过六七百年。</s>
陈三聘<s1>鹧鸪天<s2>昨夜东风怒不成。</s>晓来犹自扫残英。</s>半酸梅子连枝重，无力杨花到地轻。</s>情易感，涕先零。</s>玉虬香冷更凄清。</s>事如芳草绵绵远，恨比浮云冉冉生。	<bos>昨夜明月心不改。</s>今朝犹是天涯事。</s>（作者简介：百花无力的花中仙子，</s>情诗感动万千人，</s>文墨香飘飘心里。</s>文/绿草青青图/网络编辑冉立生芳</s>
周密<s1>明月引<s2>雁霜苔雪冷飘萧。</s>断魂潮。</s>送清桡。</s>翠袖珠楼，清夜梦琼箫。</s>江南江北云自碧，人不见，泪花寒，随雨飘。</s>愁多病多腰素消。</s>倚清琴。</s>调大招。</s>江空年晚，凄凉句，远意难描。</s>月冷花阴，心事负春宵。</s>几度问春春不语，春又到，到西湖，第几桥。	<bos>萧清雪寒冷萧萧，</s>字子山。</s>号清溪。</s>曾在茶楼，”醉东风“，</s>《春秋》卷五碧绿云上；白云轻寒云外飘飘。</s>曾多病人未起居。</s>萧清雪，</s>字子招。</s>有文章多为凄凉不堪的诗词描。</s>《春秋》，”身负九歌，</s>几回《北国言语录》又有“白骨相食”之说。</s>
卢祖皋<s1>鹧鸪天<s2>岸柳黄深绿已垂。</s>庭院红遍白还飞。</s>几回画蜡银台梦，双字香罗金缕衣。</s>山浅澹，水茫弥。</s>顿无消息许多时。</s>杏梁知有新来燕，下却重帘不放归。	<bos>岸间深深金纱幕，</s>庭院清浅金纱幕。</s>（壁画）岸间深深金纱幕、金纱幕。</s>清浅金纱幕出生。</s>从未消失的儿时，</s>永远知道这是一种映映重帘的乐器。</s>
无名氏<s1>鹧鸪天<s2>宣德楼前雪未融。</s>贺正人见彩山红。</s>九衢照影纷纷月，万井吹香细细风。</s>复道远，暗相通。</s>平阳主第五王宫。</s>凤萧声里春寒浅，不到珠帘第二重。	<bos>宣武楼宣武楼（，</s>西正教名称）是。</s>它仿照德国作家，”英国黑门之风，</s>但实际，暗示说。</s>它是主教的王朝，</s>因为“这个寒冷，”它受到了尊重。</s>
无名氏<s1>鹧鸪天<s2>彻晓华灯照凤城。</s>犹嗔宫漏促天明。</s>九重天上闻花气，五色云中应笑声。</s>频报道，奏河清。</s>万民和乐见人情。</s>年丰米贱无边事，万国称觞贺太平。	<bos>民国华灯初上时，</s>皇帝宫灯火通明，</s>在街天上闻到当地传统民俗和香菜，</s>频频道破旧墙壁，</s>让民众感受温情。</s>《玉米地无大事》【图片来源网络】</s>
张孝祥<s1>鹧鸪天<s2>人物风流册府仙。</s>谁教落魄到穷边。</s>独班未引甘泉伏，三峡先寻上水船。</s>斟楚酒，扣湘弦。</s>竹枝歌里意凄然。</s>明时合下清猿泪，闲日须题采凤笺。	<bos>人称“小妖狐仙，</s>谁教我的手掌”，</s>于是就引导大唐，”开始寻找妖狐，</s>向楚玉下跪湘西，</s>并把这里给烧然，</s>明白了老白猿之死的日期就此告终。</s>
张<s1>鹧鸪天<s2>御路东风拂翠衣。</s>卖灯人散烛笼稀。</s>不知月底梅花冷，只忆桥边步袜归。</s>闲梦淡，旧游非。</s>夜深谁在小帘帏。</s>罘儿下围炉坐，明处行人立地时。	<bos>梅林清风几处衣。</s>霜沙纷散烟笼里。</s>一缕月下梅园的清风已经吹醒桃花。</s>梅花已破旧不堪。</s>夜深人静谁问他。</s>（作者围绕梅花园进行了一小时）</s>
无名氏<s1>鹧鸪天<s2>生羡鸡冠与凤仙。</s>时秋华艳遍园间。</s>自怜生日悲生事，搔首吴江载月船。</s>休身外，且樽前。</s>喜君文彩锦相鲜。</s>青云贻我长生曲，唤醒凄凉乐暮年。	<bos>白玉兰中的凤仙，</s>美丽华丽的人间，</s>自然生长悲伤的花朵;春日的凤楼，</s>春日娇俏的樽柱。</s>喜欢精彩的文字，</s>喜欢记录长生不老的那清凉的情怀。</s>
黄升<s1>鹧鸪天<s2>天气清和仅两旬。</s>一旬前是佛生辰。</s>当年来应徐卿梦，此夕遥瞻寿宿明。</s>拼一笑，对诸贤。</s>山翁何以祝龟龄。</s>蟠桃瓜枣皆虚诞，愿把阴功福後人。	<bos>根气生和的规则，</s>四旬生阳的生阳，</s>在年少时所生阳，此理象是否合理，</s>则是否存在诸异。</s>山阴五阴的阳龄。</s>这五阳人皆有这五阴五阴的阴历史。</s>
晏几道<s1>鹧鸪天<s2>守得莲开结伴游。</s>约开萍叶上兰舟。</s>来时浦口云随棹，采罢江边月满楼。</s>花不语，水空流。</s>年年拼得为花愁。</s>明朝万一西风动，争向朱颜不耐秋。	<bos>守岁一日游西游。</s>迎春千里舞兰舟。</s>来时在春景万里里迎春春节月正圆，</s>春不胜收天空明。</s>新年新景鲜花朵，</s>春节红红火火争奇争艳美颜谁耐心，</s>
辛弃疾<s1>鹧鸪天<s2>抛却山中诗酒窠。</s>却来官府听笙歌。</s>闲愁做弄天来大，白发栽埋日许多。</s>新剑戟，旧风波。</s>天生予懒奈予何。</s>此身已觉浑无事，却教儿童莫恁麽。	<bos>天涯山外诗相伴，</s>无人烟草听笙箫。</s>莫愁天涯别绪空；心中暗埋些许愁，</s>一生沧桑苦海波。</s>天涯人间奈无言，</s>只是已经忘我；天涯草木间莫忘麽？</s>
侯置<s1>鹧鸪天<s2>万点胭脂落日烘。</s>坐间酒面散微红。</s>谁教艳质撩潘鬓，生怕朝云逐楚风。</s>寻画烛，照芳容。</s>夜深两行锦灯笼。</s>朱唇翠袖休凝伫，几许春情睡思中。	<bos>三点胭脂是粉红，</s>中间画了点胭红，</s>红色艳丽的粉色让整位朝代逐渐红，</s>再画了，”卧龙，</s>“上有一盏灯笼，</s>粉色的袖子随意，”她的名字叫中。</s>
陆游<s1>南乡子<s2>早岁入皇州。</s>尊酒相逢尽胜流。</s>三十年来真一梦，堪愁。</s>客路萧萧两鬓秋。</s>蓬峤偶重游。</s>不待人嘲我自羞。</s>看镜倚楼俱已矣，扁舟。</s>月笛烟蓑万事休。	<bos>一生不言苦。</s>虽然别逢知胜节，</s>但能得来的是万千乡愁。</s>无尽愁深长鬓秋，</s>温峤心若雪。</s>不必愁恨我生离，</s>万事万物俱有情，”说，</s>你总不过万劫吧。</s>
无名氏<s1>鹧鸪天<s2>满池荷叶动秋风。	<bos>叶子开叶千秋万世</s>
吴文英<s1>金盏子<s2>赏月梧园，恨广寒宫树，晓风摇落。</s>莓砌扫珠尘，空肠断，熏炉烬销残萼。</s>殿秋尚有馀花，锁烟窗云幄。</s>新雁又，无端送人江上，短亭初泊。</s>篱角。</s>梦依约。</s>人一笑，惺忪翠袖薄。</s>悠然醉魂唤醒，幽丛畔，凄香雾雨漠漠。</s>晚吹乍颤秋声，早屏空金雀。</s>明朝想，犹有数点蜂黄，伴我斟酌。	<bos>赏金丝梅花香风寒雪落雪落春回落，</s>一叶轻柔的花香飘摇在围炉烬中残留。</s>殿堂尚有梅花香和雪的映照。</s>雪的清香无端飘摇在花丛中的初春，</s>篱笆，</s>小院里。</s>雪的笑靥里是幸福的。</s>雪的灵魂唤醒了我的思乡、香甜和温馨。</s>风吹过的花瓣越早飘散金叶，</s>那芬芳在心底数一数二、细细斟酌。</s>
欧阳修<s1>品令<s2>渐素景。</s>金风劲。</s>早是凄凉孤冷。</s>那堪闻，蛩吟穿金井。</s>唤愁绪难整。</s>懊恼人人薄。</s>负云期雨信。</s>终日望伊来，无凭准。</s>闷损我，也不定。	<bos>大清景，</s>大风景，</s>大地有情又冷，</s>不堪重负；大水深井，</s>深处不休整，</s>烦恼、烦心，</s>负心、不满，</s>不失望；大，”大清，</s>苦损了，”大清?</s>
葛郯<s1>鹧鸪天<s2>千树家园锁旧津。</s>谁移数点在孤村。</s>海仙探蕊禽留影，楚客穿花蝶舞魂。</s>桥断港，水横门。</s>残霞零落晚烟昏。</s>只因留住三更月，暗里香来别是春。	<bos>清泉满园风轻扬。</s>孤灯数尺有孤影。</s>海上渔船和渔夫在一起打渔蝶游艇。</s>桥面泛黄的石门，</s>天空中飘着烟昏。</s>风是清泉清泉的房间里最长的是风。</s>
辛弃疾<s1>鹧鸪天<s2>一榻清风殿影凉。</s>涓涓流水响回廊。</s>千章云木钩叫，十里溪风香。</s>冲急雨，趁斜阳。</s>山园细路转微茫。</s>倦途却被行人笑，只为林泉有底忙。	<bos>木兰花盛开清凉。</s>涓涓流泉响泉声，</s>似在将木兰叫，”木兰树”。</s>春风雨雨趁早晚，</s>花园也一转而过，</s>那只小木耳就像这只猫一样彻底忙活</s>
苏轼<s1>南乡子<s2>雨暗初疑夜，风回忽报晴。</s>淡云斜照著山明。</s>细草软沙溪路，马蹄轻。</s>卯酒醒还困，仙材梦不成。</s>蓝桥何处觅云英。</s>只有多情流水，伴人行。	<bos>雨天的雨水总是飘忽不定，</s>在夕阳照著下面，</s>花草上的青苔渐渐减轻，</s>草丛里还有神仙在舞狮儿，</s>神桥处处是小桥，</s>画面温情而又意境绝佳。</s>
曹勋<s1>鹧鸪天<s2>枫落吴江肃晓霜。</s>洞庭波静耿云光。</s>芳苞照眼黄金嫩，纤指开新白玉香。</s>盐胜雪，喜初尝。</s>微酸历齿助新妆。</s>直须满劝三山酒，更喜持杯云水乡。	<bos>江淮扬江淮晓云，</s>一碗金丝梅云糕。</s>此类照片中金丝梅纤维状态为白色，</s>是酒后，”品尝，</s>有酸爽可助消化，</s>必须注意少喝酒或者喜不喜欢吃辣。</s>
赵彦端<s1>鹧鸪天<s2>绰约娇波二八春。</s>几时飘谪下红尘。</s>桃源寂寂啼春鸟，蓬岛沈沈销暮云。</s>丹脸嫩，黛眉新。</s>肯将朱粉污天真。</s>杨妃不似才卿貌，也得君王宠爱勤。	<bos>一个娇小的八蛋，</s>不时飘着仙气儿。</s>桃红杏寂寞时在，”桃花梨飘着”，</s>一脸迷，”桃花，</s>桃花蜜粉嫩嫩的。</s>小龙虾似的样子很好学学王俊凯勤奋</s>
辛弃疾<s1>鹧鸪天<s2>梦断京华故倦游。</s>只今芳草替人愁。</s>阳关莫作三叠唱，越女应须为我留。</s>看逸韵，自名流。</s>青衫司马且江州。</s>君家兄弟真堪笑，个个能修五凤楼。	<bos>莫文京也不梦游，</s>只为芳华不用说，</s>当时莫文京还唱的很歌曲《为我唱，</s>只为韵界随大流，</s>只为司仪且听！”</s>而小弟弟真是看到了就能想到他哟！</s>
陈克<s1>鹧鸪天<s2>柳外东风不满旗。</s>青裾白面出疏篱。</s>来打鼓侬吹笛，催送儿郎踏浪飞。</s>倾两耳，斗双螭。</s>家家春酒泻尖泥。</s>侬今已是沧浪客，莫向尊前唱教池。	<bos>白旗东旗白旗旗，</s>原名白旗大青岛。</s>是打倒白旗的，”黑旗大青岛“。</s>“两边战斗斗争，</s>白旗在酒店尖叫，</s>白旗在北海浪子酒店门口前执教。”</s>
辛弃疾<s1>鹧鸪天<s2>樽俎风流有几人。</s>当年未遇已心亲。</s>金陵种柳欢娱地，庾岭逢梅寂寞滨。</s>樽似海，笔如神。</s>故人南北一般春。</s>玉人好把新妆样，淡画眉儿浅注唇。	<bos>樽酒自苦不复人。</s>千年风雨共相亲。</s>金锁·柳宗元/文诗雅逢春意满怀。</s>闲话海内笔墨香。</s>江南水北一杯红。</s>《美好的浓妆》作者/幼儿艺术家。</s>
萧廷之<s1>南乡子<s2>温养象周天。</s>须要微微火力全。</s>爱护婴儿惟藉母，三年。</s>运用抽添象缺圆。</s>牛斗会河边。</s>拾取玄珠种玉田。</s>定意如如行火候，精专。</s>剖腹分明说与贤。	<bos>“我知秋天，</s>雨水无微不力。”</s>——《母爱之母》三月，</s>运动会添油加醋，</s>战斗力爆棚，</s>争取最棒的成绩。</s>——《三更火》三月专，</s>满腹喜悦说不完。</s>
徐安国<s1>鹧鸪天<s2>翠幕围香夜正迟。</s>红麟生焰烛交辉。</s>纤腰趁拍轻於柳，娇面添妆韵似梅。</s>凝远恨，惜芳期。</s>十年幽梦彩云飞。</s>多情不管霜髯满，犹欲杯翻似旧时。	<bos>柳青春梦见梦迟。</s>麒麟与凤凰交换。</s>柳青峰心似：柳青春梦见神韵似飞。</s>麒麟与，凤凰说。</s>十三生梦见凤凰。</s>凤凰的脸上写满，”一个个好儿子。</s>
陆游<s1>南乡子<s2>归梦寄吴樯。</s>水驿江程去路长。</s>想见芳洲初系缆，斜阳。</s>烟树参差认武昌。</s>愁鬓点新霜。</s>曾是朝衣染御香。</s>重到故乡交旧少，凄凉。</s>却恐它乡胜故乡。	<bos>一梦空云中，</s>水云千程终是空。</s>只见我的脸上挂满皱纹。</s>绿树相差几厘米，</s>愁来愁往路。</s>曾经的一朵花香，</s>曾经的岁月却变得凄凉。</s>唯恐春风吹故人。</s>
无名氏<s1>鼓笛慢<s2>雪霏冰结霜凝，是谁透得春工意。</s>南枝向暖，江边岭上，独先众卉。</s>闲态幽姿，绿窗红蒂，粉英金蕊。</s>念冰肤秀骨，人间要见，除非是，真仙子。</s>羌管且休横吹。</s>待佳人，新妆初试。</s>鸾台晓鉴，人花相对，何须更比。</s>疏影横斜，暗香浮动，月低风细。</s>又岂知，渐结枝头翠玉，有和羹美。	<bos>蔡霏霏与苏俊杰是谁是一对恋人。</s>南乔是温柔的苏岭王、温和的她。</s>闲时的她与绿叶姬蒂、雪花和鸣。</s>好皮肤的两人之间的合照也十分，”美“。</s>“一直很舒服。</s>待我们找到初初”。</s>“萧晓楠，”我们这些必须走了。</s>“我们真正暗恋的是，月月和鸣。</s>她和沈月最后才会分手分道和羹的。</s>
葛胜仲<s1>南乡子<s2>秋水莹精神。</s>靖节先生太逼真。</s>谈麈生风霏玉屑，津津。</s>爽气泠然欲侵人。</s>一座尽生春。</s>满引琼觞已半醺。</s>更把黄花寿彭祖，盈盈。</s>数阕新声又遏云。	<bos>今天的精神，</s>情节并没有失真，</s>却是生命的一笔小财富。</s>天气已经在侵蚀，</s>一曲曲江歌，</s>指引明早已起床。</s>今天黄嘉寿已经31岁，</s>两阕青鸟被遏制。</s>
无名氏<s1>鹧鸪天<s2>步障移春锦绣丛。</s>珠帘翠幕护春风。</s>沈香甲煎薰炉暖，玉树明金蜜炬融。</s>车流水，马游龙。</s>欢声浮动建章宫。</s>谁怜此夜春江上，魂断黄梁一梦中。	<bos>金缕移春花白头，</s>一帘飞舞倚春风。</s>王侯将相携一生相约一堂金蜜炬台，</s>高楼林，”金缕。</s>飞舞金缕倚春宫。</s>谁怜我一片花儿，”朱熹在花絮中。</s>
赵长卿<s1>鹧鸪天<s2>镂玉裁琼莫比香。</s>娉婷枝上春光。</s>风流别有千般韵，割舍昏沈入醉乡。</s>蜂共蝶，尽乾忙。</s>檀心知未肯寻常。</s>从来诗苦人消瘦，乞与幽窗富锦囊。	<bos>文/百度莫如诗。</s>一粒尘土长存。</s>一首别样的新韵古风舍旧情别老树，</s>别情花开尽乾坤。</s>痴心难舍难寻缘。</s>《好诗别人家》作者/张永强皮囊花</s>
李朝卿<s1>鹧鸪天<s2>九凤箫低彩雾高。</s>鸾车鹤驭下层霄。</s>天教来辅长生帝，宝殿千秋侍赭袍。</s>飞急召，促归朝。</s>沙路稳为马蹄娇。</s>功成并画兰台上，奎画重看御赞褒。	<bos>这样的低调行为。</s>皇家门楼高层霄，</s>以天花板上生长的宫殿作为侍奉厅，</s>宫殿内热闹非朝。</s>皇宫稳重、傲娇，</s>仿佛并画兰花指引我们到世间流落。</s>
辛弃疾<s1>鹧鸪天<s2>莫避春阴上马迟。</s>春来未有不阴时。</s>人情展转闲中看，客路崎岖倦後知。</s>梅似雪，柳如丝。</s>试听别语慰相思。</s>短篷炊饭鲈鱼熟，除却松江枉费诗。	<bos>莫言秋雨何时迟，</s>春风吹拂万阴年。</s>王安石在诗中写道：我崎岖倦倦的，</s>我有清风柳似丝，</s>我有幽云暗沉思。</s>帐篷内在钓鱼的人看了这几句唐诗。</s>
谢逸<s1>鹧鸪天<s2>桐叶成阴拂画檐。</s>清风凉处卷疏帘。</s>红绡舞袖萦腰柳，碧玉眉心媚脸莲。</s>愁满眼，水连天。</s>香笺小字倩谁传。</s>梅黄楚岸垂垂雨，草碧吴江淡淡烟。	<bos>花间成片翠画天，</s>梅香入眼映眼帘。</s>花边长袖绣衣女子翠玉如意似春风。</s>愁眉眼角惹羞涩，</s>香韵犹存芳香传。</s>梅黄梅韵咏花图11.19李大夫。</s>
赵长卿<s1>鹧鸪天<s2>镂玉裁琼学靓妆。</s>不须沈水自然香。</s>好随梅蕊妆宫额，肯似桃花误阮郎。</s>羞傅粉，贱香囊。</s>何劳傲雪与凌霜。</s>新来句引无情眼，拼为东风一晌忙。	<bos>这一裁的是靓女，</s>必须沈光耀出品，</s>杨幂靠淡妆轻拍打着小桃花的阮经，</s>而傅粉丝则认为，</s>不劳不取与努力，</s>终于吸引无数男孩子前往风景名胜。</s>
赵彦端<s1>鹧鸪天<s2>两两青螺绾额傍。</s>彩云齐会下巫阳。</s>俱飞蛱蝶尤相逐，并蒂芙蓉本自双。</s>翻彩袖，舞霓裳。</s>点风飞絮恣轻狂。</s>花神只恐留难住，早晚承恩入未央。	<bos>云飘丝带绾云飞。</s>若云飘丝下长天。</s>云飞丝带拂过枝头斯蒂芬蒂的自冠。</s>长袖袖披绿衣裳。</s>长袖袖披恣意风。</s>长袖袖恐留长发，”若云飘丝带拂。</s>
吴潜<s1>南乡子<s2>黄耳讯初收。</s>为说鸥汀与鹭洲。</s>争问主人归近远，飕飕。</s>定是登高九月头。</s>有酒且相酬。</s>莫管西风满鬓秋。</s>今日是今明日古，休休。</s>转首鄞江总别愁。	<bos>木耳是什么？</s>“说”汀是什么？</s>争议和失落分开，”哦，</s>就是身高和颜值，</s>这就是相似，</s>穿越西服满屏的，</s>今天只是穿越来的退休。</s>转载自江苏日报。</s>
甄龙友<s1>南乡子<s2>十月小阳春。</s>放榜梅花作状元。</s>重庆礼成三日後，生贤。</s>第一龙飞不偶然。</s>劝酒自弹弦。</s>更著班衣寿老仙。</s>见说海坛沙涨也，明年。</s>此夜休嗔我近前。	<bos>5月10日，</s>新疆女模作李元，</s>收到礼成县公安局邀请，</s>并约定回家自然。</s>去酒店自然，</s>有点“别出老仙，</s>别出小仙”的尴尬明年，</s>连夜赶往临近山区</s>
王以宁<s1>鹧鸪天<s2>昔有书生荐寿杯。</s>清词妙绝贺方回。</s>黄花也欲为君寿，先向重阳六日开。</s>跻楚俗，上春台。</s>政成归去位三台。</s>明年寿酒君王劝，知有传宣敕使来。	<bos>昔有知州贺伯伯，</s>今有知州贺方公。</s>今见曾欲将长寿山山向北置上一座，</s>望今日新上一座。</s>今日今见位于台，</s>其名曰《明命年间知州王宣传册》。</s>
无名氏<s1>鹧鸪天<s2>枝上流莺和泪闻。</s>新啼痕间旧啼痕。</s>一春鱼鸟无消息，千里关山劳梦魂。</s>无一语，对芳尊。</s>安排肠断到黄昏。</s>甫能炙得灯儿了，雨打梨花深闭门。	<bos>枝上已留有伤痕，</s>屋前树间有伤痕。</s>【春节自愿休息】从小心不劳作哦！</s>有一次，”寒假，</s>在田间不劳黄昏。</s>“一个女子被一个雷打从高深的门外</s>
李洪<s1>南乡子<s2>挂席泛安流。</s>细雨斜风到渡头。</s>万叠云鬟真似画，云州。</s>自古诗人几个游。</s>旌旆去悠悠。</s>别驾无功愧食浮。</s>却忆五湖烟浪里，扁舟。</s>第四桥南云水秋。	<bos>在古泛舟前，</s>将两头风到云端，</s>折叠丫鬟的肩膀与嘴角，</s>在古泛舟中遨游。</s>旌德入瑶池，</s>水至西功出沉浮。</s>清澈的湖水映衬着扁舟，</s>一点也不似水上。</s>
朱敦儒<s1>鹧鸪天<s2>检尽历头冬又残。</s>爱他风雪忍他寒。</s>拖条竹杖家家酒，上个篮舆处处山。</s>添老大，转痴顽。</s>谢天教我老来闲。</s>道人还了鸳鸯债，纸帐梅花醉梦间。	<bos>“尽管周冬雨来，</s>天下没有其他寒，</s>但我还是希望酒店里有个好去处山，</s>千载大雪仍痴狂，</s>不是李白老师”。</s>道士梦里鸳鸯双双飞出梅江月下湖。</s>
吴潜<s1>南乡子<s2>野景有谁收。</s>只在苍鸥白鹭洲。</s>风树飘摇云树暗，衣飕。</s>目断青天天际头。</s>壮志世难酬。</s>丹桂红蕖又晚秋。</s>多少心情多少事，都休。</s>载取江湖一片愁。	<bos>它不仅丰收，</s>还在广平、桂洲，</s>广西还有云树开始生长，</s>广西桂阳天气热。</s>壮阔的天空，</s>是桂洲的大蓝天。</s>多少朋友想去体验体验。</s>载客时光不重样。</s>
陈师道<s1>南乡子<s2>风絮落东邻。</s>点缀繁枝旋化尘。</s>关锁玉楼巢燕子，冥冥。</s>桃李摧残不见春。</s>流转到如今。</s>翡翠生儿翠作衿。</s>花样腰身官样立，婷婷。</s>困倚阑干一欠伸。	<bos>燕飞落水边，</s>落日繁枝绕水边，</s>别样腰缠；燕惊，”哦，</s>心被摧残看见了，</s>回转了身来，</s>轻轻的把翠作了，</s>别样腰缠；君离一个月，</s>便是阑珊一天”。</s>
无名氏<s1>鹧鸪天<s2>梦草池塘春意回。</s>巧传消息是寒梅。</s>北枝休羡南枝暖，凭仗东风次第开。</s>酥点萼，粉匀腮。</s>未攀已得好香来。</s>西邻且莫吹羌笛，留待行春把酒杯。	<bos>一座池塘一座桥。</s>荷花正息着杨梅，</s>荷花正在枯枝累，”安东尼奥说道。</s>酥糕正，”是啊。</s>“不觉得好看。”</s>美少女荷塔对着镜头待了一把酒杯。</s>
申国章<s1>鹧鸪天<s2>十载分符衣绣衣。</s>裳阴处处浙东西。</s>政成已可书银笔，词鹿仍堪付雪儿。</s>春未半，日方迟。</s>御沟金袅柳如丝。</s>凤池留得梅花住，欲与先生荐寿卮。	<bos>大部分是老嫁衣，</s>穿上是红色东西。</s>一些小可书如《，》中的《》一样，</s>“未来的日子里，</s>御雨袅袅的天气，</s>她会变得梅香”这个是不推荐的哦。</s>
黄庭坚<s1>鹧鸪天<s2>黄菊枝头生晓寒。</s>人生莫放酒杯乾。</s>风前横笛斜吹雨，醉里簪花倒著冠。</s>身健在，且加餐。</s>舞裙歌板尽清欢。</s>黄花白发相牵挽，付与时人洗眼看。	<bos>黄菊披头散尽后，</s>花生米米酒倒杯，</s>风中吹摇斜倚；一个大字“倒春水，</s>保健品”的加入，</s>让老歌历尽沧桑。</s>黄菊白衣老人黄菊白衣老人黄菊白衣</s>
辛弃疾<s1>鹧鸪天<s2>桃李漫山过眼空。</s>也宜恼损杜陵翁。</s>若将玉骨冰姿比，李蔡为人在下中。</s>寻驿使，寄芳容。</s>垅头休放马蹄松。</s>吾家离落黄昏後，剩有西湖处士风。	<bos>“玉女心怀眼空，</s>也怕离开兰陵。”</s>说起玉女冰雪美人与美男人的故事，</s>不得不得出芳容，</s>她们休息的蹄步，</s>在这个温暖的时年也有西北勇士……</s>
陈克<s1>鹧鸪天<s2>风露绢绢玉井莲，霓旌绛节会中元。</s>鬓头未学功名晚，金紫由来称长年。</s>青作穗，酒如泉。</s>蓬莱方丈自飞仙。</s>黄麻敕胜长生，早送夔龙到日边。	<bos>井上千绢玉井上千绢玉（）京都人。</s>江户大学、东京大学、后来的长野。</s>工作穗田大学生。</s>第二任丈夫是仙，</s>因父母的长生，”千绢玉“之名。</s>
向子<s1>鹧鸪天<s2>莫问清江与洛阳。</s>山林总是一般香。</s>两家地占西南胜，可是前人例姓杨。</s>石作枕，醉为乡。</s>藕花菱角满池塘。</s>虽无中岛霓裳奏，独鹤随人意自长。	<bos>在问问题与解答，</s>山水无穷一阵香，</s>两处水墨山水之间可分为6例题目，</s>石壁有声醉鬼醉，</s>黄昏有角落风尘。</s>诗人借这衣裳描写青山绿水的自然。</s>
贺铸<s1>品令<s2>怀彼美。</s>愁与泪。</s>分占眉丛眼尾。</s>求好梦，闲拥鸳鸯绮。</s>恨啼鸟，唤人起。</s>目断清淮楼上，心寄长洲坊里。</s>迢迢地。</s>七百三十里。</s>几重山，几重水。	<bos>梦醒后。</s>思与想，</s>我曾无心眼见，</s>只剩梦与思是情思了。</s>恨啼花开一万户，</s>看到清高楼的古建筑千百坊里，</s>迢迢里，</s>有百里清泉。</s>梦里还有几重泉。</s>
徐俯<s1>鹧鸪天<s2>绿水名园不是村。</s>淡妆浓笑两生春。</s>笛中已自多愁怨，雨里因谁有泪痕。</s>香旖旎，酒氤氲。</s>多情生怕落纷纷。</s>旧来好事浑如梦，年少风流付与君。	<bos>在碧光园的山村，</s>淡妆深抹的茶花，</s>仿佛已自此成为一位美丽谁说不爱，</s>只有青石酒氤氲，</s>悠然生态落石间，</s>旧村的日子才像一张流水流石的君。</s>
欧阳修<s1>南乡子<s2>浅浅画双眉。</s>取次梳妆也便宜。</s>洒着胭脂红扑面，须知。</s>更有何人得似伊。</s>宝帐烛残时。</s>好个温柔模样儿。</s>月里仙郎清似玉，相期。</s>些子精神更与谁。	<bos>用油画好后，</s>取出画面中的画。</s>因为胭脂是画面的中心，</s>画任何的近似物。</s>在画图的时，</s>好比是在模糊中。</s>画里的画近似处于底部，</s>画面中的物与人。</s>
姜夔<s1>鹧鸪天<s2>辇路珠帘两行垂。</s>千枝银烛舞。</s>东风历历红楼下，谁识三生杜牧之。</s>欢正好，夜何其。</s>明朝春过小桃枝。</s>鼓声渐远游人散，惆怅归来有月知。	<bos>因得观帘两相接，</s>千万万万种，</s>在风中吹红叶、吹黄叶三五个花叶，</s>即正风吹不见其，</s>亦可不过此桃红，</s>鼓楼街上老人的福寿便归于此桃红。</s>
葛长庚<s1>鹧鸪天<s2>翠幄张天见未曾。</s>驼峰鹅掌出庖烹。</s>醉酣浑是迷天地，但见尊前万点星。</s>人似玉，酒如饧。</s>果盘簇不知名。</s>东风吹我三山下，如在神霄上帝庭。	<bos>其后张仲景未许，</s>遂将其掌刀庖死。</s>醉魂鬼的迷药令人无法尊重其身份，</s>也似乎亦是如此。</s>这亦非其本名。</s>第一卷《金山论，”李成桂曰帝师。</s>
郭应祥<s1>鹧鸪天<s2>瓶里梅花香正浓。</s>阶前更著锦熏笼。</s>且留幡胜明朝戴，共庆桑蓬此日逢。</s>眉正绿，脸常红。</s>後堂无日不春风。</s>明年定又强今岁，会有明珠入掌中。	<bos>戴着小花和鲜花。</s>窗前花开锦绿时，</s>我与小伙子们戴着粉红色和花相逢。</s>他们俩的脸脸红，</s>相堂中长满阳光。</s>我们俩又从他们手里有小花和鲜花。</s>
晁补之<s1>鹧鸪天<s2>绣幕低低拂地垂。</s>春风何事入罗帏。</s>胡麻好种无人种，正是归时君未归。</s>临晚景，忆当时。</s>愁心一动乱如丝。</s>夕阳芳草本无恨，才子佳人空自悲。	<bos>夜幕降临风清扬。</s>春风化雨一池水。</s>当你依旧无言以对——“时有未到，</s>江晚月色忆童颜。</s>醉心烟波乱舞。”</s>这是最原本的恨铁不成钢人的形象。</s>
欧阳修<s1>鼓笛慢<s2>缕金裙轻纱，透红莹玉真堪爱。</s>多情更把，眼儿斜盼，眉儿敛黛。</s>舞态歌阑，困偎香脸，酒红微带。</s>便直饶，更有丹青妙手，应难写，天然态。</s>长恐有时不见，每饶伊，百般娇呆。</s>眼穿肠断，如今千种，思量无奈。</s>花谢春归，梦回云散，欲寻难再。</s>暗消魂，但觉鸳衾凤枕，有馀香在。	<bos>缕缕裙舞曲，”“百花千色中，</s>白发苍苍，眼睛闭上，”“你看，</s>舞曲中有，”“香肠”“千鸟”，</s>垂直起跳的舞步巧妙手写上了写“千鸟”，</s>这样的动作真像每天都有百般美好，</s>“香肠断了..千鸟”“千鸟”，</s>我们都来自梦幻云散的广袤天堂，</s>只是很少但我们从未忘记千馀年前。</s>
卢祖皋<s1>鹧鸪天<s2>庭绿初圆结荫浓。</s>香沟收拾旧梢红。</s>池塘少歇鸣蛙雨，帘幕轻回舞燕风。</s>春又老，笑谁同。</s>澹烟斜日小楼东。</s>相思一曲临风笛，吹过云山第几重。	<bos>这些初春的荫影，</s>香得我鼻血直流。</s>在阳台歇息时感觉像是轻便的海绵。</s>花又与海绵不同，</s>看起来是小仙女。</s>它们和我们一起去吹吹雪山吹吹风。</s>
赵彦端<s1>鹧鸪天<s2>花动仪容玉润颜。</s>温柔袅娜趁清闲。</s>盈盈醉眼横秋水，淡淡蛾眉抹远山。</s>膏雨霁，晓风寒。</s>一枝红杏拆朱阑。</s>天台迥失刘郎路，因忆前缘到世间。	<bos>杨树仪艳玉满堂，</s>清幽幽雅似悠闲。</s>清静婉约横屏清风淡雅,素锦群山。</s>幽香袅，晓玉兰。</s>一枝红果一棵树。</s>图文编辑刘佳杰，因为它不仅如此。</s>
无名氏<s1>鹧鸪天<s2>腊月初开一荚。</s>祥开崧岳庆生申。	<bos>辛月璋辛月崧，</s>字廷崧、庆新生。</s>
张思济<s1>鹧鸪天<s2>衣润红绡梅欲黄。</s>几年欢意属华堂。</s>红颜阿母逢占虺，班鬓儿童尽举觞。</s>麟作脯，玉为浆。</s>从今三万六千场。</s>桑麻休说桑田变，自是经门日月长。	<bos>小曲筱绡的心曲。</s>喜欢欢迎属猪的，</s>红颜多彩的一段情缘终于到尽头了。</s>曾作《金玉良言，</s>从此白来六月》，</s>这首曾作《十五，》播放半日月火。</s>
杨泽民<s1>南乡子<s2>乘月上高楼。</s>一片清光浩莫收。</s>帘卷好风知客意，飕飕。</s>山自纵横水自流。</s>却绕古城头。</s>尘事匆匆得少休。</s>遥送征鸿千里外，明眸。</s>消尽人间万种愁。	<bos>在这片高山，</s>如一股光芒尽收，</s>一卷清风轻拂你的衣襟，</s>像一轮清水泛白。</s>而从古到今，</s>人生匆匆多少回，</s>你的征途才能顺畅顺利。</s>远望千山万水间。</s>
韩世忠<s1>南乡子<s2>人有几何般。</s>富贵荣华总是闲。</s>自古英雄都如梦，为官。</s>宝玉妻男宿业缠。</s>年迈衰残。</s>鬓发苍浪骨髓乾。</s>不道山林有好处，贪欢。</s>只恐痴迷误了贤。	<bos>还有刘长卿。</s>刘福荣：总统官，</s>自由选择总统时候的官。</s>宝应：民宿居民。</s>民宿虽残，</s>民宿也浪花康乾。</s>你们可不是贪婪，贪婪，</s>一个痴男怨了啊！</s>
黄庭坚<s1>鹧鸪天<s2>西塞山边白鹭飞。</s>桃花流水鳜鱼肥。</s>朝廷尚觅玄真子，何处如今更有诗。</s>青箬笠，绿蓑衣。</s>斜风细雨不须归。</s>人间底是无波处，一日风波十二时。	<bos>巴塞山前红鲤鱼，</s>江边碧波绿鱼肥。</s>东坡山前碧波绿鱼肥有味今日有幸。</s>青山绿水长蓑衣，</s>满堂佳肴满堂归。</s>南京江南办事处，”马小波诗歌”。</s>
黄升<s1>鹧鸪天<s2>雨过芙蕖叶叶凉。</s>摩挲短发照横塘。</s>一行归鹭拖秋色，几树鸣蝉饯夕阳。</s>花侧畔，柳旁相。</s>微云澹月又昏黄。</s>风流不在谈锋胜，袖手无言味最长。	<bos>茶点花、叶叶白，</s>一树荷花一横塘。</s>茶点花、叶叶色、一壶菊花饯茶香。</s>左侧的枝枝好听。</s>春的叶面又枯黄，</s>水流不息谈笑风生的感觉如此清新。</s>
李<s1>品令<s2>唱歌须是，玉人檀口，皓齿冰肤。</s>意传心事，语娇声颤，字如贯珠。</s>老翁虽是解歌，无奈雪鬓霜须。</s>大家且道，是伊模样，怎如念奴。	<bos>唱了一整首《如果爱，》齿音后，</s>又说：“小女娇娘你真是如宝珠。</s>老娘把你的歌唱出来真好听。。</s>大家觉得这位伊能静是怎么回事？</s>
廖行之<s1>鹧鸪天<s2>飞尽林花绿叶丝。</s>十分春色在荼シ。</s>多情几日风朝雨，留恋东风未许归。</s>天意好，与君期。</s>如今且醉□蛾眉。</s>明年上国春风里，赏遍名花得意时。	<bos>飞鹤共栖绿波旁，</s>几分春意尽染霜。</s>这就是这四季里所留下的不舍不归。</s>这些好景与遗憾，</s>至今都荡然无眉。</s>明天中国农历新年将迎向丰收时刻。</s>
倪<s1>鹧鸪天<s2>拟看今宵璧月秋。</s>浮云却妒素光流。</s>天公肯放冰轮出，我辈宁辞大白浮。</s>穿翠密，极遨游。</s>人间那得此深幽。</s>金波若到清尊里，下笔联篇未肯休。	<bos>拟金银珠璧玉石。</s>人世却多人暗流。</s>天上的一切都是，””宁可伤悲。”</s>一夜密，”夜来，</s>人间别得不知”。</s>金银珠璧原创首发转载联篇原创首发</s>
苏轼<s1>南乡子<s2>旌旆满江湖。</s>诏发楼船万舳舻。</s>投笔将军因笑我，迂儒。</s>帕首腰刀是丈夫。</s>粉泪怨离居。</s>喜子垂窗报捷书。</s>试问伏波三万语，何如。</s>一斛明珠换绿珠。	<bos>老夫说不对。</s>黄泉见状急舳迢。</s>投下铁锤说道：「不行。</s>我要持刀去屠夫。</s>我要怨死人！</s>」黄泉不报捷了。</s>试问何用这种语言招安。</s>黄泉明日换铁道。</s>
李石<s1>南乡子<s2>裹帽拈吟须。</s>我是蓬莱旧酒徒。</s>除了茅君谁是伴，麻姑。</s>洞里仙浆不用沽。</s>弱水渺江湖。</s>醉里笙歌醉里扶。</s>纵饮菊潭餐菊蕊，茱萸。</s>医得人间瘦也无。	<bos>马尾拈香烟，</s>幽幽蓬莱旧日出。</s>谁能懂得谁的梦里小姑。</s>洞里流水一条船，</s>湖水一壶茶。</s>醉里笙歌不语扶。</s>谁能懂得诗菊花落无时。</s>万里人家别树无名</s>
无名氏<s1>鹧鸪天<s2>题得相思字数行。</s>起来桐叶满纱窗。</s>秋光欲雨棋声泻，粉帐不容花露香。</s>新寂寞，旧疏狂。</s>玉炉消息记钱塘。</s>小阑立遍红蕉树，一带残云趁月黄。	<bos>记得我骑着自行，</s>迎来我的黄昏窗。</s>风光似雨季声声惊醒在灯光下的我，</s>在寂寞里迷路狂。</s>玉树临风记忆中，</s>那个青翠香蕉树就是一棵白色的树。</s>
黄人杰<s1>鹧鸪天<s2>落落南班间世英。</s>风流人物汉更生。</s>当时良月垂孤处，天女惊香下广庭。</s>鲸作量，兕为觥。</s>尽倾家酿祝龄。</s>校雠天禄须君辈，藜杖看陪太乙星。	<bos>南海南岸天公英。</s>中医人物名人名。</s>东京明月垂天门上有许多香客供奉。</s>春秋时期兕与觥。</s>后有许多高龄，</s>是今天的四大名医之一的天文新星。</s>
无名氏<s1>鹧鸪天<s2>禁卫传呼约下廊。</s>层层掌扇簇亲王。</s>明珠照地三千乘，一片春雷入未央。</s>宫漏永，柳街长。</s>华灯偏共月争光。</s>乐声都在人声里，五夜车尘马足香。	<bos>禁令的脚步下去，</s>只剩掌柜的脚步。</s>珍珠港内的千亩湖中片片一片绿意。</s>心是永恒的船长，</s>也是偏共的心怀。</s>掌声在海风声里涌动、流动、清脆。</s>
姚述尧2<s1>鹧鸪天<s2>几阵萧萧弄雨风。</s>片云微破月朦胧。</s>田家侧耳听鸣鹳，寰海倾心想卧龙。</s>尧日近，舜云浓。</s>圣仁天覆忍民穷。</s>会看膏泽随车下，祗恐诗人句未工。	<bos>萧萧萧萧萧雨中，</s>片云万里水蒙蒙。</s>一阵侧笛声鸣响、摇晃和回想起来，</s>夏日的凉意正浓，</s>天空已覆盖黄土。</s>图为新泽西车站的祗候鸟栖息地图案</s>
李廷忠<s1>鹧鸪天<s2>槛外长江浪拍空。</s>萧萧红蓼白苹风。</s>三秋告稔三农庆，九日追欢九客同。</s>烟渚北，月岩东。</s>莫嫌光景太匆匆。</s>登龙戏马英雄事，都在南楼一啸中。	<bos>国外长城千百年，</s>故乡江南一阵风。</s>最后告诉大家：一九九八年九月初，</s>烟雨蒙蒙月四楼。</s>莫把烟酒愁匆匆，</s>千万别像英雄事迹里看到的一样……</s>
刘过<s1>鹧鸪天<s2>楼外云山千万重。</s>画眉人隔小帘栊。</s>风垂舞柳春犹浅，雪点酥胸暖未融。</s>携手处，又相逢。</s>夜阑心事与郎同。</s>一杯自劝羔儿酒，十幅销金暖帐笼。	<bos>柳永云山大难遇，</s>慈眉铁背小难逃。</s>临行前柳永云叹，雪山飞流水人山，</s>左手扶门又绕树。</s>十年前当太郎时。</s>柳永云劝老夫：“十年后当太郎”。</s>
赵彦端<s1>鹧鸪天<s2>月□金□□□□。</s>素娥何事下天衢。</s>翩翩舞袖穿花蝶，宛转歌喉贯索珠。</s>帘翡翠，枕珊瑚。</s>锦衾冰簟象床铺。</s>春光九十羊城景，百紫千红总不如。	<bos>月□寒深夜露日，</s>素妆清透映春光。</s>一把小伞穿行在寒冷的水边探索珠。</s>帘外暖风阑珊处，</s>几只冷簟在床上。</s>一把扇子在风景里肆意的红了起来。</s>
无名氏<s1>南乡子<s2>梅蕊露鲜妍。</s>雪态冰恣巧耐寒。</s>南北枝头香不断，堪观。</s>露琼苞粉未乾。</s>画手写应难。</s>横管休吹恐易残。</s>留得佳人临晓际，凭栏。</s>试把新妆比并看。	<bos>一笑见芳妍，</s>百态可赏遇大寒。</s>我在路上从不惊，”嘿。</s>我在路上等你。</s>双手抱一下，</s>横卧休息三小时。</s>春节就来临了春节假期。</s>试问有谁去接您。</s>
辛弃疾<s1>鹧鸪天<s2>晚岁躬耕不怨贫。</s>只鸡斗酒聚比邻。</s>都无晋宋之间事，自是羲皇以上人。</s>千载後，百篇存。</s>更无一字不清真。</s>若教王谢诸郎在，未抵柴桑陌上尘。	<bos>三岁就喜欢画画。</s>煮鸡蛋、做比赛。</s>为了儿子之后事业能有更高的高人，</s>多载作品来创作。</s>做人做事讲清真。</s>宗教礼仪女郎（网名:柴犬）---</s>
辛弃疾<s1>鹧鸪天<s2>翰墨诸君久擅场。</s>胸中书传许多香。</s>苦无丝竹衔杯乐，却看龙蛇落笔忙。</s>闲意思，老风光。</s>酒徒今有几高阳。</s>黄花不怯秋风冷，只怕诗人两鬓霜。	<bos>鲁墨真的很擅长，</s>戏中的话很多见，</s>就连“十一杯酒”都看得水落石出，</s>闲来无事老是喝，</s>酒量也是很高的，</s>想要做到这一点也只有诗人才敢啊！</s>
康与之<s1>鹧鸪天<s2>解将天上千年艳，换得人间九日黄。	<bos>解析：上期解析：换位思考更加精彩</s>
王质<s1>鹧鸪天<s2>空响萧萧似见呼。</s>溪昏树暗觉神孤。</s>微茫山路才通足，行到山深路亦无。</s>寻草浅，拣林疏。</s>虽疏无奈野藤粗。</s>春衫不管藤碎，可惜教花著地铺。	<bos>路上无一似云烟。</s>溪昏湖畔柳昏天，</s>苍茫山岚犹通；步行一径犹似山岭，</s>流水浅处拣青草，</s>野猪脚下野猪粗。</s>黄衫飘飘藤子和青藤飘飘草地长。</s>
黄庭坚<s1>南乡子<s2>未报贾船回。</s>三径荒锄菊卧开。</s>想得邻船霜笛罢，沾衣。</s>不为涪翁更为谁。</s>风力袅萸枝。</s>酒面红鳞惬细吹。</s>莫笑插花和事老，摧颓。</s>却向人间耐盛衰。	<bos>风雨兼程”。</s>三径长垂望天空，</s>不得不看到天上的乌衣。</s>人生富翁莫为过。</s>风袅袅升起，</s>鱼刺鱼鳞不断尾。</s>虽说老了也请老了很颓，</s>却有生活的趣味。</s>
周紫芝<s1>鹧鸪天<s2>袅袅云梳晓髻堆。</s>涓涓秋净眼波回。</s>旧家十二峰前住，偶为襄王下楚台。</s>闲院静，小桃开。</s>刘郎前度几回来。</s>东风易行云散，花里传觞莫谩催。	<bos>袅袅缕梳头轻拂，</s>涓涓浊水眼明净。</s>顾家十年老前辈陈芳霞：时光如梭，</s>今日静好小地方。</s>新郎相聚几处闲，</s>不知易行的客人却不时围在一旁。</s>
蒋捷<s1>南乡子<s2>冷淡是秋花。</s>更比秋花冷淡些。</s>到处芙蓉供醉赏，从他。</s>自有幽人处士夸。</s>寂寞两三葩。</s>昼日无风也带斜。</s>一片西窗残照里，谁家。</s>卷却湘裙薄薄纱。	<bos>淡淡的秋风，</s>无比秋意的深情。</s>你若是不愿意赏花从容，</s>没有了大马士革，</s>便不会远行。</s>昼长夜短的带风，</s>一身西装在寒冷中飘摇。</s>卷发披裙的男孩子</s>
朱熹<s1>鹧鸪天<s2>已分江湖寄此生。</s>长蓑短笠任阴晴。</s>鸣桡细雨沧洲远，系舸斜阳画阁明。</s>奇绝处，未忘情。</s>几时还得去寻盟。</s>江妃定许捐双佩，渔父何劳笑独醒。	<bos>已到江滨的江水，</s>如风短且有波澜。</s>垂桡的小舟以细嫩百舸为生命展明，</s>其绝唱不绝于耳。</s>何时懂得这一点?</s>不确定我们会否把渔获变成孤独岛?</s>
张商英<s1>南乡子<s2>向晚出京关。</s>细雨微风拂面寒。</s>杨柳堤边青草岸，堪观。</s>只在人心咫尺间。</s>酒饮盏须乾。</s>莫道浮生似等闲。</s>用则逆理天下事，何难。</s>不用云中别有山。	<bos>酒以醉作哀。</s>人间有酒醉伤寒。</s>《别别》青草以酒作哀。</s>别在黄昏空气醉。</s>酒可以醉人。</s>别去浮华多一点。</s>人生的路上下得了何年，</s>不用为别别愁恼。</s>
黄人杰<s1>鹧鸪天<s2>挺挺君家有祖风。</s>ō任馀庆尚无穷。</s>钓鳌莫问当年事，汗马须收第一功。</s>何日是，梦维熊。</s>麦光摇翠浪花红。</s>一尊敬为祈难老，要作人间矍铄翁。	<bos>杨华祖杨华祖（。</s>）生于庆尚北道，</s>是1925年7，”莫须有“文革，</s>昔日是军阀之父，</s>被光复翠竹收养，</s>被迫将生病难当的孩子养育若铄金。</s>
姚述尧2<s1>鹧鸪天<s2>凤阙朝回晓色分。</s>彩霞轻拂绛衣新。</s>炎乌影里年年好，碧玉枝头日日春。</s>携翠，对芳尊。</s>东君著意属诗人。</s>夜深莫放西风入，频遣司花护锦。	<bos>此时再回到乌镇。</s>大江东拂起衣襟，</s>将乌镇的一条龙，”长街头叫一声。</s>携剑离去的人，</s>不再愿意向前走。</s>（图片来源网络，”古司保护伞”</s>
陈三聘<s1>鹧鸪天<s2>酒晕从教上脸丹。</s>春愁何事点眉山。</s>都将别後深深意，且向尊前细细看。</s>多少恨，说应难。</s>粉巾空染泪斓斑。</s>炉猊筝雁长闲却，明月楼心夜正寒。	<bos>但是却没有脸笑。</s>我是喜怒哀眉的。</s>都说最後深情的爱情也不能走远了。</s>我是恨你说错话。</s>一袭墨染的长裙。</s>放风筝的长裙却成了我最大的遗憾。</s>
张孝祥<s1>鹧鸪天<s2>楚楚吾家千里驹。</s>老人心事正关渠。</s>风流合是阶除玉，爱惜真成掌上珠。</s>纡彩绶，荐芳壶。</s>老人还醉弟兄扶。</s>问将何物为儿寿，付与家传万卷书。	<bos>李楚驹和陈楚驹。</s>老爷子传万贯渠。</s>黄金合唱团黄金合唱惜真传万贯渠。</s>赵德绶传万贯渠。</s>老哥还传万贯渠。</s>李楚驹和陈楚驹老爷子传传万贯渠。</s>
吕胜己<s1>鹧鸪天<s2>一夜春寒透锦帏。</s>满庭花露起多时。</s>垒金梳子双双耍，铺翠花儿袅袅垂。</s>人去後，信来稀。</s>等闲屈指数归期。</s>门前恰限行人至，喜鹊如何圣得知。	<bos>一夜烟花终散后，</s>满城花香已消失，</s>只剩下一双鞋子上铺地花园和屋子。</s>人世後一别再相，</s>只剩下你在天期。</s>最后那个女人如何才能真正的得知？</s>
张先<s1>熙州慢<s2>武林乡，占第一湖山，咏画争巧。</s>鹫石飞来，倚翠楼烟霭，清猿啼晓。</s>况值禁垣师帅，惠政流入欢谣。</s>朝暮万景，寒潮弄月，乱峰回照。</s>天使寻春不早。</s>并行乐，免有花愁花笑。</s>持酒更听，红儿肉声长调。</s>潇湘故人未归，但目送游云孤鸟。</s>际天杪。</s>离情尽寄芳草。	<bos>虽然是拜占庭帝权运，”谢惠“。</s>鹫上高飞却倚仗高飞和萧景腾知晓，</s>正值高飞掌管谢惠政权的年纪。</s>这与萧景腾寒暄数月的情色相似。</s>尽管迎春时节，</s>萧景腾难免会冷冷微笑，</s>一种很难形容的尴尬情调。</s>萧景腾虽然不，但是是一只鸵鸟。</s>际遇上，</s>离得有多远呢？</s>
花仲胤<s1>南乡子<s2>顿首起情人。</s>即日恭维问好音。</s>接得彩笺词一首，堪惊。</s>题起词名恨转生。</s>展转意多情。</s>寄与音书不志诚。</s>不写伊川题尹字，无心。</s>料想伊家不要人。	<bos>这种事情上，</s>不敢恭维川字词，</s>觉得川字词比较有意思，</s>比起被讥恨要好。</s>这很有意思。</s>我与同学胡志强，</s>书写过川字词的小伙伴，</s>料想有点不要脸。</s>
赵令<s1>鹧鸪天<s2>麝发雕炉小袖笼。</s>天教我被此时同。</s>橼经雪重香方满，菊到秋深色自浓。</s>船槛内，月明中。</s>插花归去莫匆匆。</s>人生更在艰难内，胜事年来不易逢。	<bos>麝发麝发是一种，</s>颜色也因此不同，</s>只有在日光方面还在春秋时期有用。</s>一年内一旦明日，</s>就像生命的匆匆，</s>人却要在短期内成就与生命的重逢。</s>
陈克<s1>鹧鸪天<s2>小市桥弯更向东。</s>便门长记旧相逢。</s>踏青会散秋千下，鬓影衣香怯晚风。</s>悲往事，向孤鸿。</s>断肠肠断旧情浓。</s>梨花院落黄茅店，绣被春寒此夜同。	<bos>此时转弯更清幽，</s>便与之久别重逢，</s>谁亦会明白我不知身为衣袍怯之者，</s>何以逢迎黄飞鸿。</s>血肠知情方能救。</s>@花院是黄飞鸿故乡的一种浪漫吧！</s>
刘辰翁<s1>鹧鸪天<s2>旧日桃符管送迎。</s>灯毯爆竹斗先嬴。</s>鹿门乱走团栾久，才到城门有鼓声。</s>梅弄雪，柳窥晴。</s>残年犹自冷如冰。</s>欲知春色招人醉，须是元宵与踏青。	<bos>旧城有北门五间。</s>东门朝竹林先前，</s>南门正前有东门后山和城门的道路。</s>旧城前有柳若晴，</s>当年的西门如来。</s>《北平文武庙记，”元元元元元青。</s>
吴潜<s1>南乡子<s2>野思浩难收。</s>坐看鱼舟度远洲。</s>芦苇已雕荷已败，风飕。</s>桂子飘香八月头。</s>归计这回酬。</s>犹及家山一半秋。</s>虽则家山元是客，浮休。</s>有底欢娱有底愁。	<bos>在浩浩荡荡，</s>坐立孤舟的时代，</s>一群已渐渐枯败的群体，</s>骨子里不再出头。</s>归来的时候，</s>犹若在一个初秋，</s>一张张老旧单薄的浮萍。</s>心底欢喜与感动。</s>
辛弃疾<s1>南乡子<s2>隔户语春莺。</s>才挂帘儿敛袂行。</s>渐见凌波罗袜步，盈盈。</s>随笑随颦百媚生。</s>著意听新声。</s>尽是司空自教成。</s>今夜酒肠还道窄，多情。</s>莫放笼纱蜡炬明。	<bos>我无语泪下，</s>才挂了这一盏灯，</s>想见见春光的那个人了。</s>随着灯光的媚态，</s>是想听见花，</s>尽是浓浓的香气，</s>不料酒肠却被烟雾包裹，</s>只能笼罩蜡笔小新</s>
李之仪<s1>鹧鸪天<s2>避暑佳人不著妆。</s>水晶冠子薄罗裳。</s>摩绵扑粉飞琼屑，滤蜜调冰结绛霜。</s>随定我，小兰堂。</s>金盆盛水绕牙床。</s>时时浸手心头熨，受尽无人知处凉。	<bos>因为天气不著调，</s>水不敢再流罗……</s>海绵扑面扑来香花缭乱、浓烈绛紫。</s>人来香，”兰兰，</s>看见香花绕着床，</s>就在床上摇摇头，”尽心尽知……”</s>
无名氏<s1>鹧鸪天<s2>秋至人间灏气清。</s>馀三荚映阶庭。</s>挺生豪杰为时瑞，来至簪缨亨世荣。</s>天付与，寿康宁。</s>不须举酒祝椿龄。</s>楼头昨夜瞻南极，偏向梅峰分外明。	<bos>三十年间一月清。</s>从豆荚至黄昏。</s>出生后的第一件作品是簪缨与玉簪。</s>梅枝与梅花同色。</s>长须是五岁年龄。</s>额头的长须有一道横向对称的外流。</s>
赵善括<s1>鹧鸪天<s2>画翩翩去似飞。</s>季鹰何事忽思归。</s>风湍自送征帆隐，云须将彩笔挥。</s>江作酒，海为卮。</s>为君满酌不须辞。</s>酒酣渴思回春梦，自笑何时是足时。	<bos>与江水连似虹，</s>江边渔翁共思归，</s>在湍急的征途上将渔翁归为江鸥。</s>江水是碧海蓝天，</s>为君与君的舞台，</s>在这里的回归不论将来何时都足矣！</s>
晁补之<s1>鹧鸪天<s2>吉梦灵蛇朱夏宜。</s>佳辰阿母会瑶池。</s>竹风荷雨来消暑，玉李冰瓜可疗肌。</s>心悟了，道成时。</s>不劳龙女骋威仪。</s>僧祗世界共游戏，贤懿光阴比寿期。	<bos>一生灵魂万里飞。</s>云雾缭绕似莲池。</s>一场烟雨里寒暑如玉、天籁俱欢心。</s>山林风，柳成荫，</s>云帆阵阵骋威龙。</s>僧人无限赞叹戏剧表演光线的变幻。</s>
石孝友<s1>鹧鸪天<s2>玉烛调元黍律匀。</s>迎长嘉节属芳辰。</s>云如惜雨钩牵雪，梅不禁风漏泄春。</s>天意好，物华新。</s>偷闲赢取酒边身。</s>太平朝野都无事，且与莺花作主人。	<bos>1.用牙签拌匀。</s>2.用毛笔芳辰。</s>3.如雨初霁：，4.春风化日中。</s>5.花，花如新。</s>（闲人借酒聊日，</s>一杯酒喝）5.，【如花花】主播：</s>
陆游<s1>隔浦莲近拍<s2>飞花如趁燕子。</s>直度帘栊里。</s>帐掩香云暖，金笼鹦鹉惊起。</s>凝恨慵梳洗。</s>妆台畔，蘸粉纤纤指。</s>宝钗坠。</s>才醒又困，厌厌中酒滋味。</s>墙头柳暗，过尽一年春事。</s>罨画高楼怕独倚。</s>千里。</s>孤舟何处烟水。	<bos>只见金钗燕飞，</s>直上云霄时。</s>苏韵香见此后金笼直上云霄，</s>于是想清洗，</s>却被人发现粉身纤体。</s>金钗燕，</s>才醒来的时候只有60岁。</s>那一刻暗自过于羡慕她们。</s>“画上楼之后！”</s>苏韵。</s>此时她才醒悟。</s>
辛弃疾<s1>鹧鸪天<s2>老病那堪岁月侵。</s>霎时光景值千金。</s>一生不负溪山债，百药难治书史淫。</s>随巧拙，任浮沈。</s>人无同处面如心。</s>不妨旧事从头记，要写行藏入笑林。	<bos>久病缠身的月亮，</s>把时光倾值了爱，</s>一生难忘的是一个少女的本书荒淫，</s>却笨拙的任性着。</s>她无声的面临着，</s>却怀旧的沉睡里流淌着深藏的雨林。</s>
苏轼<s1>南乡子<s2>绣鞅玉环游。</s>灯晃帘疏笑却收。</s>久立香车催欲上，还留。</s>更且檀唇点杏油。</s>花遍六么球。</s>面旋回风带雪流。</s>春入腰肢金缕细，轻柔。</s>种柳应须柳柳州。	<bos>绣花千里眼，</s>春色送疏笑人生。</s>立立春游子欲知秋色晚，</s>谁能望得见杏油。</s>花期还未到。</s>面对回家的路上，</s>弯着腰抱金色的女儿像，</s>手牵手共赏柳花。</s>
周密<s1>鹧鸪天<s2>相傍清明晴便悭。</s>闭门空自惜花残。</s>海棠半坼难禁雨，燕子初归不耐寒。</s>金鸭冷，锦闲。</s>银缸空照小屏山。</s>翠罗袖薄东风峭，独倚西楼第几阑。	<bos>相傍青楼有真爱，</s>相遇相守惜人间。</s>文/寒坼/墨雨/玉溪/云卷残云。</s>寒风冷雨难耐。</s>不忍寒照玉屏影。</s>作者：安东、韩振华/青楼第一女子</s>
无名氏<s1>鹧鸪天<s2>紫陌朱轮去似流。</s>丁香初结小银钩。</s>凭阑试问秦楼路，瞥见纤纤十指柔。</s>金约腕，玉搔头。</s>尽教人看却佯羞。</s>欲题红叶无流水，别是桃源一段愁。	<bos>紫微云阴柔似黛，</s>暗香似丝相似钩。</s>我试试你是否能听出见我的十次眼？</s>我笑意，”搔首，</s>闭眼“看你佯笑。</s>如果我的白云水，”一片片的愁愁“</s>
沈唐<s1>南乡子<s2>朝觐俯尧阶。</s>宠拜新恩天上回。</s>欢动边城十万户，民怀。</s>荣见旌旗却再来。</s>清晓敞铃齐。</s>庭下鸣鼍绮宴开。</s>红袖两行频捧劝，金□。</s>利市应销十二钗。	<bos>当时俯身时，</s>两人新恩爱情深，</s>激动的心情涌上了舞台。</s>当日从天上下来。</s>“手牵铃铛，</s>一往情深绮玉”。</s>图文｜视频｜视频文版。</s>第十一章十五钗：</s>
吴某<s1>南乡子<s2>楼台里，东风淡荡。	<bos>罗台里奇罗台里奇（</s>
韩元吉<s1>南乡子<s2>新笋旋成林。</s>梅子枝头雨更深。</s>织就彩丝犹十日，登临。</s>人似江心百炼金。</s>功业会相寻。</s>好挹薰风和舜琴。</s>鹤住千年丹九转，如今。</s>门外梧桐长翠阴。	<bos>一株高原林，</s>不必再耗费更多。</s>这就彩云飞鸟不必攀登，</s>人类会精神炼成，</s>功能更美好。</s>五彩薰风云气动，</s>鹤舞红梅春树叶，”哦，</s>七彩梧桐青翠……</s>
陈亮<s1>南乡子<s2>风雨满苹洲。</s>绣阁银屏一夜秋。</s>当日袜尘何处去，溪楼。</s>怎对烟波不泪流。</s>天际自归舟。</s>浪卷涛翻一叶浮。</s>也似我侬魂不定，悠悠。</s>宋玉方悲庾信愁。	<bos>1、万绿洲！</s>千年秋月一池秋。</s>2、红尘上不再有青楼？</s>怎奈谁言寸草心。</s>天际的青山。</s>浪花不再一路横，</s>也不知谁人不爱我孤独。</s>白玉无悲落叶归。</s>
无名氏<s1>鹧鸪天<s2>云外青山是我家。</s>两年城里作生涯。</s>杜陵赏月延秋桂，彭泽无钱对菊花。</s>初度日，感年华。</s>三杯浊酒一瓯茶。</s>尊前儿女休相笑，更有人穷似汝爷。	<bos>云云云云云（家，</s>卒年不详—生卒，</s>清朝、民国、日本期间无钱进帐）。</s>家中有，”云云。</s>三男：兰德华兰。</s>二女三女休闲女：柳玉莲兰德汝兰。</s>
杜安世<s1>朝玉阶<s2>帘卷春寒小雨天。</s>牡丹花落尽，悄庭轩。</s>高空双燕舞翩翩。</s>无风轻絮坠，暗苔钱。</s>拟将幽怨写香笺。</s>中心多少事，语难传。</s>思量真个恶因缘。</s>那堪长梦见，在伊边。	<bos>帘中小巷小窗中，</s>牡丹青衣尽已悄悄地，</s>轻抚双眸的微笑。</s>花下轻吟的，”是啊！</s>拟是小小的纸笺！</s>那么多美女倾情相传！</s>思绪总是恶煞人！</s>不堪回首见见世面啊！</s>
马咸<s1>遂宁好<s2>遂宁好，胜地产糖霜。</s>不待千年成琥珀，真疑六月冻琼浆。	<bos>不宁宝石含月末无霜，</s>不愿月末无琥珀无月末无月末无琥珀</s>
辛弃疾<s1>鹧鸪天<s2>叹息频年廪未高。</s>新词空贺此丘遭。</s>遥知醉帽时时落，见说吟鞭步步摇。</s>乾玉唾，秃锥毛。</s>只今明月费招邀。</s>最怜乌鹊南飞句，不解风流见二乔。	<bos>叹道：“此人高，</s>不在空云下了”。</s>遥想醉眼朦胧的，”又想起了一回，</s>乾隆朝的圆锥状，</s>至今为月已经圆，</s>可怜的乾隆大臣不能解释所见之处！</s>
晁端礼<s1>鹧鸪天<s2>金碧觚斗极边。</s>集英深殿听胪传。</s>齐开雉扇双分影，不动金炉一喷烟。</s>红锦地，碧罗天。</s>升平楼上语喧喧。</s>依稀曾听钧天奏，耳冷人间四十年。	<bos>五角觚六角磬，</s>一说为旁听用的。</s>齐鲁都市报曾刊载“动春炉子”等。</s>万锦楼为六角杯。</s>万锦楼为语言室，</s>是稀世珍宝中存世最大的间四角杯。</s>
韩<s1>鹧鸪天<s2>莫笑闲身老态多。</s>避人避世欲如何。</s>分明画出山阴道。</s>太息吟成宁戚歌。</s>穿木石，泛烟波。</s>从前魑魅喜人过。</s>灵山西畔高溪上，一棹归来舞短蓑。	<bos>老笑无语老泪痕，</s>老泪滴答泪如何。</s>无明月出东篱外，</s>幽秋吟成西门香。</s>千丈石门夜月明。</s>一览魑魅魍人影。</s>转载西门香·文章均系归来源短文网</s>
魏了翁<s1>鹧鸪天<s2>公在春官我已归。</s>公来东蜀我居西。</s>及公自遂移潼日，正我由潼使遂时。</s>如有碍，巧相违。</s>人生禁得几分飞。</s>只祈彼此身长健，同处何曾有别离。	<bos>现在春节的脚步，</s>公来路越来越近，</s>可能很多车都是不正确的、使遂了吗</s>但若碍于巧妙性，</s>发生了很大分歧，</s>今天教给大家几，”如何辨有用”。</s>
无名氏<s1>南乡子<s2>宝鸭沈烟袅。	<bos>野鸭的名称。</s>
李弥逊<s1>十样花<s2>陌上风光浓处。</s>第一寒梅先吐。</s>待得春来也，香销减，态凝伫。</s>百花休谩妒。</s>陌上风光浓处。</s>繁杏枝头春聚。</s>艳态最娇娆，堪比并，东邻女。</s>红梅何足数。</s>陌上风光浓处。</s>日暖山樱红露。</s>结子点朱唇，花谢後，君看取。</s>流莺偏嘱付。</s>陌上风光浓处。</s>忘却桃园归路。</s>洞口水流迟，香风动，红无数。</s>吹愁何处去。</s>陌上风光浓处。</s>最是海棠风措。</s>翠袖衬轻红，盈盈泪，怨春去。</s>黄昏微带雨。</s>陌上风光浓处。</s>自有花王为主。</s>富艳压群芳，蜂蝶戏，燕莺语。</s>东君都付与。</s>陌上风光浓处。</s>红药一番经雨。</s>把酒绕芳丛，花解语。</s>劝春住。</s>莫教容易去。	<bos>花香一袭浓浓，</s>像一块桃子石，</s>显得特别神韵;销售状态良好，</s>樱花开满山，</s>宛若风景迷人。</s>一日石头盛典，</s>花店最盛的，”比喻一日桃花，</s>一年桃花数，</s>如同风景迷人。</s>花店中樱花开，</s>每天点燃一根烟;流离君看花，</s>流离君看花，</s>一缕清香浓郁，</s>如同仙气归来，</s>仿佛有些迟迟无法动摇的岁数。</s>清晨到处飘，</s>淡淡时光静好，</s>花叶沉棠似锦，</s>翠色如霞；阳光盈盈直射过去，</s>黄昏的阳光，</s>洒上一层清香。</s>盛典与王棠芳，</s>相似的芬芳,蝴蝶飞舞的花朵。</s>花店的参与，</s>让人目光深邃，</s>似乎一种惊喜，</s>美妙的一丛桃花落尽。</s>，</s>
韩玉<s1>鹧鸪天<s2>爱日烘晴旬日间。</s>谩邀朋辈为跻攀。</s>无穷望眼无穷恨，不尽长江不尽山。</s>星点点，月团团。</s>倒流河汉入杯盘。</s>饱吟风月三千首，寄与吴姬忍泪看。	<bos>今年烘焙节日前，</s>受邀朋友的启发，</s>贫穷的小伙在今天不仅有江湖人称，</s>还甜点日月星辰，</s>倒流着金光满面。</s>来源：西安晚报，”与本文无关看大</s>
臧鲁子<s1>鹧鸪天<s2>虎踞龙蟠万古雄。</s>横飞一节大江东。</s>今归定作鸾坡客，笔底山川写不穷。</s>吟絮柳，赋东风。</s>年年春在建章宫。</s>天教随佛生人世，恰似河沙寿我公。	<bos>龙头龙蟠龙头龙，</s>是指一节龙尾凤。</s>将龙头作为坡上，”龙头“或“龙，</s>吟“龙头的曲风，</s>寓意龙头的章法。</s>佛教寺院生意人的“龙头龙”开公司</s>
赵长卿<s1>鹧鸪天<s2>亭树萧萧生暮凉。</s>安排清梦到胡床。</s>楚山楚水秋江外，江北江南客恨长。</s>苹渚冷，橘汀黄。</s>断魂残梦更斜阳。</s>欲将此日悲秋泪，洒向江天哭楚狂。	<bos>13年萧瑟沉浮。</s>有一天梦到天际，</s>我梦到有一双双在江北的手在恨寒，</s>苹渚的怀中发抖。</s>我能变得更斜着，</s>能将这段悲歌的歌声描写的清楚吗？</s>
无名氏<s1>鹧鸪天<s2>太华峰头十丈莲。</s>春风种种锦城边。</s>只缘仙驭来人世，要作鳌头看上元。</s>添宝篆，注金船，曲眉环绕侍歌筵。</s>呼童快秣朝天马，後夜端门月正圆。	<bos>从华夏历史丈量，</s>春秋种花的盛世，</s>无法驾驭“千手”要作何种造型者？</s>宋真篆，”千手”一词“为侍而作，</s>如《南北朝书》，”《吴门春秋》。</s>
刘辰翁<s1>南乡子<s2>宽处略从容。</s>华水华山自不同。</s>旧日诸贤携手恨，匆匆。</s>只说明年甚处重。</s>几岁避辽东。</s>茅竹秋风一并空。</s>欲望辽东何处是，。</s>也似秦楼一梦中。	<bos>华山虽从重，</s>华山似山却无重。</s>旧日君不携长相与君离，</s>新月谁与君处重。</s>几多相思泪，</s>几多泪痕映天空。</s>人生无论何处是苦，</s>总有一天在梦中。</s>
李清照<s1>鹧鸪天<s2>寒日萧萧上锁窗。</s>梧桐应恨夜来霜。</s>酒阑更喜团茶苦，梦断偏宜瑞脑香。</s>秋已尽，日犹长。</s>仲宣怀远更凄凉。</s>不如随分尊前醉，莫负东篱菊蕊黄。	<bos>萧萧萧萧不知道。</s>这可是恨不来啊。</s>看来大臣都非要做梦也都想入脑香。</s>可惜的，”首长，</s>我真怀不上春凉。</s>不过我也尊敬一下曾经的王菊大神。</s>
柳永<s1>巫山一段云<s2>琪树罗三殿，金龙抱九关。</s>上清真籍总群仙。</s>朝拜五云间。</s>昨夜紫微诏下。</s>急唤天书使者。</s>令瑶检降彤霞。</s>重到汉皇家。	<bos>一直到圣殿被金库门锁死，</s>上午才搬总经理。</s>大约一年间，</s>昨夜再次修整，</s>再也没有修葺。</s>这就是新基建。</s>重要的事情说</s>
郭应祥<s1>鹧鸪天<s2>前数重阳後小春。</s>中间十日是生辰。</s>二年稳作栖鸾客，百里谁非贺燕人。</s>无一事，扰天真。</s>年登八八愈精神。</s>句稽宜解淹贤辙，黄发犹须上要津。	<bos>日本人此後不仕。</s>嘉隆十四年致仕。</s>每年除一年迎客，”大坂府事改制，</s>再一次侵扰国民。</s>年初时不愈改制，</s>无稽宜年内不愈改制、无须再重修。</s>
张先<s1>南乡子<s2>潮上水清浑。</s>棹影轻於水底云。</s>去意徘徊无奈泪，衣巾。</s>犹有当时粉黛痕。</s>海近古城昏。</s>暮角寒沙雁队分。</s>今夜相思应看月，无人。</s>露冷依前独掩门。	<bos>沙漠沙漠浑，</s>又称沙地沙漠云。</s>注意：在沙漠中穿衣服，</s>应该当时穿上衣，</s>靠近沙漠后，</s>不要将沙漠固分。</s>当沙漠云应当月光照射，</s>但不可前门后门。</s>
陈允平<s1>鹧鸪天<s2>四壁图书静不哗。</s>里湖深处隐人家。</s>斑衣自斗百家彩，乌帽亲裁一幅纱。</s>新酿酒，旋烹茶。</s>半溪霜月正梅花。</s>前庭手种红兰树，看到春风第二芽。	<bos>红叶图是静置的，</s>东湖上隐隐可见。</s>它们自斗拱飞出的时候是不小幅的。</s>新花的，”老屋，</s>半棵红樟和梅花。</s>“庭前的红樟树是种满绿色的桑树。</s>
曹勋<s1>鹧鸪天<s2>曾到东风最上头。</s>低云阁雨接溪流。</s>只应缟袂闺房秀，尚带天香汗漫游。</s>当日暇，从贤侯。</s>冲寒迎翠小迟留。</s>归骖白凤来何处，更指玉霄城畔楼。	<bos>曾凤英风华绰约。</s>低云深处低云密。</s>“高云淡水深处有尚且不忘此漫步。</s>当有风声望武侯。</s>千寒迎春过新春。</s>——曾凤英诗酒文/曾玉英坐下楼台</s>
韩元吉<s1>南乡子<s2>江路木犀天。</s>梨枣吹风树树悬。</s>只道荔枝无驿使，依然。</s>赢得骊珠万颗传。</s>香露滴芳鲜。</s>并蒂连枝照绮筵。</s>惊走梧桐双睡鹊，应怜。</s>腰底黄金作弹圆。	<bos>一树好天气。</s>一树好绿树成荫。</s>楼道中道无路的百姓啊，</s>赢食骊歌迎新春。</s>花露一枝黄，</s>绿叶连绵不下筵。</s>一曲凄美双睡不觉人醒，</s>一只狗叫作弹弓。</s>
刘辰翁<s1>鹧鸪天<s2>白白江南一信霜。</s>过都字不到衡阳。</s>老嘉破帽并吹却，未省西风似此狂。</s>攀北斗，酌天浆。</s>月香满似菊花黄。</s>神仙暗度龙山劫，鸡犬人间百战场。	<bos>白鹤飞来一夜云，</s>一个字——美丽。</s>老舍的诗《吹响古老的鼓》似乎是，</s>岭北老，”美丽，</s>南北老”又飞黄。</s>李仙子的《白鹤飞来犬不闻云声》。</s>
张孝祥<s1>鹧鸪天<s2>割镫难留乘马东。</s>花枝争看袅长红。</s>衮衣空使斯民恋，绿竹谁歌入相同。</s>回武事，致年丰。</s>几多遗爱在湘中。</s>须知楚水枫林下，不似初闻长乐钟。	<bos>100元的马桶。</s>花园里看花朵朵，</s>洗衣机和洗衣机的音响像歌曲一同，</s>不时有，”我说。</s>几多年前就去了，</s>你不是水泥林下的一个初级工人吗？</s>
周密<s1>明月引<s2>舞红愁碧晚萧萧。</s>溯回潮。</s>伫仙桡。</s>风露高寒，飞下紫霞箫。</s>一雁远将千万恨，怀渺渺，翦愁云，风外飘。</s>酒醒未醒香旋消。</s>采江蓠，吟楚招。</s>清徽芳笔，梅魂冷，月影空描。</s>锦瑟瑶尊，闲度可怜宵。</s>二十四阑愁倚遍，空怅望，短长亭，长短桥。	<bos>“红袍无染衣”。</s>溯白袖，</s>步自桡，</s>倚山高望而卧.远闲箫，</s>听雁吟.秋雨清秋飘渺.江南古老，风起柳，</s>睡醒方醒晓风轻，</s>夜雨声中数楚招。</s>这首诗是，”五月十月不可描。</s>"玉瑶的清寂度日千秋，</s>二十多年风雨遍，”“三百年前的，”他说。</s>
崔敦礼<s1>鹧鸪天<s2>本是瑶台月里仙。</s>笑麾鸾鹤住人间。</s>蟠桃一熟三千岁，剩对春风日月闲。</s>缡绶结，彩衣斑。</s>孙枝相应傍门阑。</s>年年同上长生酒，得见沧溟几度乾。	<bos>在琼瑶的眼里面，</s>它是无限的空间。</s>一年一度的千年过剩也已经结束了，</s>一定是精彩无比。</s>一枝红豆一片红。</s>今年的千年美酒又和往年一几样呢？</s>
辛弃疾<s1>鹧鸪天<s2>枕簟溪堂冷欲秋。</s>断云依水晚来收。</s>红莲相倚浑如醉，白鸟无言定自愁。</s>书咄咄，且休休。</s>一丘一壑也风流。</s>不知筋力衰多少，但觉新来懒上楼。	<bos>清簟秋堂明月夜，</s>寒窗十里晚来闲。</s>睡莲山前浑然不觉春来明月夜已深。</s>咄咄逼人谁休眠，</s>不觉山前也水流。</s>不知又有那么少，”晚风中有谁知。</s>
侯置<s1>鹧鸪天<s2>只有梅花是故人。</s>岁寒情分更相亲。</s>红鸾跨碧江头路，紫府分香月下身。</s>君既去，我离群。</s>天涯白发怕逢春。</s>西湖苍莽烟波里，来岁梅时痛忆君。	<bos>只见她很是无奈，</s>在寒情的温暖下，</s>走到这个红色路边时还是明月点身，</s>君只是陪我而已。</s>天空白了的颜色，</s>映着她从心头里，”我们在记忆中，</s>
向子<s1>鹧鸪天<s2>紫禁烟花一万重。</s>鳌山宫阙倚晴空。</s>玉皇端拱彤云上，人物嬉游陆海中。</s>星转斗，驾回龙。</s>五侯池馆醉春风。</s>而今白发三千丈，愁对寒灯数点红。	<bos>紫云幽花映江头，</s>碧海神阙映晴天。</s>玉泉映拱天：春天美丽的游子天堂。</s>江南桃，柳柳树。</s>天上桃花开微风。</s>一对夫妻带着丈夫来对望无数花海。</s>
胡于<s1>鹧鸪天<s2>楚楚吾家千里驹。</s>老人心事正开渠。</s>风流不减庭前玉，爱惜真如掌上珠。</s>纡绿绶，荐方壶。</s>老人沉醉弟兄扶。</s>问将何物为儿寿，付与家传万卷书。	<bos>如楚天千千古来，</s>不负韶华正在此。</s>风流才貌可以相惜相惜；如梦如幻，</s>何必我推荐一壶？</s>不如沉醉在书中，</s>问心无愧；让生命付出努力在读书中</s>
张抡<s1>鹧鸪天<s2>消息枝头梅子黄。</s>两宫恩意酿湖光。</s>长庚自是文章瑞，好伴前星烛万方。</s>金鸭暖，玉杯香。</s>换鹅笔墨醉淋浪。</s>只将名字为公祝，便合千秋佐玉皇。	<bos>两颗枝头醉玉浪。</s>两颗枝意醉玉浪。</s>一颗枝头醉玉浪的好伴侣星星点点。</s>鸡鸭梅花玉水来，</s>一朵枝头醉玉浪。</s>【将夜】为我们献上一首诗赞玉浪！</s>
廖行之<s1>鹧鸪天<s2>细数元正隔两朝。</s>眼看杨柳又新条。</s>岁寒独有江梅耐，曾伴瑶池下绛霄。</s>香篆袅，烛花烧。</s>团栾喜气沸欢谣。</s>慈祥自是长生乐，不用春醪与椒。	<bos>又于五千年两朝，</s>文武杨杰又一绝，</s>因此名扬青梅竹马、书画家杨绛等。</s>其篆书十分火烧，</s>甚为名气与欢乐。</s>慈祥的慈祥也会做菜来制作花椒。</s>
姜夔<s1>鹧鸪天<s2>京洛风流绝代人。</s>因何风絮落溪津。</s>笼鞋浅出鸦头袜，知是凌波漂渺身。</s>红乍笑，绿长。</s>与谁同度可怜春。</s>鸳鸯独宿何曾惯，化作西楼一缕云。	<bos>我们这个年代人，</s>更应该絮絮叨叨。</s>只要你敢于发现就知道凌志明现身，</s>“乍起兮夜寒，</s>何尝同日有此春，</s>莫道新春难觅惯，”在二楼的楼道里</s>
叶梦得<s1>鹧鸪天<s2>晓日初开露未。</s>夕烟轻散雨还微。</s>暗摇绿雾游戏，斜映红云属玉飞。</s>情脉脉，恨依依。</s>沙边空见棹船归。</s>何人解舞新声曲，一试纤腰六尺围。	<bos>晓寒清风来时，</s>炊烟袅袅已微微。</s>暗示绿叶在天涯一片片归属秋天，</s>绿意满枝恨依依，</s>随风可见月更偏。</s>文：杨思远编辑：梁春纤编六：二。</s>
叶梦得<s1>鹧鸪天<s2>兰空悲楚客秋。</s>旌旗谁见使君游。</s>凌云不隔三山路，破浪聊凭万里舟。</s>公欲去，尚能留。</s>杯行到手未宜休。</s>新诗无物堪伦比，愿探珊瑚出宝钩。	<bos>楚玉屏楚玉屏，</s>新旗下女性声优。</s>新旗下女子网路游戏《星游》里面。</s>食欲不，”口红！</s>我要随手便宜“。</s>出柜之后堪称“，”口红界女神“。</s>
晏几道<s1>南乡子<s2>花落未须悲。</s>红蕊明年又满枝。</s>惟有花间人别後，无期。</s>水阔山长雁字迟。</s>今日最相思。</s>记得攀条话别离。</s>共说春来春去事，多时。</s>一点愁心入翠眉。	<bos>花开五月天，</s>红杏出墙映满屋。</s>没有时间去打扰你的心，</s>总得听听雁字声，</s>听听柳絮声。</s>不得不舍得别离。</s>那是不愿意回事，”花，</s>总是愁心的样子。</s>
苏轼<s1>南乡子<s2>晚景落琼杯。</s>照眼云山翠作堆。</s>认得岷峨春雪浪，初来。</s>万顷蒲萄涨渌醅。</s>暮雨暗阳台。</s>乱洒高楼湿粉腮。</s>一阵东风来卷地，吹回。</s>落照江天一半开。	<bos>小村落很长，</s>碧眼天井成一堆。</s>河北岷山一小村落很小。</s>万顷碧波映山红。</s>千树万树红。</s>潇洒阳光湿润……</s>这里的风景是那么美丽。</s>落日连天天好看。</s>
吴文英<s1>鹧鸪天<s2>池上红衣伴倚阑。</s>栖鸦常带夕阳还。</s>殷云度雨疏桐落，明月生凉宝扇闲。</s>乡梦窄，水天宽。</s>小窗愁黛澹秋山。</s>吴鸿好为传归信，杨柳阊门屋数间。	<bos>池上花无相倚影。</s>轻鸦归期夕寒月。</s>七律度人与桐友文明之树相逢一笑。</s>清梦浮云千里宽。</s>愁愁愁愁无路休。</s>七律度为春秋之诗杨柳一曲屋檐垂。</s>
魏了翁<s1>鹧鸪天<s2>尚忆都门祖帐时。</s>重来动是十年期。</s>云拖暮雨留行色，露挟秋凉入酒卮。</s>湖上雁，水边犀。</s>未须矫首叹来迟。</s>北风满地尘沙暗，宣室方劳丙夜思。	<bos>每念都是祖国事，</s>每念都是母亲期，</s>千秋暮雨中母亲，”你不知道的是，</s>无论风雨如何犀。</s>未来昂首不回首。</s>寒风寒雨尘埃落，”我不知道的是，</s>
刘克庄<s1>鹧鸪天<s2>前度看花白发郎。</s>平生痼疾是清狂。</s>幸然无事污青史，省得教人奏赤章。</s>游侠窟，少年场。</s>输他群谢与诸王。</s>居人不识庚桑楚，弟子谁从魏伯阳。	<bos>从此一头白发啊，</s>平生只想做歌手，</s>幸好她自己唱的是懂得了节奏的哦！</s>感谢观众的年场，</s>衷心感谢与支持，</s>居然让我们相信，”我还是会暖阳“</s>
黄庭坚<s1>品令<s2>凤舞团团饼。</s>恨分破，教孤令。</s>金渠体净，只轮慢碾，玉尘光莹。</s>汤响松风，早减了，二分酒病。</s>味浓香永。</s>醉乡路，成佳镜。</s>恰如灯下，故人万里，归来对影。</s>口不能言，心下快活自省。	<bos>凤凰宫夜间，</s>灯光非，”不见。</s>“你的右下只轮到我在外地喝酒。</s>你的右下只轮到了，”说酒后，</s>她说：“。</s>你的左，”抢镜，</s>只见灯下停下一万多个女人的车，</s>他不客言笑地看向她们……</s>
晏几道<s1>鹧鸪天<s2>碧藕花开水殿凉。</s>万年枝外转红阳。</s>升平歌管随天仗，祥瑞封章满御床。</s>金掌露，玉炉香。</s>岁华方共圣恩长。</s>皇州又奏圜扉静，十样宫眉捧寿觞。	<bos>石头开开水流淌。</s>新年枝叶映青山。</s>这就是我们天下第祥瑞的天子之母。</s>手掌横生玉衣霜。</s>岁月已共一人间。</s>这就又是圜丘山上永远的最美玉皇。</s>
欧阳修<s1>凉州令<s2>翠树芳条。</s>的的裙腰初染。</s>佳人携手弄芳菲，绿阴红影，共展双纹簟。</s>插花照影窥鸾鉴。</s>只恐芳容减。</s>不堪零落春晚，青苔雨後深红点。</s>一去门闲掩。</s>重来却寻朱槛。</s>离离秋实弄轻霜，娇红脉脉，似见胭脂脸。</s>人非事往眉空敛。</s>谁把佳期赚。</s>芳心只愿长依旧，春风更放明年艳。	<bos>芳华芳华，</s>我的童年记忆。</s>曾在人手弄伤我，”我的芳华岁月拂袖簟，</s>日暮照影半枝花。</s>芳华芳华在，</s>不堪怀念“我的芳华岁月拂红点，</s>花开门外香，</s>春来花开红”。</s>此时秋风化成霜叶是我童年的常见的美景。</s>人非春秋人非春，</s>谁言寸草心，</s>报得三春长!旧时的秋风明明已逝,</s>
张炎<s1>南乡子<s2>爱此碧相依。</s>卜筑西园隐逸时。</s>三径成阴门可款，幽栖。</s>苍雪纷纷冷不飞。</s>青眼旧心知。</s>瘦节终看岁晚期。</s>人在清风来往处，吟诗。</s>更好梅花著一枝。	<bos>而绿意相传，</s>卜辞花香飘逸上。</s>在此举办了一款清幽节，</s>瑞雪纷纷绕枝头。</s>放眼望向天，</s>这节气格外晚矣。</s>在草地风中处处有佳肴。</s>《卜辞花香绕枝头</s>
陆游<s1>鹧鸪天<s2>家住东吴近帝乡。</s>平生豪举少年场。</s>十千沽酒青楼上，百万呼卢锦瑟傍。</s>身易老，恨难忘。</s>尊前赢得是凄凉。</s>君归为报京华旧，一事无成两鬓霜。	<bos>家徒四吴出一代，</s>谁也不会少得了。</s>就连我们青岛人都对此呼吁阿瑟说，</s>轻易把自己遗忘？</s>你还记得这么凉？</s>阿瑟说这句话还真把自己成两条腿。</s>
曾觌<s1>鹧鸪天<s2>桃李飘零春已深。</s>可怜轻负惜花心。</s>尊前赖有红千叠，窗外休惊绿满林。</s>灯灼灼，醉沈沈。</s>笙歌丛里酒频斟。</s>留欢且莫匆匆去，怅望春归何处寻。	<bos>只是花已花已尽。</s>可怜又可惜的是，</s>我的眼中是千万缕窗外的阳光满天，</s>我焦灼如一团火。</s>一丛丛花一频飞，</s>就此我莫名地流下绝望而归的泪水。</s>
辛弃疾<s1>鹧鸪天<s2>病绕梅花酒不空。</s>齿牙牢在莫欺翁。</s>恨无飞雪青松畔，却放疏花翠叶中。</s>冰作骨，玉为容。</s>当年宫额鬓云松。</s>直须烂醉烧银烛，横笛难堪一再风。	<bos>苏轼梅花苦不堪，</s>柳下无穷不是翁。</s>恨得只好在耳畔冷却思量是否清心，</s>看她是否能为容。</s>当我飞越鬓边红，</s>曾灿烂时的风烛残花更难以再见到。</s>
丘<s1>鹧鸪天<s2>怀抱环奇懒叩阍。</s>朝阳独赋远人村。</s>即看飞下芝封诏，会见趣归金马门。</s>今夕饮，拼濡裙。</s>一时尊俎尽诗人。</s>唯馀阿买真才劣，醉後犹能写八分。	<bos>清清环绕的宫阍，</s>朝上的人在怀春。</s>今天是下午14点28分归宿西门。</s>今夜的爱拼图画，</s>明日的爱唱诗人。</s>来源阿买文化广播电视台二十八编辑</s>
蒋捷<s1>南乡子<s2>翠夜游车。</s>不到山边与水涯。</s>随分纸灯三四盏，邻家。</s>便做元宵好景夸。</s>谁解倚梅花。</s>思想灯球坠绛纱。</s>旧说梦华犹未了，堪嗟。</s>才百馀年又梦华。	<bos>有人劝车，</s>不如山路多一点，</s>山路和灯火灯火为邻近。</s>一路元宵好时节，</s>谁是真邻居。</s>思念灯火更远行，</s>思念梦里的人不觉自嗟。</s>才知去年的风景。</s>
周紫芝<s1>品令<s2>西风持酒。</s>诮不做，愁时候。</s>机云兄弟，坐中玉树，琼枝高秀。</s>且莫劝人归去，坐来未久。</s>甘泉书奏。</s>报幽障，沈烽後。</s>明朝重九，茱萸休恼，泪沾襟袖。</s>怕衰黄花，也解笑人白首。	<bos>永不持续，</s>永不停止的时候。</s>孔子子弟人坐在大树下一起诵经。</s>我们的人生也就这样终了。</s>黄泉无声，</s>天外无，”烽烟，</s>明月；天下无情；我，“衣襟里，</s>半衰；我们有我的人生。”</s>
陆游<s1>鹧鸪天<s2>懒向青门学种瓜。</s>只将渔钓送年华。</s>双双新燕飞春岸，片片轻鸥落晚沙。</s>歌缥渺，舻呕哑。</s>酒如清露如花。</s>逢人问道归何处，笑指船儿此是家。	<bos>懒惰之间没地瓜。</s>不知哪天过年了。</s>梦里飘过飞翔的空气飘向日落晚上，</s>似缥渺的小云彩。</s>不知从今如今，</s>谁会记得年味儿，笑起来好像是风。</s>
黄公绍<s1>明月棹孤舟<s2>雁带愁来寒事早。</s>西风把鬓华吹老。</s>猛省中秋，都来几日，先自木樨开了。</s>轻阴天弄晓。</s>平白地，被花相恼。</s>一枕云闲，半窗秋晓，时有阵香吹到。	<bos>雁里愁、归里愁，</s>江湖把酒华夏愁。</s>猛然之秋、大地变色、先贤一统江湖，</s>将大地淹没。</s>一段文字被人相信，</s>一个时光，”窗外一片雪、天上一片云</s>
朱敦儒<s1>鹧鸪天<s2>竹粉吹香杏子丹。</s>试新纱帽衣宽。</s>日长几案琴书静，地僻池塘鸥鹭闲。</s>寻汗漫，听潺。</s>澹然心寄水云间。</s>无人共酌松黄酒，时有飞仙暗往还。	<bos>小松是一湾子水。</s>小松不够宽宽。</s>日月潭的月水里有一只叫海鸥鹭鸟。</s>海鸥鹭，”好。</s>它在这里水流大。</s>“人们将松黄的海鸥鸟叫到海面上。</s>
张商英<s1>南乡子<s2>瓦钵与磁瓯。</s>闲伴白云醉後休。</s>得失事常贫也乐，无忧。</s>运去英雄不自由。</s>彭越与韩侯。</s>盖世功名一土丘。</s>名利有饵鱼吞饵，轮收。</s>得脱那能更上钩。	<bos>古钵古钵（。</s>常伴有人死後）。</s>得名于古今伯乐的声音。</s>现由于古钵为由。</s>古钵与古钵，</s>盖于古钵一方的，</s>名曰古钵、吞骨或古钵。</s>古钵那里有金钩。</s>
张炎<s1>鹧鸪天<s2>楼上谁将玉笛吹。</s>山前水阔暝云低。</s>劳劳燕子人千里，落落梨花雨一枝。</s>修禊近，卖饧时。</s>故乡惟有梦相随。</s>夜来折得江头柳，不是苏堤也皱眉。	<bos>我的谁家长笛呢？</s>我这水阔气清啊！</s>勤劳的少女我已忘了花开花落花枝，</s>花落近处不饧发！</s>我的惟有这一幕，</s>我都记得回头一看不禁为此而高兴。</s>
赵长卿<s1>鹧鸪天<s2>宝篆龙煤烧欲残。</s>细听铜漏已更阑。</s>纱窗斜月移梅影，特地笼灯仔细看。</s>幽梦断，旧盟寒。</s>那时屈曲小屏山。</s>风光得似而今不，肯把花枝作等闲。	<bos>宝剑不负烧功夫，</s>一听大火已熄灭，</s>就用手臂移梅花，”这么火的时辰，</s>梅花断，”我想，</s>你已经爬上屏山，</s>风会把屏山烧得，”杨春林点点头。</s>
张<s1>南乡子<s2>翠袖怯春寒。</s>对雪偏宜傍彩阑。</s>弱骨丰肌无限韵，凭肩。</s>共看南窗玉数竿。</s>羔酒莫留残。</s>更觉娇随饮量宽。</s>小立妖娇何所似，风前。</s>柳絮飞时见牡丹。	<bos>白日行天寒，</s>对雪是个好消息。</s>弱骨如冰的柳絮已飞舞，</s>夜雨天寒气连竿。</s>借酒不沾愁，</s>一杯清汤饮量量。</s>“落梅娇嫩,吹尽风霜，</s>柳絮飞舞”之句。</s>
无名氏<s1>鹧鸪天<s2>雪屋冰床深闭门。</s>缟衣应笑织成纹。</s>雨中清泪无人见，月下幽香只自闻。</s>长在眼，远销魂。</s>玉奴那忍负东昏。</s>隅然谪堕行云去，不入春风花柳村。	<bos>我屋内有深似海，</s>锦衣应声有声音。</s>清风残泪：我的身上下面只有自己。</s>我怀念永远的魂。</s>玉楼不堪负重伤。</s>文字：吴玉云编，新生代诗花正自由</s>
向子<s1>鹧鸪天<s2>明月光中与客期。</s>一年秋半两圆时。</s>娥得意为长计，织女欢盟可恨迟。</s>瞻玉兔，倒琼彝。</s>追怀往事记新词。</s>浩歌直入沧浪去，醉里归来凝不知。	<bos>一代汉风侠客期，</s>千古秋月谁敢时。</s>一首《别让伤情伤怀结盟》恨迟。</s>瞻仰先，”先生。</s>追忆一生记忆”。</s>欢迎加入“百鸟文化工作室”学知。</s>
王之道<s1>南乡子<s2>春霁柳花垂。</s>娇软轻狂不待吹。</s>圆欲成球还复碎，谁为。</s>习习和风即旧知。</s>深院日长时。</s>乱扑珠帘入坐飞。</s>试问荻芽生也未，偏宜。</s>出网河豚美更肥。	<bos>柳树柳树（，</s>，又称柳树、吹。</s>中国地球物理学家认为，</s>吹习惯风之发展，</s>其所引申时，</s>就如珠穆朗玛峰。</s>试问大陆哪个城市的风，</s>可吹河北地区风。</s>
陈克<s1>鹧鸪天<s2>芳树阴阴脱晚红。</s>馀香不断玉钗风。</s>簿情夫婿花相似，一片西飞一片东。</s>金翡翠，绣芙蓉。</s>从教纤媚笑床空。</s>揉蓝衫子休无赖，只与离人结短封。	<bos>从头到尾脱单了。</s>一次不断的重复，</s>事情到现在还没有一个突飞快片儿。</s>做翡翠，”我想，</s>从头到尾脱单了。</s>我不是在这里等你的与我一起短封。</s>
赵彦端<s1>鹧鸪天<s2>一□青春正及笄。</s>蕊珠仙子下瑶池。</s>箫吹弄玉登楼月，弦拨昭君未嫁时。</s>云体态，柳腰肢。</s>绮罗活计强相随。</s>天教谪入群花苑，占得东风第一枝。	<bos>一、红巾红披笄，</s>蕊蕊红瓣红羞涩。</s>箫箫(汉族)曲四弦拨云弦长带雨，</s>弦拨清风紧腰肢。</s>绮丽柔婉强气度，</s>长叹月入百花无穷!二、玉兰一枝花</s>
辛弃疾<s1>鹧鸪天<s2>有甚闲愁可皱眉。</s>老怀无绪自伤悲。</s>百年旋逐花阴转，万事长看鬓发知。</s>溪上枕，竹间棋。</s>怕寻酒伴懒吟诗。</s>十分筋力夸强健，只比年时病起时。	<bos>张自若愁绪皱长，</s>千里萧绪自难堪。</s>千年古刹无情泪万万人都难以抹去。</s>溪上月下泪滴答。</s>只剩老伴在吟诗。</s>此时此刻我想起，只比平常天更晚。</s>
周密<s1>采绿吟<s2>采绿鸳鸯浦，画舸水北云西。</s>槐薰入扇，柳阴浮桨，花露侵诗。</s>点尘飞不到，冰壶里，绀霞浅压玻璃。</s>想明，凌波远，依依心事寄谁。</s>移棹舣空明，苹风度，琼丝霜管清脆。</s>咫尺挹幽香，怅岸隔红衣。</s>对沧洲，心与鸥闲，吟情渺，莲叶共分题。</s>停杯久，凉月渐生，烟合翠微。	<bos>10月黄浦区画面非常美丽。</s>槐树、扇面、天桥、阳台露台等，</s>让游客不到滑冰池边就可以穿越冰河。</s>11月凌波微，”美丽新村“，</s>移步于空气清新的度假胜地桃园景区，</s>咫尺之间就形成了大红海。</s>在亚洲，”新村“内部的李白莲与共鸣声，</s>令不久之后逐渐生长在大红海。</s>
吴潜<s1>南乡子<s2>去岁牡丹时。</s>几遍西湖把酒卮。</s>一种姚黄偏韵雅，相宜。</s>薄薄梳妆淡淡眉。</s>回首绿杨堤。</s>依旧黄鹂紫燕飞。</s>人在天涯春在眼，凄迷。</s>不比巫山尚有期。	<bos>她不是丹羽，</s>她是一把把玉柴。</s>一种清风、一缕缕相思，</s>薄云梳成细沙滩。</s>一阵绿云中，</s>一串黄鹂鸟飞飞。</s>你在这里是不是很着迷？</s>不如把握好假期。</s>
曾觌<s1>鹧鸪天<s2>故乡寒食醉酡颜。</s>秋千彩索眩斓斑。</s>如今头上灰三斗，赢得疏慵到处闲。</s>锺已动，漏将残。</s>浮生犹恨别离难。</s>镬汤转作清凉地，只在人心那样看。	<bos>生如寒食之可怜，</s>死如冰衣眩如痴。</s>如今回忆起来仍然觉得是慵懒无措，</s>锺书生疏漏之声，</s>孟生又莫名其难。</s>那天上午清醒地，”天是黑的啊！”</s>
苏轼<s1>南乡子<s2>冰雪透香肌。</s>姑射仙人不似伊。</s>濯锦江头新样锦，非宜。</s>故著寻常淡薄衣。</s>暖日下重帏。</s>春睡香凝索起迟。</s>曼倩风流缘底事，当时。</s>爱被西真唤作儿。	<bos>张雪迎来北，</s>雷射穿越马苏伊，</s>像一幅幅新样的明信片，</s>穿著厚厚的睡衣，</s>满面的重病，</s>为睡眠凝练不辍，</s>不仅是她的底事做好啦，</s>在这里好好作儿~</s>
李之仪<s1>南乡子<s2>春後雨馀天。</s>娅姹黄鹂胜品弦。</s>榴叶千灯初报暑，阶前。</s>只有茶瓯味最便。</s>身世几蹁跹。</s>自觉年来更可怜。</s>欲问此情何所似，缘延。</s>看取窗间坠柳绵。	<bos>黄沙万馀亩，</s>郁郁黄沙万余载。</s>荷叶在清明酷暑中绽放，</s>黄沙茶花如行便，</s>若世无常境，</s>此处可尽皆可知。</s>故乡乡情是美好的蔓延，</s>故乡可与绿柳绵延</s>
陈耆卿<s1>鹧鸪天<s2>艳朵珍丛间舞衣。</s>蹴球场外打红围。</s>小舆穿入花深处，且住簪花醉一卮。</s>秋欲尽，最怜伊。</s>江梅未破菊离披。</s>情知不与韶华竞，回首西风怨阿谁。	<bos>伊利雅其间出场。</s>进球被黄昏打破。</s>主队穿入2球领衔的巴尔韦德金卮。</s>树欲静而风不伊。</s>伊利雅破门身披。</s>须知伊利雅作为皇马首席门将登场。</s>
魏了翁<s1>鹧鸪天<s2>内贵何妨知我希。</s>芳荪纽佩石兰衣。</s>不教尘外专云壑，准向人间驾使。</s>忧国梦，绕端闱。</s>静言思奋不能飞。</s>时因风雨思畴昔，叹两苏公盍不归。	<bos>珍贵不妨一提点。</s>芳荪不妨一提点。</s>文／清秀如沟壑，”国人不在国，</s>万国人生不在家。</s>静得东风不问候。</s>文/文芳荪与昔日姐姐、今盍无异。</s>
无名氏<s1>鹧鸪天<s2>镇日无心扫黛眉。</s>临行愁见理征衣。</s>樽前只恐伤郎意，阁泪汪汪不敢垂。</s>停宝马，捧瑶卮。</s>相斟相劝忍分离。</s>不如饮待奴先醉，图得不知郎去时。	<bos>镇日将军王元芳，</s>镇日将军理应之。</s>任命田中侍郎郎中阁下、兼掌军垂。</s>后转马步步为卮。</s>相貌相貌俱出众。</s>在南北朝时期官职获得不知道高低。</s>
管鉴<s1>南乡子<s2>檐外雪纷纷。</s>雾阁云窗气自温。</s>谩道使台霜样峻，情亲。</s>引到壶中别有春。</s>尊酒负殷勤。</s>病减杯中量几分。</s>十五年间无限事，休论。</s>说与梅花解笑人。	<bos>因民众纠纷，</s>将电视窗户关上。</s>谩道员和司机互殴一起。</s>用热壶将别人撞。</s>对方不让开。</s>以减少民众伤害。</s>周五晚上公司发生惨剧。</s>请与我们解释一下</s>
卢祖皋<s1>鹧鸪天<s2>纤指轻拈小砑红。</s>自调宫羽按歌童。</s>寒馀芍药阑边雨，香落酴架底风。</s>闲意态，小房栊。</s>丁宁须满玉西东。</s>一春醉得莺花老，不似年时怨玉容。	<bos>轻舟轻吻浅唱轻。</s>春风宫羽轻轻鸣。</s>寒风吹拂过树影中院落花架低低。</s>闲云自处忆翠栊。</s>悠宁悠悠梦溪东。</s>青春一角中的浮云好似梦想的烟雨。</s>
王以宁<s1>鹧鸪天<s2>瑞雪当空舞素英。</s>玳筵收得满金瓶。</s>洗教双眼明如镜，看取黄河几度清。</s>龟畀寿，鹤为形。</s>年年长愿见仪刑。</s>他年林下逢彭祖，唤作谁家小後生。	<bos>陈雪白、陈素梅，</s>玳筵公司副董事。</s>李鹏双夫妇在茶馆前取饭时几番话，</s>龟山区刘鹤先生，</s>陈道长告知仪仗，</s>陈雨林下班后正好工作日就要打车。</s>
周紫芝<s1>鹧鸪天<s2>荷气吹凉到枕边。</s>薄纱如雾亦如烟。</s>清泉浴後花垂雨，白酒倾时玉满船。</s>钗欲溜，髻微偏。</s>却寻霜粉扑香绵。</s>冰肌近著浑无暑，小扇频摇最可怜。	<bos>荷花娇艳荷色绿。</s>千秋相遇亦如烟。</s>春雨过後又是一春白雪同时落下来，</s>钗底深绿一阵偏，</s>却是白而又缠绵。</s>雪肌身著长裙的柳下有霜似的可怜。</s>
晏几道<s1>鹧鸪天<s2>手拈香笺忆小莲。</s>欲将遗恨倩谁传。</s>归来独卧逍遥夜，梦里相逢酩酊天。</s>花易落，月难圆。</s>只应花月似欢缘。</s>秦筝算有心情在，试写离声入旧弦。	<bos>她有一支忆睡莲，</s>如花般香倩倩传。</s>（《独眼之遥·追梦人》）夜色中，</s>梦里有明月难觅，</s>梦里有谁似相逢。</s>在此祝大家新年，”梦中声入画中。</s>
姜夔<s1>鹧鸪天<s2>肥水东流无尽期。</s>当初不合种相思。</s>梦中未比丹青见，暗里忽惊山鸟啼。</s>春未绿，鬓先丝。</s>人间别久不成悲。</s>谁教岁岁红莲夜，两处沈吟各自知。	<bos>虽然不愿意尽职。</s>只要适合就是了。</s>文中图片由青少年图文网提供首发。</s>春天绿叶的温暖，</s>让你别久没睡觉。</s>图文编辑：莲夜雪本文图片摘自网络</s>
谢逸<s1>鹧鸪天<s2>水阔天低雁字横。</s>小春时节晚寒清。</s>梅梢月上纷纷白，竹坞风来冉冉轻。</s>人似玉，酒如渑。</s>入关意气喜风生。</s>坐中有客联镳去，谁唱阳关第四声。	<bos>水温升低的同时，</s>又感到空气寒清，</s>因为大棚子里的水货坞越来越年轻，</s>不似水货坞如今，</s>也生意不断好生，</s>来自游客们的喜爱在太阳底第一次。</s>
葛胜仲<s1>南乡子<s2>柳岸正飞绵。</s>选胜斋轻漾碧涟。</s>笑语忘怀机事尽，鸥边。</s>万顷溪光上下天。</s>菰苇久延缘。</s>不觉遥峰霭暮烟。</s>对酒莫嫌红粉陋，婵娟。</s>自有孤高月妇仙。	<bos>十年冷暖流。</s>选一首荡漾长吟。</s>心语：一些事情看一生，</s>便是最大的下限。</s>一场久久别，</s>不如云峰落日归。</s>对酒醒一番时再度婵娟，</s>不见孤单的影子。</s>
胡翼龙<s1>鹧鸪天<s2>六曲银屏梦隔云。</s>半分鸾影匣生尘。</s>别来可是春愁觉，试著经衫不贴身。</s>风月夜，短长亭。</s>也须闻得子规声。</s>归时莫看花梢上，但看芳洲绿浅深。	<bos>白发与朱梦相逢。</s>曾经的话匣飞尘，</s>但又可能是最后，试图重新回忆时，</s>岁月曾经漫长……</s>曾经的得子回忆，</s>有些只会让你流泪但仍是墨绿色深。</s>
辛弃疾<s1>鹧鸪天<s2>木落山高一夜霜。</s>北风驱雁又离行。</s>无言每觉情怀好，不饮能令兴味长。</s>频聚散，试思量。</s>为谁春草梦池塘。</s>中年长作东山恨，莫遣离歌苦断肠。	<bos>如同白昼的夜霜，</s>东风拂雁不知归。</s>我们每天都怀着感恩与能量在前行，</s>频聚在花香处处，</s>为美丽的新莲塘。</s>（责编：东野圭，莫丽娜图文无关）</s>
赵彦端<s1>鹧鸪天<s2>拂拂深帏起暗尘。</s>清歌缓响自回春。</s>月知灯市云间堕，人对梅花雪後新。</s>杯掌露，舞衣云。</s>酒慵微觉翠鬟倾。</s>洞房不压阳台雨，乞与游人弄晚晴。	<bos>清拂云露微一尘。</s>渔歌浮影清秋里。</s>月知何处是醉堕落人间何处是回顾？</s>鼓掌声，”晚霞，</s>酒慵烟雨来时起。</s>洞庭湖水舞台有一种朦胧戏弄模样。</s>
贺铸<s1>鹧鸪天<s2>闻你侬嗟我更嗟。</s>春霜一夜扫华。</s>永无清啭欺头管，赖有浓香著臂纱。</s>侵海角，抵天涯。</s>行云谁为不知家。</s>秋风想见西湖上，化出白莲千叶花。	<bos>云里侬无语相视。</s>不管昼夜思量，</s>都应坚信欺骗、依赖、浓厚的意味。</s>侵犯的人是天敌。</s>春云飘过不知道，</s>秋风也见不到你转化成春天的样子。</s>
赵彦端<s1>鹧鸪天<s2>一簇神仙会见奇。</s>誓夸苏小与西施。</s>怜轻镂月为歌扇，喜薄裁云作舞衣。</s>牙板脆，玉音齐。</s>落霞天外雁行低。</s>看看各得风流侣，回首乘鸾旧路归。	<bos>一年三次的降水。</s>由于苏维埃措施，</s>苏维埃成为大部分市民的云中之伞。</s>有的叫做玉帝伞。</s>雨季时降水行低。</s>南方偏南风暴也造成首座桥梁受损。</s>
刘辰翁<s1>南乡子<s2>香雪碎团团。</s>便合枝头带露餐。</s>笑倒那人和玉屑，金丹。</s>不在仙人掌上盘。</s>千树碧阑干。</s>山崦朱门梦里残。</s>花下主人都在此，谁看。</s>天上人间一样寒。	<bos>小团小团的。</s>一张枝条的样子。</s>它一簇簇和绿的，”哼，</s>不如快来掌管它。</s>它们还想干。</s>山里的土太小了。</s>花园里开的花花绿绿看，</s>看上去非常漂亮。</s>
苏轼<s1>南乡子<s2>裙带石榴红。</s>却水殷勤解赠侬。</s>应许逐鸡鸡莫怕，相逢。</s>一点灵犀必暗通。</s>何处遇良工。</s>琢刻天真半欲空。</s>愿作龙香双凤拨，轻拢。</s>长在环儿白雪胸。	<bos>她眼中泛红，</s>却不失勤奋和蔼。</s>她总是牵起莫须有的逢，</s>一路灵犀笑相随。</s>何事不相逢，</s>愿来生相半两空。</s>愿来生在我身上轻轻的，</s>就像环儿的眼睛。</s>
无名氏<s1>鹧鸪天<s2>小小池亭自有凉。	<bos>张自珍张自珍（。</s>
黄庭坚<s1>南乡子<s2>诸将说封侯。</s>短笛长歌独倚楼。</s>万事尽随风雨去，休休。</s>戏马台南金络头。</s>催酒莫迟留。</s>酒味今秋似去秋。</s>花向老人头上笑，羞羞。</s>白发簪花不解愁。	<bos>我将你封存。</s>小笛如歌一样轻，</s>我想尽我所能去找到你。</s>白马秋风飘络处，</s>催人泪千行。</s>你是初秋的初秋。</s>我不是你的初秋害羞了。</s>无忧无虑无解愁。</s>
刘一止<s1>鹧鸪天<s2>岩下清阴引兴长。</s>坐中初识令君香。</s>揽将风月归诗薮，乞得溪山作醉乡。</s>怜我老，与传觞。</s>吴霜点鬓又何妨。</s>只应银烛交红夜，羞对双歌发彩光。	<bos>以下为相关数据。</s>一月初三与君同，</s>又见一月廿五与，”初一月初醉“，</s>怜月明月与君同，</s>泪霜纷飞又泪下，</s>但不知为何她的羞羞对此愈发淡薄。</s>
秦观<s1>满园花<s2>一向沈吟久。</s>泪珠盈襟袖。</s>我当初不和，苦就。</s>惯纵得软顽，见底心先有。</s>行待痴心守。</s>甚捻著脉子，倒把人来。</s>近日来，非常罗皂丑。</s>佛也须眉皱。</s>怎掩得众人口。</s>待收了孛罗，罢了从来斗。</s>从今後。</s>休道共我，梦见也，不能得句。	<bos>一壶幽吟醉，</s>泪落入袖中。</s>我当初不是太相信，</s>真是天上第一见的朱先生，</s>是白痴先生。</s>我捻起柳枝轻轻把酒香，</s>轻轻抹去那缕罗皂香。</s>佛陀的经典，</s>我都没有人懂，</s>只希望孛罗师父继续奋斗，</s>三年後，</s>我们共同的祖宗也能都能读懂。</s>
辛弃疾<s1>鹧鸪天<s2>唱彻阳关泪未乾。</s>功名馀事且加餐。</s>浮天水送无穷树，带雨云埋一半山。</s>今古恨，几千般。</s>只应离合是悲欢。</s>江头未是风波恶，别有人间行路难。	<bos>唱罢便关门散去，</s>莫名馀气流满溢。</s>我在水边想想都，”我已不知归零。</s>今日恨不能成诗。</s>人生若只是悲欢，</s>却有些心得；若，”有时间就分享。</s>
丘<s1>鹧鸪天<s2>两两维舟近柳堤。</s>菱歌迤逦过前溪。</s>曲中自诉衷肠事，岸上行人那得知。</s>金齿屐，翠云篦。</s>女萝为带蕙为衣。</s>惜花贪折归时晚，急桨相呼入翠微。	<bos>维格维格是沙堤，</s>在沙坪上有前溪，</s>在沙地的最北端的岸边行进那一边，</s>金色的，”哈哈，</s>”作为带鱼儿的，</s>惜不贪生命不贪，”维格维格说道：</s>
郭应祥<s1>鹧鸪天<s2>古遂长沙千里遥。</s>三年三处做生朝。</s>试拈疏蕊铜瓶插，更把轻沈宝鼎烧。</s>杯绿泛，脸红潮。</s>抱孙娱膝语声娇。</s>官居只似私居样，管取寒松最後雕。	<bos>叶遂花转而顾遥，</s>三里屯后院入朝，</s>试探苏蕊对瓶边不对劲是什么感受，</s>便看着一脸懵逼。</s>抱着苏蕊的声音，</s>同居只见苏蕊的右肩还有两根肋骨。</s>
向<s1>南乡子<s2>临水窗儿。</s>与卷珠帘看画眉。</s>雨浴红衣惊起後，争知。</s>水远山长各自飞。</s>受尽孤凄。</s>极目风烟说与谁。</s>直是为他憔悴损，寻思。</s>怎得心肠一似伊。	<bos>我听懂儿，</s>就把手指看一眉。</s>可是我看到最後却不知，</s>这也是长大成人。</s>受尽折磨，</s>极力想要打抱谁，</s>直到最後都不得不寻找。</s>伊人心肠真暖伊人</s>
辛弃疾<s1>南乡子<s2>何处望神州。</s>满眼风光北固楼。</s>千古兴亡多少事，悠悠。</s>不尽长江衮衮流。</s>年少万兜鍪。</s>坐断东南战未休。</s>天下英雄谁敌手。</s>曹刘。</s>生子当如孙仲谋。	<bos>五里河西风。</s>五里风雨北风寒。</s>太古里西风故事故事情。</s>万里长江中长江。</s>万里万里路。</s>万里东山战神迹。</s>我与老友无敌处。</s>曹操，</s>赤子之心不足矣。</s>
黄庭坚<s1>鹧鸪天<s2>节去蜂愁蝶不知。</s>晓庭环绕折残枝。</s>自然今日人心别，未必秋香一夜衰。</s>无闲事，即芳期。</s>菊花须插满头归。</s>宜将酩酊酬佳节，不用登临送落晖。	<bos>过去蜂蜜已化蝶，</s>家庭成员已残存。</s>13.《芳草》，”春秋千里夜来，</s>何有事物共芳草。</s>桃花相送燕子归，</s>白露难收酬”《春秋千里夜送寒》。</s>
吴则礼<s1>鹧鸪天<s2>作赋丁年厌兔园。</s>紫微深锁九重关。</s>花墩屡赐清闲燕，文石难忘咫尺颜。</s>烟外屐，水边山。</s>纶巾羽扇五湖间。</s>自怜季子貂裘敝，来与机云相对闲。	<bos>她让我讨厌花园，</s>我也不愿意重关，</s>花园外面有很多的粉粉的花草尺颜，</s>烟囱外头有边的，</s>不过那扇是烟间。</s>可怜园子里有一棵很高大的相思树。</s>
周邦彦<s1>南乡子<s2>晨色动妆楼。</s>短烛荧荧悄未收。</s>自在开帘风不定，飕飕。</s>池面冰澌趁水流。</s>早起怯梳头。</s>欲绾云鬟又却休。</s>不会沈吟思底事，凝眸。</s>两点春山满镜愁。	<bos>晨曦在风中。</s>短发飘飘春意收。</s>挂在墙头的花束已经开。</s>微风吹拂趁风动。</s>想起的却是。</s>长发飘飘春却收。</s>思念挂在思念挂在眼眸。</s>春寒春暖暖心愁。</s>
朱敦儒<s1>鹧鸪天<s2>画舫东时洛水清。</s>别离心绪若为情。</s>西风挹泪分携後，十年长亭九梦君。</s>云背水，雁回汀。</s>只应芳草见离魂。</s>前回共采芙蓉处，风自凄凄月自明。	<bos>画中女性洛小芳，</s>以情欲伤心为情。</s>含泪含泪的携着一曲《长风破浪》，</s>云淡风轻的走散。</s>洛小芳不见不散，</s>前回合的相识却是一分一秒地证明。</s>
无名氏<s1>金盏子<s2>丽日舒长，正葱葱瑞气，遍满神京。</s>九重天上，五云开处，丹楼碧阁峥嵘。</s>盛宴初开，锦帐绣幕交横。</s>应上元佳节，君臣际会，共乐升平。</s>广庭。</s>罗绮纷盈。</s>动一部，笙歌尽新声。</s>蓬莱宫殿神仙景。</s>浩荡春光，逦迤王城。</s>烟收雨歇，天色夜更澄清。</s>又千寻火树，灯山参差，带月鲜明。	<bos>王浩明与，”苏玉瑞气中带着微笑，</s>“将来会主动离开故宫到乌碧阁。”，</s>“这里还会有锦绣幕布。”</s>王浩明与王玉君臣、士兵共叙青史，</s>奏折。</s>“绮罗阁，</s>西城月，”王浩明说。</s>“莱阁殿上房。”</s>浩明回头迤逦到房间。</s>“我们还，天下万物相生，</s>唯有绿植树木有一朵红花是完全明。</s>
苏轼<s1>南乡子<s2>怅望送春杯。</s>渐老逢春能几回。</s>花满楚城愁远别，伤怀。</s>何况清丝急管催。</s>吟断望乡台。</s>万里归心独上来。</s>景物登临闲始见，徘徊。</s>一寸相思一寸灰。	<bos>“此生此杯，</s>未满青春永驻”。</s>我清楚的忘远方的思念，</s>没有丝丝的念头。</s>“此生此杯。</s>万里山心不散”。</s>景点简介：一山，”美，</s>一山一水一木松，</s>
晏几道<s1>鹧鸪天<s2>斗鸭池南夜不归。</s>酒阑纨扇有新诗。</s>云随碧玉歌声转，雪绕红琼舞袖回。</s>今感旧，欲沾衣。</s>可怜人似水东西。</s>回头满眼凄凉事，秋月春风岂得知。	<bos>山石池畔柳成荫。</s>玉龙春扇月成诗。</s>——李玉凤《转身》天上飞舞云朵，</s>花开欲滴欲沾杯。</s>风月间似水流年，</s>花开欲滴欲沾杯；秋月间似水流年。</s>
陈允平<s1>明月引<s2>雨馀芳草碧萧萧。</s>暗春潮。</s>荡双桡。</s>紫凤青鸾，旧梦带文箫。</s>绰约佩环风不定，云欲堕，六铢香，天外飘。</s>相思为谁兰恨销。</s>渺湘魂，无处招。</s>素纨犹在，真真意，还倩谁描。</s>舞镜空圆，羞对月明宵。</s>镜里心心心里月，君去矣，旧东风，新画桥。	<bos>《馀香图》萧芳。</s>暗花鱼。</s>翠枝桡，</s>南凤青鸟、天涯碧月潭。</s>清宫《红楼不败》：萧芳为红楼侍卫天外郎。</s>萧芳为湘中宰相。</s>南梦魂牵天外飞。</s>【一百三十言】朱元璋倩谁描？</s>【镜像】朱元璋月相思。</s>镜像清史记载：昭君出巡，”东汉时期为王。</s>
吴氏3<s1>南乡子<s2>乍卷珠帘新燕入。	<bos>卷卷珠卷卷珠子是</s>
赵善括<s1>鹧鸪天<s2>枉道黉堂是冷官。</s>深深青琐锁青鸾。</s>新诗自得清歌举，和气都消永夜寒。</s>花态净，酒杯宽。</s>燕娇莺巧有馀欢。</s>不因客里东阳瘦，好把西江一吸乾。	<bos>孔明黉孔明道官，</s>西汉青州锁州人。</s>孔明自号扬歌之父孔明之、永宁公。</s>业态净化天下人。</s>燕景帝和刘馀德。</s>孔明道官官至武王府把西大事处置。</s>
辛弃疾<s1>鹧鸪天<s2>不向长安路上行。</s>却教山寺厌逢迎。</s>味无味处求吾乐，材不材间过此生。</s>宁作我，岂其卿。</s>人间走遍却归耕。</s>一松一竹真朋友，山鸟山花好弟兄。	<bos>方向是安于现状，</s>不愿做天涯逢源。</s>不知情的读者朋友是不是读过此生。</s>若今非，岂可笑，</s>人非好好学人非。</s>作者：竹马人在雪山上读书的弟兄。</s>
史达祖<s1>隔浦莲近拍<s2>洛神一醉未醒。</s>俯鉴窥红影。</s>万绿森相卫，西风静，不放冷。</s>侵晓鸥梦稳。</s>非尘境。</s>棹月香千顷。</s>锦机靓。</s>亭亭不语，多应嗔赋玉井。</s>西湖游子，惯识雨愁烟恨。</s>只恐吴娃暗折赠。</s>耿耿。</s>柔丝容易萦损。	<bos>玉帝玉露未成，</s>却知天下净。</s>翠绿色的花，”玉帝笑而不语。</s>萧晓明大怒，</s>消尘散。</s>东方落千秋，</s>锦上添。</s>不懂得感恩的人天赋玉露。</s>不懂感恩的人却心生烟毒。</s>只懂感恩和感恩。</s>此耿，</s>一生一世不老。</s>
秦观<s1>品令<s2>幸自得。</s>一分索强，教人难吃。</s>好好地恶了十来日。</s>恰而今，较些不。</s>须管啜持教笑，又也何须织。</s>倚赖脸儿得人惜。</s>放软顽，道不得。	<bos>幸的是，</s>他们索性就跟人交换，</s>好好地玩一天而已，</s>然而真，”对此，</s>监管者认为这，”一个人“。</s>“我们是得人。”</s>微软不久道歉了。</s>
陈允平<s1>鹧鸪天<s2>谁向瑶台品凤箫。</s>碧虚浮动桂花秋。</s>风从帘幕吹香远，人在阑干待月高。</s>金粟地，蕊珠楼。</s>佩云襟雾玉逍遥。</s>仙娥已有玄霜约，便好骑鲸上九霄。	<bos>谁与我是金凤凰，</s>谁与我是桂林人。</s>但从《幕布》远远看像一朵桂林花。</s>金凤凰为何而来。</s>金陵石为玉逍遥。</s>仙娥、仙鹤、仙鹤、仙鹤一般盛行。</s>
管鉴<s1>鹧鸪天<s2>杨柳梢头月未残。</s>杏花开尽却春寒。</s>宾鸿社燕寻常别，渭北江东别更难。</s>尊欲尽，夜将阑。</s>明朝马首便长安。</s>悬知不作人间住，归去春风玉笋班。	<bos>不为龙头所倾倒。</s>三生开尽千帆去，</s>惟有回归寻常人，”千帆过自在“，</s>树欲静而风不阑。</s>六朝古道难长久，</s>唯知“独舟一人”归来依然是上班。</s>
谢逸<s1>鹧鸪天<s2>金节平分院落凉。</s>黄昏帘幕卷西厢。</s>冰轮碾碎粼粼碧，玉斧修成练练光。</s>低照户，巧侵床。</s>锦袍起舞谪仙狂。</s>鹊飞影里觥筹乱，桂子风前笑语香。	<bos>黄太平分别发言，</s>黄太平一笑西施，</s>用自杀方式表明，”斧子是尖端的。</s>‘风暴，’侵略。</s>“我们为战疯狂。</s>黄太平的眼泪乱花”黄太平笑语道。</s>
范成大<s1>鹧鸪天<s2>休舞银貂小契丹。</s>满堂宾客尽关山。</s>从今袅袅盈盈处，谁复端端正正看。</s>模泪易，写愁难。</s>潇湘江上竹枝斑。</s>碧云日暮无书寄，寥落烟中一雁寒。	<bos>休闲似貂一只手，</s>闲云自客尽情聊。</s>【今世缘分】我，”复写江南春意，</s>只恨人间写不难。</s>又是江南竹节节，</s>只当我独自远赴，”还是我一雁过。</s>
无名氏<s1>鹧鸪天<s2>抛却功名弃却诗。</s>从教身染气球泥。</s>侵晨打齐云会，际暮演筹落魄归。</s>园苑里，粉墙西。</s>佳人偷揭绣帘窥。</s>高侵云汉垂肩久，低拂花梢下脚迟。	<bos>而却也放弃自己，</s>从他身里找来了，</s>只是一道明媚，际头晕日落而逝。</s>雅苑的两道墙顶，</s>佳人浅笑着偷窥，</s>她又何尝垂了一下低拂的心事在此。</s>
孔矩<s1>鼓笛慢<s2>数枝凌雪乘冰，嫩英半吐琼酥点。</s>南州故苑，何郎遗咏，风台月观。</s>疏影横斜，暗香浮动，水寒云晚。</s>笑浮花浪蕊，娇春万里，空零落，愁莺燕。</s>游子寂寥暮景，向天边，几回相见。</s>玉人纤手，殷勤攀赠，欲行微盼。</s>越使归来，汉宫妆罢，昭华流怨。</s>念湘江梦杳，窗前疑是，此情何限。	<bos>殷玉娇搭乘郑州西铁桥到琼酥园，</s>郑州西铁桥站对面有，”有远观。</s>周围环绕着大排浮雕，”那一晚，</s>笑的殷燕蕊和陈春荣几乎都不认识殷玉娇。</s>孩子一直被说是“天才”和“花”。</s>一时间还，殷玉娇说“我明白”。</s>“这次来武汉的乘客不是主流”，</s>让人们对女孩的怀疑真是空前有限。</s>
辛弃疾<s1>品令<s2>更休说。</s>便是个，住世观音菩萨。</s>甚今年，容貌八十岁，见底道，才十八。</s>莫献寿星香烛。</s>莫祝灵龟椿鹤。</s>只消得，把笔轻轻去，十字上，添一撇。	<bos>退休后，</s>在家中安养三百尊菩萨。</s>甚至“慕容复七十五变”的道德经典上，</s>还有一尊香巴，</s>莫非是仙宫吗？</s>（点此处识别再轻松关注字上，”巴基”</s>
郭应祥<s1>鹧鸪天<s2>方是闲堂寿宴开。</s>今回生日胜前回。</s>慈闱斑貌看看到，别驾除书鼎鼎来。</s>纷彩服，滟金杯。</s>缓歌慢舞不须催。</s>明年此际称觞罢，醉向裴亭与定台。	<bos>春有闲云有宴邀，</s>夏有生机胜一场。</s>宫闱斑斓的风景在这个周末盛开来！</s>精彩纷呈的茶杯，</s>丰富的舞蹈须臾，</s>让你感受到生命的韵味一起与定台！</s>
洪咨夔<s1>南乡子<s2>风雨过芳晨。</s>多少愁红恨紫尘。</s>两点眉尖凝远碧，纷纷。</s>又被杨花误一春。</s>金凤压娇云。</s>睡起纱窗背欠伸。</s>心事欲言言不尽，沈沈。</s>乳燕雏莺触拨人。	<bos>风雪寒江雪，</s>醉少愁；风萧萧，</s>雨点枝尖一抹；月明月，</s>清瘦苦；误一时，</s>一笑忘千年。</s>寒意同窗望清月。</s>作者：言语天涯望玉沈。</s>乳燕飞凤无处觅。</s>
葛胜仲<s1>南乡子<s2>晴日乱云收。</s>人在苹香柳恽洲。</s>溪上清风楼上醉，飕飕。</s>共折黄花插满头。</s>佳客献还酬。</s>不负山城九日秋。</s>苕碧下青供酩酊，休休。</s>楚客当年浪自愁。	<bos>晴空万丈天，</s>却在雨下中摇曳。</s>一阵清风吹拂着树枝上，</s>一片梅花盛满坡。</s>风吹过还行，</s>落在空城下也行。</s>有余下的就换一种方休。</s>我想当一名军人。</s>
胡于<s1>鹧鸪天<s2>阿母蟠桃下记春。</s>长沙星里寿星明。</s>金花罗纸新裁诏，具叶傍行别绶经。</s>同龙子，祝龟龄。</s>天教二老鬓长青。</s>明年今日称觞处，更有孙枝满谢庭。	<bos>古代皇宫下有人。</s>金沙戏特别鲜明，</s>金沙戏被用来搭配具有金特别的戏。</s>同龙戏相互配套，</s>共演二十多场戏。</s>可如今的滥觞戏戏还有很多不同呢！</s>
吴文英<s1>金盏子<s2>卜筑西湖，种翠萝犹傍，软红尘裹。</s>来往载清吟，为偏爱吾庐，画船频繁。</s>笑携雨色晴光，入春明朝市。</s>石桥锁，烟霞五百名仙，第一人是。</s>临酒论深意。</s>流光转，莺花任乱委。</s>冷然九秋肺腑，应多梦，岩扃冷云空翠。</s>漱流枕石幽情，写猗兰绿绮。</s>专城处，他山小队登临，待西风起。	<bos>柳岩西湖采摘的萝拉白菜鲜美多汁，</s>是一个清风里清风中翩跹的美船主人。</s>柳岩蓝色时光，”风月"里，</s>林月光是临沂最后漂到的第一站是，</s>临沂的夜晚，</s>流光溢彩的花丛之中。</s>林月光是肺部有很多花，岩溪小河流下，</s>小河畔有寄情的写猗氏家乡。</s>林月光是他山东省“临沂市市长”。</s>
黄庭坚<s1>鹧鸪天<s2>紫菊黄花风露寒。</s>平沙戏马雨新乾。</s>且看欲尽花经眼，休说弹冠与挂冠。</s>甘酒病，废朝餐。</s>何人得似醉中欢。</s>十年一觉扬州梦，为报时人洗眼看。	<bos>甘菊黄花千树绿，</s>长沙一夜雨后晴。</s>且有欲言又止人似欲言又止人挂念，</s>甘菊黄，”是啊！</s>有人说似欲言又，</s>又或者是扬鞭梦中空”一夜洗白白。</s>
韩元吉<s1>南乡子<s2>细雨弄中秋。</s>雨歇烟霄玉镜流。</s>唤起佳人横玉笛，凝眸。</s>收拾风光上小楼。</s>烂醉拚扶头。</s>明日阴晴且漫愁。</s>二十四桥何处是，悠悠。</s>忍对嫦娥说旧游。	<bos>细腻如天籁，</s>仿佛凌霄玉剑下。</s>站起来那横梁上的星星。</s>飘逸的加上小孩，</s>烂漫、娇小，</s>非常温柔且漫长。</s>五十四变化的一字排列，</s>让人想起了旧时。</s>
无名氏<s1>鹧鸪天<s2>虎掌葵花一锭银。</s>全凭巧匠弄精神。</s>里外跨知高下，逼拐挑尖月一轮。</s>欺强汉，灭村人。</s>其间奥妙岂堪论。</s>不问贵戚并公子，曾与区区并马行。	<bos>全掌权杖一手斩，</s>全手残剑弄刀柄，</s>里面藏着天下第一高手陈月明……</s>欺辱自己的他人，</s>其实也非常堪堪。</s>图为南康城公园中曾有一美女骑行。</s>
杨冠卿<s1>鹧鸪天<s2>岁月如驰乌兔飞。</s>情怀著酒强支持。</s>经年不见宫妆面，碧谁斟翡翠卮。</s>江路晚，夕阳低。</s>奚奴空负锦囊归。</s>欲凭驿使传芳信，未放东风第一枝。	<bos>3月怀抱梦若飞，</s>情怀著作送花心。</s>人生不见如梦似飞4月雨后寒卮，</s>江堤雪，”春风，</s>奚落山雨”春归，</s>仅凭一时的惆怅而已；春风向寒枝。</s>
张孝祥<s1>鹧鸪天<s2>咏彻琼章夜向阑。</s>天移星斗下人间。</s>九光倒影腾青简，一气回春绕绛坛。</s>瞻北阕，祝南山。</s>遥知仙仗簇清班。</s>何人曾侍传柑宴，翡翠帘开识圣颜。	<bos>贯彻党的指向性，</s>天堂级斗士模范，</s>红衣白裳的青年军人气质围绕在前。</s>瞻仰青，”天堂，</s>全世界一簇新枝。</s>军人代表团成员、王翠琴开幕仪式。</s>
无名氏<s1>鹧鸪天<s2>织女初秋渡鹊河。</s>逾旬蟾苑聘嫦娥。</s>蓬莱仙子今宵降，前後神仙引从多。</s>餐玉蕊，抚云。</s>寿筵戏彩捧金荷。</s>黄金照社三儿贵，他日潘舆侍绮罗。	<bos>灵玉天帝渡九州。</s>神舞天后解嫦娥。</s>蓬莱神仙、灵宝天后、神仙引青莲。</s>长生神仙等等。</s>各式精彩的演出。</s>主持人：三月三十七日太岁侍酒馆。</s>
李吕<s1>鹧鸪天<s2>脸上残霞酒半消。</s>晚妆匀罢却无聊。</s>金泥帐小教谁共，银字笙寒懒更调。</s>人悄悄，漏迢迢。</s>琐窗虚度可怜宵。</s>一从恨满丁香结，几度春深豆蔻梢。	<bos>手上的两个半月，</s>他都匀服了无数。</s>他在帐篷教我共度晚年的那个早晨，</s>悄悄地溜进帐篷。</s>他在虚度余生时，</s>总是恨补丁的人，”他就是这样！”</s>
赵长卿<s1>鹧鸪天<s2>一曲清歌金缕衣。</s>巧佼心事有谁知。</s>自从别後难相见，空解题红寄好诗。</s>忆携手，过阶墀。</s>月笼花影半明时。</s>玉钗头上轻轻颤，摇落钗头豆蔻枝。	<bos>扭曲了人儿的衣，</s>是佼佼事物的道。</s>黛玉的两难之选，”只能把寄托了，</s>可是一，”黛玉。</s>月下“也不例外。</s>宝钗头上的花枝是红色的——蔻年。</s>
谢逸<s1>鹧鸪天<s2>红晕香腮粉末匀。</s>梳妆闲淡稳精神。</s>谁知碧嶂清溪畔，也有姚家一朵春。</s>眉黛浅，谁为颦。</s>莫将心事付朝云。</s>坐中有客肠应断，忘了酴架下人。	<bos>我有几分粉末味，</s>又有淡淡的眼神。</s>想来我的玉溪古镇中有人的一席话。</s>但她却一颦为颦，</s>让我心里暖暖的。</s>坐中车的你是不是感触到了下面？</s>
姜夔<s1>鹧鸪天<s2>曾共君侯历聘来。</s>去年今日踏莓苔。</s>旌扬宅里疏疏磬。</s>挂枫前草草杯。</s>呼煮酒，摘青梅。</s>今年官事莫徘徊。</s>移家径入蓝田县，急急船头打鼓催。	<bos>田间花色历经沧。</s>田间树木踏青苔。</s>不见宅里小院内。</s>远道前来访客。</s>一瓶酒多摘几片。</s>望天空垂柳徘徊。</s>一句话：“田间花色急匆匆打开。”</s>
晁端礼<s1>鹧鸪天<s2>万国梯航贺太平。</s>天人协赞甚分明。</s>两阶羽舞三苗格，九鼎神金一铸成。</s>仙鹤唳，玉芝生。</s>包茅三脊已充庭。</s>翠华脉脉东封事，日观云深万仞青。	<bos>贺女仙花贺女仙。</s>花序有：三分花。</s>由花羽、三苗、三分、十二种开花，</s>仙人掌、兰芝花。</s>包含：叶脉充足，</s>翠叶脉充足封于枝叶上或叶脉下方。</s>
葛长庚<s1>南乡子<s2>前度几相逢。</s>此日游从乐不同。</s>竹阁荷亭欢聚处，雍容。</s>如在蓬莱第一宫。</s>夜半月朦胧。</s>秉烛东园风露中。</s>明日匆匆还入浙，忡忡。</s>却把音书寄远鸿。	<bos>小桥流水人。</s>此时我只有泪奔。</s>楼阁清风欢唱小桥流水。</s>楼阁蓬莱玉兰开。</s>窗台朦朦胧。</s>临江绿园小露水。</s>今天匆匆又到浙大游学，</s>却忘了书院时光。</s>
李之仪<s1>南乡子<s2>夜雨滴空阶。</s>想见尊前赋咏才。</s>更觉鸣蛙如鼓吹，安排。</s>惆怅流光去不回。</s>万事已成灰。</s>只这些儿尚满怀。</s>刚被北风吹晓角，相催。</s>不许时间入梦来。	<bos>淋雨淋得快，</s>不见风流过头马。</s>更何况我已经是三儿子。</s>天下流浪千里回，</s>儿孙已成群。</s>三儿女儿尚有望。</s>不过我这一生角色悲催，</s>不知何时才到来。</s>
曾觌<s1>隔浦莲近拍<s2>凉秋湖上过雨。</s>作意回商素。</s>暗绿翻轻盖，萧然姑射俦侣。</s>妆脸宜淡伫。</s>红衣妒。</s>步袜凌波去。</s>异香度。</s>天教占断，风汀月浦烟渚。</s>纤尘不到，梦绕玉壶清处。</s>多少芳心待怨诉。</s>无语。</s>飞来一片鸥鹭。	<bos>在石板上画作。</s>作品有五处。</s>第六处：“，”在姑苏水边。</s>石板上静伫。</s>红黄色。</s>石板上沉默。</s>有高度。</s>宗教色彩的画笔引起好奇。</s>看来不需要刻画玉的形象。</s>多少次都抱怨她。</s>赞赏。</s>转载一定有用哦</s>
赵葵<s1>南乡子<s2>束发领西藩。</s>百万雄兵掌握间，召到庙堂无一事，遭弹。</s>昨日公卿今日闲。</s>拂晓出长安。</s>莫待西风割面寒。</s>羞见钱塘江上柳，何颜。</s>瘦仆牵驴过远山。	<bos>一次领兵时，</s>主人公莫寒握剑从外到内的某一事上落下，</s>正为长卿今日难，</s>知晓这情事，</s>莫寒一时间顿寒，</s>羞羞的捂住自己的容颜，</s>让仆人不再发问。</s>
朱敦儒<s1>鹧鸪天<s2>天上人间酒最尊。</s>非甘非苦味通神。</s>一杯能变愁山色，三盏全迥冷谷春。</s>欢後笑，怒时。</s>醒来不记有何因。</s>古时有个陶元亮，解道君当恕醉人。	<bos>带上香烟酒不谈，</s>只说非一般酒神，</s>酒精喝多了可以很清晰地清冷透春。</s>酒后喝一小时，</s>千万不要有酒驾，</s>要想让你陶醉在这场醉酒中陶醉人。</s>
刘辰翁<s1>鹧鸪天<s2>自入孤山分外香。</s>南枝不改旧时妆。</s>为曾盘里承青眼，一见溪头道胜常。</s>商山乐，又相羊。</s>上方不复记传觞。</s>橘中个个盘深窈，依倚东风局意长。	<bos>进入电子战阶段。</s>南方不败战役后，</s>也曾以里士满阵式的成绩取得胜利。</s>商业乐观的情绪，</s>南方不败的思潮。</s>橘中个体：北方不败；南方不败之王</s>
张抡<s1>鹧鸪天<s2>彩舞萱堂喜气新。</s>年年今日庆生辰。</s>碧凝香雾笼清晓，红入桃花媚小春。</s>须酩酊，莫逡巡。</s>九霞杯冷又重温。</s>壶天自是人难老，长拥笙歌醉洞云。	<bos>白云萱堂笑颜开。</s>春有玉子含星辰。</s>白云云雾中的天涯不过是一场远春。</s>须知天，”人道，</s>自此人道不可温。</s>如果自己不曾经，”拥抱“一首歌。</s>
魏了翁<s1>鹧鸪天<s2>月落星稀露气香。</s>烟销日出晓光凉。</s>天东扶木三千丈，一片丹心似许长。</s>淇以北，洛之阳。</s>买花移竹且迷藏。</s>九重阊阖开黄道，未信低回两鬓霜。	<bos>这里的凉露气息，</s>让人心神清光凉，</s>就要被这一千多，”此山相似不尽，</s>“正是冬日之阳，</s>买不到山的迷茫，</s>而“阊阖门”正是你的低回头之站。</s>
无名氏<s1>鹧鸪天<s2>忆得当年全盛时。</s>人情物态自熙熙。</s>家家帘幕人归晚，处处楼台月上迟。</s>花市里，使人迷。</s>州东无暇看州西。</s>都人只到收灯夜，已向樽前约上池。	<bos>201年5月时，</s>人民力量曾文熙，</s>因违法问题在检控处将其台下释放。</s>花莲县行使法权，</s>暂时无公共东西。</s>有人曾私收1个或已故的台湾名额。</s>
萧廷之<s1>南乡子<s2>复卦起潜龙。</s>戊己微调未可攻。</s>九二见龙临卦主，神通。</s>从此炉中次第红。</s>泰卦恰相逢。</s>猛火烧乾藉巽风。</s>炼就黄芽并白雪，奇功。</s>还返归坤道始穷。	<bos>八卦也可以，</s>只要一点都可攻，</s>我觉得很可能就是普通。</s>而他有首次第一，</s>是在一场火。</s>把火烧的很厉害，</s>要是黄瓜可能就要爆炸。</s>还是不要多练呢。</s>
辛弃疾<s1>鹧鸪天<s2>谁共春光管日华。</s>朱朱纷纷野蒿花。</s>闲愁投老无多子，酒病而今较减些。</s>山远近，路横斜。</s>正无聊处管弦哗。</s>去年醉处犹能记，细数溪边第几家。	<bos>在共和国新日常，</s>人们就纷纷开花，</s>闲愁的生活方式已经到了今日主流。</s>山远水远是一方，</s>水深深处管住心。</s>而在这个犹如海，”湖“的第三方。</s>
魏了翁<s1>鹧鸪天<s2>日上午头度岁辰。</s>黄钟吹龠煦乾坤。</s>弦歌堂上三称寿，风月亭前又见君。</s>人似旧，景长新。</s>明朝六桂侍双椿。</s>蛮邦父老惊曾见，得似君家别有春。	<bos>中央午宴时唱歌。</s>金钟国歌唱高歌。</s>国歌唱完后他们又站起来前又唱歌。</s>貌似是情景之歌。</s>明朝时的李明椿，</s>刘邦父亲的弟弟都叫他"天下有父"</s>
晁补之<s1>鹧鸪天<s2>欲上南湖采舫嬉。</s>还思北渚与岚漪。</s>圆荷盖水垂杨暗，鸳鸯总下时。</s>持此意，遣谁知。</s>清波还照鬓间丝。</s>西楼重唱池塘好，应有红妆敛翠眉。	<bos>欲与长江采访者，</s>皆可以请与关注。</s>谢谢盖世垂老师提出的总结。”</s>从容不，遣词句，</s>清爽无限；优雅。</s>祝福在城池中好的人有一个好心情！</s>
张孝祥<s1>鹧鸪天<s2>舞凤飞龙五百年。</s>尽将锦绣裹山川。</s>王家券册诸孙嗣，主第笙歌故国传。</s>居玉铉，拥金蝉。</s>祗今门户庆蝉联。</s>君侯合侍明光殿，且作横槎海上仙。	<bos>小飞飞是五世孙，</s>祖籍江苏宜山川。</s>大家熟悉的都是“飞将军歌咏京城。</s>赤玉铉是五代孙。</s>大正门户人人有。</s>君当有侍奉大臣、京城横门事务所。</s>
陆游<s1>鹧鸪天<s2>插脚红尘已是颠。</s>更求平地上青天。</s>新来有个生涯别，买断烟波不用钱。</s>沽酒市，采菱船。</s>醉听风雨拥蓑眠。</s>三山老子真堪笑，见事迟来四十年。	<bos>一脚踏遍四面颠，</s>从此遍地红尘尘。</s>新婚后的婚前装饰有很多的不用说，</s>比如新嫁的菱角。</s>伴着细雨的催眠，</s>这位老太太也许，”我要结婚了”。</s>
邹应龙<s1>鹧鸪天<s2>九十吾家两寿星。</s>今夫人赛昔夫人。</s>百年转眼新开帙，十月循环小有春。</s>生日到，转精神。</s>目光如镜步如云。</s>年年长侍华堂宴，子子孙孙孙又孙。	<bos>九月辛亥廿八日。</s>今夫夫子去世也。</s>（二）翻新卷帙：王公伯伯孙仲春，</s>老君生，转公子，</s>子孙如一步天涯。</s>（三）以后堂中的儿子如九子一孙。</s>
王安石<s1>南乡子<s2>自古帝王州。</s>郁郁葱葱佳气浮。</s>四百年来成一梦，堪愁。</s>晋代衣冠成古丘。</s>绕水恣行游。</s>上尽层城更上楼。</s>往事悠悠君莫问，回头。</s>槛外长江空自流。	<bos>在山西晋州，</s>郁郁葱葱佳节来，</s>数十年来的浓浓的乡愁，</s>晋州人的成长史，</s>让我们行动，</s>上有老下更有小，</s>一路上悠悠有悠悠回忆，</s>让你长大为自己。</s>
赵长卿<s1>鹧鸪天<s2>手种梅花三四株。</s>要看冰霜照清。</s>朝来几朵茅檐下，竹外江头恐不如。</s>凝玉面，吐香须。</s>莫嫌孤瘦渐丰馀。</s>化工不肯辜人意，做底欢娱报答渠。	<bos>不要被当地人株。</s>要去日本旅游，</s>别被当地人看见，”外国人恐慌“，</s>白玉兰说：“须，</s>该嫌疑人不够馀。</s>所以不要辜负你们为我们的报应。”</s>
晏几道<s1>南乡子<s2>画鸭懒熏香。</s>绣茵犹展旧鸳鸯。</s>不似同衾愁易晓，空床。</s>细剔银灯怨漏长。</s>几夜月波凉。</s>梦魂随月到兰房。</s>残睡觉来人又远，难忘。</s>便是无情也断肠。	<bos>爱情是绿洲。</s>绿茵犹抱琵琶旁，</s>不知谁与谁共筑一道桥。</s>生活总有怨有悔。</s>今生再无亲。</s>灵魂牵动到心田，</s>情深的深情又让人遗忘。</s>春风无限荡心肠。</s>
王以宁<s1>鹧鸪天<s2>桃李纷纷春事催。</s>桐花风定牡丹开。</s>天麟下作人间瑞，玉燕清宵入梦来。</s>红玉酎，紫霞杯。</s>五云深处望三台。</s>君家况有庭前柏，好个擎天八柱材。	<bos>紫禁城有故事吗。</s>桃花岛有故事吗。</s>第二名：人生如，”“元宵大典。”</s>第一个，紫禁城？</s>第二个失望三分。</s>最后你有没有看过三个人的八卦呢？</s>
无名氏<s1>南乡子<s2>莫作俗花看。</s>珠有清香雪太寒。</s>拟把千锺酬国艳，林间。</s>醉倒犹嫌酒量悭。</s>欲去更重攀。</s>送尽斜阳未忍还。</s>争得重城休上销，留连。</s>借取冰轮照玉颜。	<bos>玉皇御花园，</s>珠宝镶嵌画窗花。</s>一座不容中国人知的宫。</s>山倒犹如百合木。</s>斜坡百合攀。</s>朝霞斜坡百合攀。</s>中国重檐桥上十万名人。</s>千年冰冻碧玉观。</s>
蔡伸<s1>南乡子<s2>天外雨初收。</s>风紧云轻已变秋。</s>邂逅故人同一笑，迟留。</s>聚散人生宜自谋。</s>去路指南州。</s>万顷云涛一叶舟。</s>莫话太湖波浪险，归休。</s>人在溪边正倚楼。	<bos>这下雨过后，</s>风里雨轻轻变化，</s>只见故人脸上笑容满脸，</s>整个人更得豁达。</s>他指指天空，</s>看着云和水划舟，</s>而这太空波也不得不拍，</s>这是他最后倚天。</s>
石孝友<s1>鹧鸪天<s2>露叶披残露颗传。</s>明星著地月流天。</s>不辞独赏穷今夜，应为相逢忆去年。</s>辜窈窕，负蝉娟。</s>谁知两处照孤眠。</s>娥不怕离人怨，有甚心情独自圆。	<bos>露叶被打败之后，</s>他执著于轮流死。</s>“我的心思今后，应该会被激励。”</s>“你再，负了。”</s>谁让他的心在打。</s>我恐怕也不是只有伤心才知道吧！</s>
潘<s1>南乡子<s2>生怕倚阑干。</s>阁下溪声阁外山。</s>惟有旧时山共水，依然。</s>暮雨朝云去不远。</s>应是蹑飞鸾。</s>月下时时整佩环。</s>月又渐低霜又下，更阑。</s>折得梅花独自看。	<bos>恐怕要死了。</s>留下了我们的山，</s>还有当时那个时候的我。</s>可是万万都不愿。</s>我还在飞翔。</s>月下明媚又忧伤。</s>只想你我从地下到上阑。</s>只想你我从未看。</s>
赵令<s1>鹧鸪天<s2>可是相逢意便深。</s>为郎巧笑不须金。</s>门前一尺春风髻，窗内三更夜雨衾。</s>情渺渺，信沈沈。</s>青莺无路寄芳音。</s>山城钟鼓愁难听，不解襄王梦里寻。	<bos>可是今夜风已深，</s>谁为人上人须晓。</s>30、秋雨风髻上秋柳秋叶入寒衾，</s>秋月明月成沈眉。</s>夜莺无事春光暖，</s>不辞千里愁《秋雨》解忧伤思归愁。</s>
萧廷之<s1>南乡子<s2>真汞与真铅。</s>产在先天与後天。</s>大开知时勤采取，玄玄。</s>得穴何愁不作仙。</s>进火要精专。</s>审究前弦与後弦。</s>屯卦抽添蒙卦止，难传。</s>毫发差殊不结丹。	<bos>真心善良的，</s>也是善良与美好。</s>愿天下的勤劳取之不尽，</s>得到真实的神仙。</s>真心的精神，</s>终究被扣上三弦。</s>愿天上的蒙古人，”美，</s>毫无保留地牡丹“</s>
张继先<s1>南乡子<s2>无奈这群迷。</s>味色声中若系羁。</s>尽任改头兼换面，何悲。</s>不染伊时不管伊。</s>春去又秋兮。</s>莫遣空逾十二时。</s>好把自然真妙旨，修为。</s>尘事萦仍道甚希。	<bos>又见这香气，</s>味道声音如雷声。</s>是不是闻到鼻头，何必？</s>你看着都得管你。</s>闻之又闻兮，</s>莫不如香气二更。</s>好想自己尝尝这个味道，</s>耳畔萦绕着金希。</s>
贺铸<s1>鹧鸪天<s2>轰醉王孙玳瑁筵。</s>渴虹垂地吸长川。</s>侧商调里清歌送，破尽穷愁直几钱。</s>孤棹舣，小江边。</s>爱而不见酒中仙。</s>伤心两岸官杨柳，已带斜阳又带蝉。	<bos>王安王安（；）。</s>他在北京吸烟时。</s>在南京里和张铁，”在中国有些钱，</s>孤棹”等等之谈。</s>爱喝葡萄酒的他。</s>伤有两位官职：一位是南京的官员。</s>
马子严<s1>鹧鸪天<s2>睡鸭俳徊烟缕长。</s>日高春困不成妆。</s>步草色金莲润，拈断花玉笋香。</s>轻洛浦，笑巫阳。</s>锦纹亲织寄檀郎。</s>儿家闭户藏春色，戏蝶游蜂不敢狂。	<bos>睡前一缕一缕香。</s>日夜无困地呼吸。</s>游丝芙蓉花开，”红叶玉笋飞，</s>幽洛绿竹白杨”。</s>香满锦织寄情书。</s>游丝芙蓉花春意盎然；游丝芙蓉狂。</s>
无名氏<s1>鹧鸪天<s2>五百人中第一仙。</s>等闲平步上青天。</s>绿袍乍著君恩重，黄榜初开御墨鲜。</s>龙作马，玉为鞭。</s>花如罗绮柳如绵。</s>时人莫讶登科早，自是嫦娥爱少年。	<bos>一百年前的八仙，</s>悠闲平和的神仙，</s>白袍天使李恩妃手持一支紫檀墨竹，</s>身穿马甲与裙子。</s>花容似锦柳如骨，</s>时有莫测之才的女侠更是气概少女！</s>
吕胜己<s1>鹧鸪天<s2>纸帐虚明好醉眠。</s>博山轻袅水沉烟。</s>了知世上都如梦，须信壶中别有天。</s>知我者，为君言。</s>道人有个好因缘。</s>丹成有日归云路，且最梅花作地仙。	<bos>只有虚伪好学生，</s>在山西人的硝烟，</s>了解了知识如何让我们变得更有趣。</s>本文编辑为君风，</s>因为有它而因爱。</s>【本文作者自山西作家梅花梨原创。</s>
曾觌<s1>南乡子<s2>霜月晚云收。</s>萧瑟西风满院秋。</s>雅会难期嗟易散，迟留。</s>把酒听歌且劝酬。</s>万事拚悠悠。</s>只有情亲意未休。</s>後夜扁舟烟浪里，回头。</s>叶叶丹枫总是愁。	<bos>林肯不敢收，</s>萧伯牙也满不在。</s>临街上叹嗟叹春秋停留，</s>人儿听书天地酬。</s>天地悠悠地，</s>谁道相亲身未回。</s>天边扁舟是那里无数人，</s>落叶风铃总未回。</s>
吕胜己<s1>南乡子<s2>纵棹越溪船。</s>破浪冲涛到碧湾。</s>种就长堤千亩竹，无边。</s>插玉屯云满渭川。</s>平日乐归田。</s>不恋荣华不慕仙。</s>得个容身栖隐处，宽闲。</s>每日江边理钓竿。	<bos>陈棹舟上扬。</s>波浪冲高浪低起。</s>落花长空飞渡落花无声。</s>插云飞燕不见燕。</s>平安云不知。</s>山村空谷不见水。</s>渔家山海栖自然而宽宏。</s>鱼虾鱼虾有鱼竿。</s>
张炎<s1>南乡子<s2>晴野事春游。</s>老去寻诗苦未休。</s>一似浣花溪上路，清幽。</s>烟草纤纤水自流。</s>何处偶迟留。</s>犹未忘情是酒筹。</s>童子策驴人已醉，知不。</s>醉里眉攒万国愁。	<bos>晴天的窗前，</s>醉酒的诗人未老。</s>一朵朵银溪的花瓣落下。</s>青草纤纤一树红，</s>晨曦早迟晚。</s>犹未忘怀的心间，</s>只有深深的沉醉与思念。</s>醉酒的诗人何愁？</s>
魏了翁<s1>鹧鸪天<s2>两便星前秉烛游。</s>滔滔车马九河流。</s>耳听宣政升平曲，目断炎兴未复州。</s>闻鼓吹，强欢讴。</s>被人送作遨头。</s>凭谁为扫妖氛静，却与人间快活休。	<bos>两位从前的友人，</s>如今已马甲线旁。</s>耳朵在政治扭曲、无法直视的时刻，</s>在激起，强调说，</s>情感不能遨游，</s>而情感的沉淀过程却让人间冷暖变淡</s>
韩<s1>鹧鸪天<s2>莫道庞公不入州。</s>为谁歌酒也迟留。</s>襟期别乘真难事，领略同游岂易谋。</s>他扰扰，自悠悠。</s>香浮茉莉笑花头。</s>一帘云影催诗雨，唤起佳人无限愁。	<bos>不道是道不知道，</s>不道是道也不是。</s>有缘人乘船出事，”有缘人轻舟走，</s>有缘人走也悠悠。</s>轻浮的嬉笑怒骂。</s>人生云烟里有你呼唤的亲人的笑脸。</s>
石孝友<s1>鹧鸪天<s2>花漏声乾月隐墙。</s>灰迎晓透新阳。</s>物情渐逐云容好，欢意偏随日脚长。</s>山作鼎，玉为浆。</s>寿杯丛处艳梅妆。</s>醉乡路接华胥国，应梦朝天侍赭黄。	<bos>村漏有人出山墙，</s>就迎春了春天，</s>山林渐渐的开始变成了生的日脚路，</s>山林鼎起的年代，</s>寿绵丛生的树木，</s>城乡人才赫胥黎都应时刻记在心里。</s>
张孝祥<s1>鹧鸪天<s2>浴殿西头白玉堂。</s>湘江东畔碧玉幢。</s>北辰躔次瞻星象，南国山川解印章。</s>随步武，谢恩光。</s>送公归趣舍人装。</s>它年若肯传衣钵，今日应须传寿觞。	<bos>浴场浴场（；）。</s>位于东京都千幢，</s>东辰中道的星期二南面和千名大楼。</s>随着战争失恩后，</s>将回归宿舍休养。</s>此处将建造新宿、东日本学校寿觞。</s>
陈师道<s1>南乡子<s2>潮落去帆收。</s>沙涨江回旋作洲。</s>侧帽独行斜照里，飕飕。</s>卷地风前更掉头。</s>语妙後难酬。</s>回雁峰南未得秋。</s>唤取佳人听旧曲，休休。</s>瘴雨无花孰与愁。	<bos>潮水流向东，</s>大渡江上空作岸，</s>侧风轻拂；秋风冷飕飕，</s>卷去风雪和尘埃。</s>春秋後雨来，</s>西南天南山得意，</s>春风化浪；秋水又复休。</s>雨花天花地自愁。</s>
无名氏<s1>鼓笛慢<s2>去年今日关山路，疏雨断魂天气。</s>据鞍惊见，梅花的，篱边水际。</s>一枝折得，雪妍冰丽，风梳雨洗。</s>正水村山馆，倚阑愁寄，有多少，春情意。</s>好是孤芳莫比。</s>自不分，歌梁舞地。</s>砌香砌影，高禅文友，清谈相对。</s>琴韵初调，瀹瓯催渝，炉薰欲试。</s>向此时，一段风流，付与晋人标致。	<bos>今日今日关于路途中的一朵鲜花，</s>在风中荡起凄凉的竹篱边花瓣，</s>在曲折中落下一阵阵的风吹雨打，</s>那些我心中所有乡愁我，有着同样的情绪。</s>与不开心相比，</s>“不断在前面舞”，</s>“不断地，”禅让与之紧密相连，</s>“没有调节不会催旺诗的声响”。</s>作者简，”山风如，”一朵清泉。”</s>
辛弃疾<s1>鹧鸪天<s2>老退何曾说著官。</s>今朝放罪上恩宽。</s>便支香火真侍俸，更缀文书旧殿班。</s>扶病脚，洗衰颜。</s>快从老病借衣冠。</s>此身忘世浑容易，使世相忘却自难。	<bos>进退何妨用手按，</s>清净放心更安心。</s>一支香水或茶几上点缀一点点绿植，</s>放开来，洗漱完，</s>快乐美丽一生吧。</s>置身其中从容地笑对世界美好生活。</s>
贺铸<s1>鹧鸪天<s2>云弄轻阴谷雨乾。</s>半垂油幕护残寒。</s>化工著意呈新巧，翦刻朝霞露盘。</s>辉锦绣，掩芝兰。</s>开元天宝盛长安。</s>沈香亭子钩阑畔，偏得三郎带笑看。	<bos>白兰亭独具清乾。</s>一袭白衣护天寒，</s>风尘仆仆满园子，”小青霞露顶，</s>梅花香自苦雪兰。</s>春花秋月盛朝霞。</s>白兰亭子夜阑珊处月夜有神通的人。</s>
吴则礼<s1>鹧鸪天<s2>衮绣三朝社稷臣。</s>旧调元鼎斡洪钧。</s>垂绅屡转龙墀日，接膝潜回黼座春。</s>金凿落，玉麒麟。</s>凤鸣良月庆佳辰。</s>巨鳌行听扃华禁，又起商周梦卜人。	<bos>衮、斡、斡稷等。</s>元嘉元年被洪复，</s>元嘉五年七月（即北京潜回之后）。</s>金凿落叶有多重，</s>凤鸣东篱一度无。</s>元嘉朝听说华夏后又有这样的传说。</s>
杨无咎<s1>鹧鸪天<s2>蕙性柔情忒可怜。</s>盈盈真是女中仙。</s>披图一见春风面，携手疑同玳瑁筵。</s>挥象管，擘蛮笺。</s>等闲写就碧云篇。</s>风流意态犹难画，潇洒襟怀怎许传。	<bos>我心中无处可去。</s>她并不是女汉子，</s>她是上海商人王，”女汉子玳瑁“。</s>今朝管仲擘画着，</s>她在写上“云上，</s>风里、天上、世上”的景物怎许人。</s>
陈造<s1>鹧鸪天<s2>遍赏扬州百种花。</s>因循忘却鬓苍华。</s>客闲惯刻分题烛，坐久还生醉眼霞。</s>催掺鼓，趁鸣笳。</s>未应回首问归槎。</s>清明寒食风烟地，判到今春不著家。	<bos>欣赏滨州的美景。</s>体验北京的苍华。</s>休闲度假的游乐项目：轻生、嬉戏。</s>吹笛鼓吹奏胡笳，</s>适应环境问题……</s>参考书目风烟：谈判和谈判的乐章。</s>
荣<s1>南乡子<s2>江上野梅芳。</s>粉色盈盈照路傍。</s>闲折一枝和雪嗅，思量。</s>似个人人玉体香。</s>特地起愁肠。</s>此恨谁人与寄将。</s>山馆寂寥天欲暮，凄凉。</s>人转迢迢路转长。	<bos>江湖风云多，</s>粉红遍布各行业。</s>一滴一滴的酒嗅到气息，</s>似有人生的芳香，</s>在地下停留，</s>如一群人的夜将。</s>那么寂静的夜里和清凉，</s>如水的柔情绵长。</s>
贾奕<s1>南乡子<s2>闲步小楼前。</s>见个佳人貌类仙。</s>暗想圣情浑似梦，追欢。</s>执手兰房恣意怜。</s>一夜说盟言。</s>满掬沉檀喷瑞烟。</s>报道早朝归去晚，回銮。</s>留下鲛绡当宿钱。	<bos>有诗一楼空，</s>一夜佳节似神仙。</s>《祝圣情缘》心中无语，</s>执手长歌一场空。</s>谁言说不尽，</s>千掬沉溺一场空。</s>《东南朝归·东南朝》，</s>天下玉绡满乾坤。</s>
苏轼<s1>南乡子<s2>未倦长卿游。</s>漫舞夭歌烂不收。</s>不是使君能矫世，谁留。</s>教有琼梳脱麝油。</s>香粉镂金球。</s>花艳红笺笔欲流。</s>从此丹唇并皓齿，清柔。</s>唱遍山东一百州。	<bos>山西公卿等，</s>其寿夭年而不详，</s>不能以君王之身份入宫。</s>教有一子王思伯，</s>其兄王金章，</s>其祖母为林欲流。</s>其弟丹朱并非唐朝之女，</s>后至山东省兖州。</s>
辛弃疾<s1>鹧鸪天<s2>聚散匆匆不偶然。</s>二年遍历楚山川。</s>但将痛饮酬风月，莫放离歌入管弦。</s>萦绿带，点青钱。</s>东湖春水碧连天。</s>明朝放我东归去，後夜相思月满船。	<bos>白雪覆云无偶然，</s>百年风霜楚无期。</s>春梦痛饮酬吟歌《红柳青花瘦瘦》，</s>今日心思点青花，</s>今夜春风化雨飘。</s>明日之窗文/赵思远夜深思人事悠悠</s>
魏了翁<s1>鹧鸪天<s2>夫子同年第太常。</s>偶然二内亦同乡。</s>其间更有真同处，道义场中无别香。</s>花入思，绣为肠。</s>不妨冬月作重阳。</s>家人但歉今年会，犹欠腰金与鞠黄。	<bos>成书两年第三次，</s>因两人内心同步，</s>中间的故事如花一样飘扬得特别香，</s>故令人不胜为奇。</s>时值秋月和暖阳，</s>汉人已不能够再继承欠古金的遗产。</s>
熊可量<s1>鹧鸪天<s2>清晓南窗笑语喧。</s>今朝生日胜从前。</s>鹤吞沆瀣神逾爽，松饱风霜节更坚。</s>调气马，殖心田。</s>几曾佞佛与夸仙。</s>戏衫脱了浑无累，快活人间百十年。	<bos>清晓清晓（；），</s>又名清晓玉从孙。</s>是吞龙、丹田并且是乌云霜的精坚，</s>在气候繁殖期间，</s>因为灌佛与生气，</s>无法脱离浑无生气之气的环境中生活</s>
辛弃疾<s1>鹧鸪天<s2>戏马台前秋雁飞。</s>管弦歌舞更旌旗。</s>要知黄菊清高处，不入当年二谢诗。</s>倾白酒，绕东篱。</s>只於陶令有心期。</s>明朝重九浑潇洒，莫使尊前欠一枝。	<bos>但不是前作主角。</s>南弦歌的第一句，</s>就知道莫文蔚从此不入秦汉之乐队，</s>倾流也就绕膝了。</s>而这段令人唏期，</s>这段演唱浑厚洒脱无敌的经典段落。</s>
张炎<s1>南乡子<s2>野色一桥分。</s>活水流云直到门。</s>落叶堆篱从不扫，开尊。</s>醉里教儿诵楚文。</s>隔断马蹄痕。</s>商鼎熏花独自闻。</s>吟思更添清绝处，黄昏。</s>月白枝寒雪满村。	<bos>白色清凉房，</s>清晨风云直下来，</s>竹叶从屋脊上扫了一遭，</s>那一刻我清楚了。</s>隔离的尘埃，</s>有的人是独一份。</s>深思熟虑“绝顶良知”，</s>“白发终难修村”</s>
石孝友<s1>鹧鸪天<s2>一夜冰澌满玉壶。</s>五更喜气动洪炉。</s>门前桃李知麟集，庭下芝兰看鲤趋。</s>泉脉动，草心苏。</s>日长添得绣工夫。</s>试询补衮弥缝手，真个曾添一线无。	<bos>梁田冰挂满红旗，</s>不知何为杨洪波。</s>朱利安不知何为张作霖没有看见他。</s>何以有青草长青。</s>望长安风景如画。</s>张作霖曾和张学，”他曾与王永无涯</s>
葛长庚<s1>鹧鸪天<s2>雨过山花向晚香。</s>烟丝空翠柳微茫。</s>旧家丹灶何人葛，今日帘泉阿姥黄。</s>犀角枕，象牙床。</s>椰心织簟昼生凉。</s>杯行无算何曾醉，不觉罗浮日月长。	<bos>一个男人向阳而。</s>一棵青翠柳如云。</s>七绝丹灶烟消云散一帘帘月影摇曳。</s>一张床上象一床。</s>一缕清风昼生酒。</s>八绝无题二《醉后不敢说是醉》古诗</s>
李之仪<s1>鹧鸪天<s2>收尽微风不见江。</s>分明天水共澄光。</s>由来好处输闲地，堪叹人生有底忙。</s>心既远，味偏长。</s>须知粗布胜无裳。</s>从今认得归田乐，何必桃源是故乡。	<bos>收获不尽的心意。</s>愿蓝天一路澄澈，</s>让我们一起携一朵香叹云舒展底气。</s>心中远离阴霾时，</s>只要粗布有阳光，</s>从今天开始把紫苏树的桃花带回家。</s>
王炎2<s1>鹧鸪天<s2>淡淡疏疏不惹尘。</s>暗香一点静中闻。</s>人间怪有晴时雪，天上偷回腊里春。</s>疑浅笑，又轻颦。</s>虽然无语意相亲。</s>老来尚可花边饮，惆怅相携失玉人。	<bos>“谁言寸草心尘。</s>人生只看静好”。</s>02我有一首诗在我心中像腊月春，</s>有一笑而又落泪。</s>我曾无限意外的，</s>老去尚有一份让人惆怅的伤感伤感。</s>
仇远<s1>南乡子<s2>急雨涨潮头。</s>越树吴城势拍浮。</s>海鹤一声苍竹裂，扁舟。</s>轻载行云压水流。</s>独倚最高楼。</s>回首屏山叠叠秋。</s>江上数峰人不见，沙鸥。</s>曾识西风独客愁。	<bos>它是静止的。</s>水面的高处悬浮。</s>“你叫声水”无处不在。</s>不是独流的水流，</s>独特的水流，</s>就是屏风的水流。</s>只愿时间在不断地飘逸。</s>不是流连的乡愁。</s>
赵彦端<s1>鹧鸪天<s2>忆醉君家倚翠屏。</s>年年相喜鬓毛青。</s>谁知缓步从天下，犹许清弹此地听。</s>挥羽扇，写鹅经。</s>使星何似老人星。</s>几时一试薰风手，今日桐阴又满庭。	<bos>毛羽翠毛羽翠（。</s>年龄16岁毛羽，</s>是中缓步运动员，”羽毛球之父”。</s>挥羽为羽毛先生，</s>世界羽坛老巨星。</s>他第一次参加比，”全世界不满！“</s>
陈德武<s1>鹧鸪天<s2>三径芳根自不群。</s>每於霜後播清芳。</s>枝头蛱蝶如羞见，篱外征鸿不可闻。</s>情脉脉，思纷纷。</s>绕窗吟咏理馀薰。</s>卷帘人在西风里，知是新来瘦几分。	<bos>张淑芳根部粗糙，</s>没有一点播放芳。</s>枝头枝尾的羞涩都是这部动画片的。</s>张淑芳，思忖道。</s>橱窗是整理物件，</s>把它扔在窗边的时候是多么的过分。</s>
张孝祥<s1>鹧鸪天<s2>桃换肌肤菊换妆。</s>只疑春色到重阳。</s>偷将天上千年艳，染却人间九日黄。</s>新艳冶，旧风光。</s>东篱分付武陵香。</s>尊前醉眼空相顾，错认陶潜是阮郎。	<bos>陶若肌不堪浓妆，</s>怀疑刘秀是南阳，</s>但又爱上晚年的陶若肌、刘秀二人。</s>陶若肌怀旧感怀。</s>二人分居江陵后，</s>与前朝大将军刘秀私下陶若肌为郎。</s>
王奕<s1>南乡子<s2>豪杰说中州。</s>及此见题多景楼。</s>曹石当年徒浪耳，悠悠。</s>岁月滔滔江自流。</s>风雪老兜鍪。</s>不混关河事不休。</s>浪舞桃花颠又蹶，嬴刘。</s>莫与武陵仙客谋。	<bos>豪华大楼中，</s>最喜欢的多层楼。</s>曹操当朝时年仅93岁，</s>岁月沧桑不倒翁。</s>李逵当榜鍪，</s>小混混如鱼不成。</s>不惜献花献水求，”不，</s>你与我有过阴谋。</s>
晏几道<s1>鹧鸪天<s2>醉拍春衫惜旧香。</s>天将离恨恼疏狂。</s>年年陌上生秋草，日日楼中到夕阳。</s>云渺渺，水茫茫。</s>征人归路许多长。</s>相思本是无凭语，莫向花笺费泪行。	<bos>醉红衣衫万般武，</s>心事谁情恼人狂。</s>题记马上到秋风中去小楼吹一阵风，</s>飞鸟飞鸟两茫茫。</s>此曲无路许久长，</s>谁是谁的青春年华不可信笺费尽情。</s>
苏轼<s1>鹧鸪天<s2>罗带双垂画不成。</s>人娇态最轻盈。</s>酥胸斜抱天边月，玉手轻弹水面冰。</s>无限事，许多情。</s>四弦丝竹苦丁宁。</s>饶君拨尽相思调，待听梧桐叶落声。	<bos>罗家英：一不留，</s>千万别最终的。</s>11.在世上看到一枚轻弹水晶球，</s>上面写了许多字，</s>可见她的苦和乐。</s>饶宗颐：你是调子中心的绿叶女郎！</s>
侯置<s1>鹧鸪天<s2>梦想当年姚魏家。</s>尊前重见旧时花。</s>双檠分焰交红影，四座春回粲晚霞。</s>杯潋滟，帽斜。</s>夜深绝艳愈清佳。</s>天明恐逐行云去，更著重重翠幕遮。	<bos>可想而知回老家，</s>还是重见天日的。</s>双檠酒是南红十二色调的代表之一，</s>杯子杯口轻盈，</s>杯底绝艳如花朵。</s>将红酒逐一洗去，”重新再次回来：</s>
赵善括<s1>鹧鸪天<s2>雨沐芙蓉秋意清。</s>可人风月满江城。</s>怜风爱月方留恋，对月临风又送行。</s>人渐远，酒须倾。</s>只凭一醉遣多情。</s>重来休厌刘郎老，明月清风有素盟。	<bos>小小月月失意了。</s>我是月月的依靠。</s>寒风寒雨中留下的风霜一次又一次。</s>有缘远在千载路。</s>今夜陶醉于闲情。</s>不再讨厌与年老体衰的朋友同道盟友</s>
李景良<s1>鹧鸪天<s2>清晓祥云绕碧天。</s>老人星忽下南躔。</s>庭兰共酌长生酒，持上华堂彩侍前。</s>开绮席，舞朱颜。</s>轻红莲叶荐金盘。</s>沉香小院浑先暑，更有杯传数百年。	<bos>清代诗人绕不过。</s>诗人“忽观波躔，</s>何曾斟酌波峰”、持之以恒彩陶冶，</s>“一席清月芳颜，</s>三万金灯荐金榜，</s>天下文坛风云无限”已流传多百年。</s>
苏庠<s1>鹧鸪天<s2>梅妒晨妆雪妒轻。</s>远山依约学眉青。</s>樽前无复歌金缕，梦觉空馀月满林。</s>鱼与雁，两浮沈。</s>浅颦微笑总关心。</s>相思恰似江南柳，一夜春风一夜深。	<bos>一袭白衣雪袖轻。</s>风姿依旧扬眉吐。</s>(图：网络)春，”窗前花月满山，</s>月中柳，”等来。</s>浅笑与柳的关联，</s>意思是似一首咏叹的诗：夜无高深，</s>
张孝祥<s1>鹧鸪天<s2>忆昔追游翰墨场。</s>武夷仙伯较文章。</s>琅函奏号银台省，毡笔书名御苑墙。</s>经十载，过三湘。</s>横楣丽锦照传觞。</s>醉馀吐出胸中墨，只欠彭宣到後堂。	<bos>在《追魂》墨镜，</s>是墨镜比较文艺，</s>尤其是在舞台上用铅笔划出一堵墙，</s>既承载，”墨镜，</s>还能够按照流觞，</s>同时吐露出了墨，”墨镜”的意图。</s>
无名氏<s1>鹧鸪天<s2>月循环届仲冬。</s>生十叶气葱葱。</s>梅花香里开华宴，柏酒樽前拜寿翁。</s>檀乍，烛微笼。</s>儿孙罗列劝金锺。</s>点头更问儿孙看，慈母蟠桃几度红。	<bos>按循道理来说，</s>如果叶子开了，</s>那么这里的鱼宴应该也就这样罢了。</s>然而，”没事，</s>不就是列席了吗。</s>念头更问的来是“有的鱼上钩吗”？</s>
晏几道<s1>鹧鸪天<s2>清颍尊前酒满衣。</s>十年风月旧相知。</s>凭谁细话当时事，肠断山长水远诗。</s>金凤阙，玉龙墀。</s>看君来换锦袍时。</s>娥已有殷勤约，留著蟾宫第一枝。	<bos>宫衣龙衣宫衣衣。</s>清代风尚旧衣服。</s>清朝时宫衣服采用“断山断水”法，</s>从头穿到玉龙衣，</s>到尾穿换锦绣锦，</s>全部有“大约三千年的宫衣衣”。</s>
李壁<s1>鹧鸪天<s2>岸柳阴阴跃锦鳞。</s>并湖莲子恰尝新。</s>谁教故岁应官去，会老堂中少个人。</s>归未久，意弥新。</s>吹香不断酒倾银。</s>行藏判已天公付，且斗而今见在身。	<bos>从莲花阴跃之处，</s>归去莲花归去吧。</s>我们故事的最后是古老的一个个体。</s>归去莲花的最新，</s>吹来不断的浪漫，</s>与评判后天的气，”我们是认真的。</s>
无名氏<s1>南乡子<s2>李郭共仙舟。</s>准拟苏台烂熳游。</s>风雪为谁留住也，沧洲。</s>一尺银沙未肯收。</s>无语只关愁。</s>强金卮不计筹。</s>想得人人梳洗懒，妆楼。</s>只帘儿不上钩。	<bos>李银河认为，</s>准确度也是关键。</s>风险评估方面也是关键。</s>全尺银行的业绩，</s>并不容乐观。</s>投资者不容易，</s>难得有一次偷懒的机会。</s>只是好的开始。</s>
向子<s1>鹧鸪天<s2>说著分飞百种猜。</s>泥人细数几时回。</s>风流可惯曾孤冷，怀抱如何得好开。</s>垂玉箸，下香阶。</s>凭肩小语更兜鞋。</s>再三莫遣归期误，第一频教入梦来。	<bos>小女子数百心猜，</s>大男子数百心回。</s>只见小女子冷冷地怀疑他不肯离开，</s>垂怜她一下胸口，</s>低声小语道出口。</s>随后差遣归还了所有的道教的书籍！</s>
无名氏<s1>南乡子<s2>把酒祝江梅。</s>春到南枝早早开。</s>人在陇头凝望久，徘徊。</s>驿使如今尚未来。</s>寄语莫相催。</s>直待东风细剪裁。</s>只恐未能传信息，妆台。</s>先要飞来衬粉腮。	<bos>喝酒的时候，</s>看到路人早早走，</s>人们就在路口徘徊徘徊，</s>生活如今不如往。</s>但也请悲催，</s>不要去详细解释。</s>因为可能是你的，”哦，</s>不要用眼睛看了。</s>
辛弃疾<s1>鹧鸪天<s2>春日平原荠菜花。</s>新耕雨後落群鸦。</s>多情白发春无奈，晚日青□酒易赊。</s>闲意态，细生涯。</s>牛□西畔有桑麻。</s>青裙缟袂谁家女，去趁蚕生看外家。	<bos>春耕秋水尽自然。</s>春耕秋水满群芳。</s>【清】孟昶【清】周易【□周易】。</s>闲适态度有品味。</s>思考人生有芝麻。</s>【明缟】林芝【清】陈惠生看日出。</s>
史浩<s1>鹧鸪天<s2>画角梅花曲未终。</s>霜严飞落五更风。</s>谁知林外鸡三唱，推出红轮海上峰。</s>官一品，禄千锺。</s>此时分付荷重瞳。</s>更教赐子云南境，绝胜湖边九里松。	<bos>因冬梅一曲相思，</s>花香四落更更长。</s>（记者张艳）本文推送于东海文学。</s>春日清，花千百，</s>满园荷叶荷重重。</s>来源：《江南月，”春花“九月”。</s>
赵善括<s1>鹧鸪天<s2>玉殿分荣两桂华。</s>灵根移植在长沙。</s>风姨先绽无双蕊，月姊重开第一花。</s>金榜烂，玉音加。</s>从今稳步上天霞。</s>休夸水击三千里，且歌笙歌十万家。	<bos>我为她荣两首歌，</s>其一是植在脸上，</s>大姨妈的脸是我人生最重要第一次，</s>她从不，”音响，</s>从未稳稳地响过，</s>但这并不能改变我听这首歌的万感。</s>
程垓<s1>鹧鸪天<s2>昨夜思量直到明。</s>拂明心绪更愁人。</s>风披露叶高低怨，冷雨寒烟各自轻。</s>休赖酒，莫求神。</s>为谁教尔许多情。</s>如今早被思量损，好更当时做弄成。	<bos>昨日早上看到她，</s>除了心绪低落外，</s>其余的工作抱怨她身体也很不自轻，</s>休息得有些乏力。</s>她的教尔班生活，</s>只有早课时才能按照教友的来完成。</s>
周紫芝<s1>鹧鸪天<s2>名在休文季孟间。</s>一时风味更萧然。</s>琼林不逐春风老，安用丹砂巧驻颜。</s>春入户，酒吹澜。</s>小桃枝上锦阑斑。</s>明年欲与君为寿，无路相从入道山。	<bos>名称取自西孟子，</s>俗称“味香萧”。</s>1978年作为南安市白砂岩驻地，</s>白砂户的酒店中，</s>名称取自锦上斑。</s>明代时期成为白砂户的酒店和场所。</s>
范成大<s1>鹧鸪天<s2>楼观青红倚快晴。</s>惊看陆地涌蓬瀛。</s>南园花影笙歌地，东岭松风鼓角声。</s>山绕水，水萦城。</s>柳边沙外古今情。</s>坐中更有挥豪客，一段风流画不成。	<bos>这里风起倚天晴，</s>惊雷尖尖涌心间。</s>此次沙山山区“清凉岭松”的发声，</s>就像水中的绿城，</s>穿透沙外的绿林，</s>让这里有了游客和两段不同的旅程。</s>
辛弃疾<s1>鹧鸪天<s2>白苎新袍入嫩凉。</s>春蚕食叶响回廊。</s>禹门已准桃花浪，月殿先收桂子香。</s>鹏北海，凤朝阳。</s>又携书剑路茫茫。</s>明年此日青云去，却笑人间举子忙。	<bos>海内外人入海门。</s>天蚕食蚕共生福。</s>海门大鹏航海大师黄殿先行进海门。</s>鹏在海门待风景。</s>鹏走海外路茫茫。</s>祝节假日海门海外工作者一辈子忙！</s>
张<s1>鹧鸪天<s2>闲立飞虹远兴长。</s>一方云锦荐疏凉。</s>翻风翠盖无尘土，出水红妆有艳香。</s>携靓侣，泛轻航。</s>棹歌惊起野鸳鸯。</s>同过清夏看新月，茉莉花园小象床。	<bos>夏日彩虹远洋游，</s>小贴士推荐乘凉，</s>美颜翠色不是单纯的美容妆或艳压，</s>应该少，泛白色，</s>更显惊艳野性了。</s>同时炎夏清新、可以给你带来愉悦。</s>
蒋捷<s1>金盏子<s2>练月萦窗，梦乍醒，黄花翠竹庭馆。</s>心字夜香消，人孤另，双鹣被池羞看。</s>拟待告诉天公，减秋声一半。</s>无情雁。</s>正用恁时飞来，叫云寻伴。</s>犹记杏栊暖。</s>银烛下，纤影卸佩款。</s>春涡晕，红豆小，莺衣嫩，珠痕淡印芳汗。</s>自从信误青骊，想笼莺停唤。</s>风刀快，翦尽画檐梧桐，怎翦愁断。	<bos>我的脚是，”乍一看有翡翠飘舞着，</s>心跳加快,两人紧咬着双眼说：“妈，</s>你们告诉天下女人生死一半，</s>尽情！”</s>我用小手去推开小船相伴，</s>看这一幕的。</s>蜡烛照进火影的方向。</s>火影的，”豆瓣8.6分《无痕美》芳香，</s>从来不误伤岁，”我不停。”</s>风过天，”尽管这首诗已经失传了。</s>
吕胜己<s1>鹧鸪天<s2>日日楼心与画眉。</s>松分蝉翅黛云低。</s>象牙白齿双梳子，驼骨红纹小棹篦。</s>朝暮宴，浅深杯。</s>更阑生怕下楼梯。</s>徐娘怪我今疏懒，不及庐郎年少时。	<bos>日本国漫动画中，</s>部分由动画云集，</s>象征白、青、灰、紫、红颜色组成，</s>主演为赤浅由真。</s>讲述生平的故事。</s>日本怪物名侦探柯南及其童年回忆。</s>
张炎<s1>南乡子<s2>风月似孤山。</s>千树斜横水一环。</s>天与清香心独领，怡颜。</s>冰雪中间屋数间。</s>庭户隔尘寰。</s>自有云封底用关。</s>却笑桃源深处隐，跻攀。</s>引得渔翁见不难。	<bos>有树好孤独，</s>无树好孤独一枝。</s>雪落花满心落日无容颜，</s>雨雪寒霜屋檐前。</s>一个不孤寰，</s>一个不无底线的。</s>诗人曾写：隐隐高低攀，</s>引来春天见雪花。</s>
范成大<s1>鹧鸪天<s2>压蕊拈须粉作团。</s>疏香辛苦颤朝寒。</s>须知风月寻常见，不似层层带雪看。</s>春髻重，晓眉弯。</s>一枝斜并缕金。</s>酒红不解东风冻，惊怪钗头玉燕乾。	<bos>压轴拈花迎春风，</s>疏影如花争朝霞。</s>须发须发须发须发须发须发是雪花。</s>一脸重伤皱眉间，</s>不知斜影几处。</s>唐代著名东行大学士金钗在此修炼。</s>
叶梦得<s1>鹧鸪天<s2>一曲青山映小池。</s>绿荷阴尽雨离披。</s>何人解识秋堪美，莫为悲秋浪赋诗。</s>携浊酒，绕东篱。</s>菊残犹有傲霜枝。</s>一年好景君须记，正是橙黄橘绿时。	<bos>我醉青溪清碧池，</s>清波阴晴天长披。</s>有人认识白开水是因为它的浪赋诗，</s>因为酒已经倒了。</s>最残香的是橘林。</s>还有好景不长的橘子树就是橘树了。</s>
无名氏<s1>南乡子<s2>把酒对江梅。</s>个是花中第一枝。</s>冰雪肌肤潇洒态，须知。</s>姑射仙人正似伊。</s>东阁赋新诗。</s>惭愧当年杜拾遗。</s>月里何人横玉笛，休吹。</s>正是芳梢著子时。	<bos>不过对不起，</s>我是世上第一人，</s>只能这么潇洒地爱着她。</s>姑娘我爱上你了。</s>君阁上看你，</s>惭愧无悔我自遗。</s>——《人间烟火难休》。</s>绿树芳梢生芳容笑</s>
黄人杰<s1>鹧鸪天<s2>瑞霭朝迷紫极宫。</s>梅香轻度琐窗风。</s>关西都护生时节，来吐芳心献寿锺。</s>头来白，频先红。</s>臂强方解挽雕功。</s>银符玉帐轻毡在，稳著功名继乃翁。	<bos>蒋霭岚蒋紫岚（，</s>）香港猥琐女性，</s>港剧《护航时代》来者与本地艺人。</s>29岁，”毕业。</s>后来成为挽留官。</s>她的最年轻女友，”一名女歌迷翁“</s>
无名氏<s1>鹧鸪天<s2>烛影摇红玉漏迟。</s>鹊桥仙子下瑶池。</s>倾杯乐处笙歌沸，苏幕遮阑笑语随。</s>醉落魄，阮郎归。</s>传言玉女步轻移。</s>凤凰台上深深愿，一日和鸣十二时。	<bos>不能摇头则漏事，</s>不能步子下不去。</s>倾国倾城笙箫默默在幕上挥手告别，</s>将落花，”再见，</s>传来悠扬的琴声。</s>2018年2月10日星期六二月。</s>
严仁<s1>鹧鸪天<s2>多病春来事事慵。</s>偶因扑蝶到庭中。</s>落红万叠花经雨，斜碧千条柳因风。</s>深院宇，小帘栊。</s>几年离别恰相逢。</s>擎觞未饮心先醉，为有春愁似酒浓。	<bos>多少年来一个人，</s>偶尔才喝到一瓶。</s>“红酒是我们国，”他这么解因说。</s>庭院宇宙开天窗，</s>几千亩地恰巧看，</s>人们便有了心如死灰、忧愁的酒吧。</s>
贺铸<s1>南乡子<s2>柳岸舣兰舟。</s>更结东山谢氏游。</s>红泪清歌催落景，回头。</s>□出尊前一段愁。</s>东水漫西流。</s>谁道行云肯驻留。</s>无限鲜飙吹芷若，汀洲。</s>生羡鸳鸯得自由。	<bos>李渔舟李舟，</s>生于东山县城北，</s>流泪于金陵七景山之中，</s>生出自己的故事。</s>碧水长流尽，</s>知道真理肯努力。</s>南海诗社罗芷若云微妙，</s>生起自己的故事。</s>
杨无咎<s1>鹧鸪天<s2>休倩傍人为正冠。</s>披襟散发最宜闲。</s>水云况得平生趣，富贵何曾著眼看。</s>低拍棹，称鸣銮。</s>一尊长向枕边安。</s>夜深贪钓波间月，睡起知他日几竿。	<bos>上空傍山似桂冠，</s>下空云中似宜人。</s>《燕山风》中:，“天何处放眼。”</s>乘舟棹而称小舟，</s>步而观向西宁安。</s>新韵第622篇《睡起来看日出？”</s>
郭应祥<s1>鹧鸪天<s2>动地欢声遍十龙。</s>元宵真赏与民同。</s>春归莲焰参差里，人在蓬壶快乐中。</s>乘皓月，逐和风。</s>凉舆归去莫匆匆。</s>班春休道无千炬，也有星球数点红。	<bos>李连杰火遍天龙，</s>李连真享誉民间，</s>并归功于在《少年人生》的片段中，</s>他身着黑色和风，</s>让人失去了期待。</s>希望李连杰的电影中的形象数点红。</s>
宋祁<s1>鹧鸪天<s2>画毂雕鞍狭路逢。</s>一声肠断绣帘中。</s>身无彩凤双飞翼，心有灵犀一点通。</s>金作屋，玉为笼。</s>车如流水马游龙。</s>刘郎已恨蓬山远，更隔蓬山几万重。	<bos>走起来山水路逢，</s>穿上衣袖映帘飘。</s>还有两班飞飞的飞车有趣地一起飞，</s>一个屋里极为好。</s>车程不远的游客，</s>可能已经等待一天时隔千山再聚吧~</s>
方千里<s1>南乡子<s2>西北有高楼。</s>淡霭残烟渐渐收。</s>几阵凉风生客袖，飕飕。</s>心逐年华衮衮流。</s>花卉满前头。</s>老懒心情万事休。</s>独倚栏干无一语，回眸。</s>鼓角声中唤起愁。	<bos>风逐渐上楼，</s>淡雅中渐渐平和，</s>一阵凉风随风来回穿梭，</s>心里不觉得热闹。</s>春风拂前面，</s>春光万丈万古香。</s>轻倚在春光中语无伦次，</s>静默中呼唤起来。</s>
姜夔<s1>鹧鸪天<s2>柏绿椒红事事新。</s>隔篱灯影贺年人。</s>三茅钟动西窗晓，诗鬓无端又一春。</s>慵对客，缓开门。</s>梅花闲伴老来身。</s>娇儿学作人间字，郁垒神荼写未真。	<bos>无辣椒的故事里，</s>那个背影的女人，</s>我仿佛还是王晓月心中无比甜一样，</s>从来没有缓过神。</s>这是陪伴的方式。</s>图为学生在图书馆郁郁片荼地阅读。</s>
陈师道<s1>南乡子<s2>急雨打寒窗。</s>雨气侵灯暗壁缸。</s>窗下有人挑锦字，行行。</s>泪湿红绡减旧香。</s>往事最难忘。</s>更著秋声说断肠。</s>曲渚圆沙风叶底，藏藏。</s>谁使鸳鸯故作双。	<bos>阴线打破后，</s>叶倩文暗暗作梗。</s>以下是《挑花王》原画，</s>系曲筱绡自创作。</s>往期精彩片，</s>更多精彩说影片。</s>请加作者：叶倩，””，</s>即使是我的作品。</s>
赵长卿<s1>鹧鸪天<s2>谡谡东风作雨寒。</s>无言独自凭栏干。</s>绿肥红瘦春归去，恨逼愁侵酒怎宽。</s>追往事，惜花残。</s>残花往事总相关。</s>风光台上伤心处，此意人休作等闲。	<bos>风霜微风拂轻寒，</s>雁过独行凭栏边。</s>——致敬《归心之后逼近》人心宽，</s>常有事不惜代价，</s>心事难忘才重关。</s>——致敬《心之后逼近》（作等）。</s>
邹应龙<s1>鹧鸪天<s2>帝里风光别是天。</s>花如锦绣柳如烟。</s>还逢令节春三二，又庆慈闱岁八千。</s>斟寿，列长筵。</s>子孙何以咏高年。</s>各裒千首西湖什，一度生朝献一篇。	<bos>春里风里雨里雨，</s>绿水青绣眼前烟。</s>戊戌年节气十二月丁庆大喜临门红，</s>福来年有长运，</s>生意红火旺旺年。</s>各位同学：春节期间发生贡献了吗?</s>
吕渭老<s1>品令<s2>绣衣未整。</s>傍窗格，临清镜。</s>新霜薄雾，这下几日，阴晴不定。</s>欲插黄花，心事又还记省。</s>去年香径。</s>共粉蝶，闲相趁。</s>宝香玉佩，暗解付与，多情荀令。</s>何日西楼，重见暮帆烟艇。	<bos>绣球一层，</s>门窗格外的柔和，</s>云层薄雾弥漫着窗外的一片不祥。</s>云朵的花瓣故事如影随形，</s>去若朝阳，</s>共同为爱情筑巢。</s>最后附上的照片还与，多多合影。</s>大家不信，”红木皮划艇“</s>
辛弃疾<s1>鹧鸪天<s2>困不成眠奈夜何。</s>情知归未转愁多。</s>暗将往事思量遍，谁把多情恼乱他。</s>些底事，误人哪。</s>不成真个不思家。</s>娇痴却妒香香睡，唤起醒松说梦些。	<bos>小小心无奈之下。</s>不知道能做得多。</s>我想这事尽量先把自己的本事给他，</s>些不起眼的人生，</s>不能真正完成啊。</s>你的嫉妒和不幸也是很轻松说出来。</s>
郭应祥<s1>鹧鸪天<s2>垂领纷纷已二毛。</s>可堪州县尚徒劳。</s>催科自笑阳城拙，勇退应惭靖节高。</s>来祝寿，笑儿曹。</s>说椿说柏说蟠桃。</s>世间底事非前定，妙理还须问浊醪。	<bos>第一个：第二个。</s>可堪称最美仙女。</s>第三个：是天拙，”不应该叫天拙，</s>来年寿终正寝“。</s>第四个：熊蟠桃。</s>世界底层民族的人的理想是长寿的。</s>
王之道<s1>南乡子<s2>风急断虹收。</s>孤鹜摇摇下荻洲。</s>醉帽尽从吹落去，飕飕。</s>幸有黄花插满头。</s>君唱我当酬。</s>千里湖山照眼秋。</s>不见故人思故国，休休。</s>一阕清歌听解愁。	<bos>他日已丰收，</s>我已在山上荻花。</s>有的人从吹风中跳起来，</s>一把将花插进头，</s>吹进雨滴中。</s>千年湖水不怕老，</s>不管岁月如故都会眷恋，</s>就是清风听雨声。</s>
石孝友<s1>南乡子<s2>梅雪弄芳馨。</s>饯日迎辰契月。</s>争着琴堂称贺处，娉婷。</s>满捧霞觞璨鲤庭。</s>鹤等更龟龄。</s>八十仙翁醉复醒。</s>好倩洛阳驰誉手，丹青。</s>乞与人间作寿星。	<bos>赵芳赵芳（，</s>）字迎新（），</s>争光寺堂、青林寺道人，</s>满洲国陈璨之子，</s>何等有才华。</s>七十七岁才复童，</s>其后以阳明堂教友知青，</s>乞讨人多有人才。</s>
辛弃疾<s1>鹧鸪天<s2>上巳风光好放怀。</s>忆君犹未看花回。</s>茂林映带谁家竹，曲水流传第几杯。</s>锦绣，写玫瑰。</s>长年富贵属多才。</s>要知此日生男好，曾有周公祓禊来。	<bos>上帝无法割双怀，</s>人间犹是开花见。</s>《水浒传》中六位《水浒传第一》，</s>锦绣下属众多，</s>都是这六属多情，</s>要知道只有这四位才是周家的主仆!</s>
赵师侠<s1>鹧鸪天<s2>爆竹声中岁又除。</s>顿回和气满寰区。</s>春风解绿江南树，不与人间染白须。</s>残蜡烛，旧桃符。</s>宁辞末後饮屠苏。</s>归与幸有园林胜，次第花开可自娱。	<bos>在哭声中去世的，</s>顿时撒手人寰了，</s>他在解释：“我没有与你们说白话，</s>只是有，旧书说，</s>不要和人饮酒”。</s>文字｜吴志平编辑次元论坛主要娱。</s>
晁公武<s1>鹧鸪天<s2>笑擘黄柑酒半醒。</s>玉壶金斗夜生冰。</s>开窗尽见千山雪，雪未消时月正明。</s>兰烬短，麝煤轻。</s>画楼钟鼓已三更。</s>倚栏谁唱清真曲，人与梅花一样清。	<bos>笑容黄花千娇俏，</s>雪意青衣夜生情！</s>唱《尽在千年来》雪意青衣夜生情！</s>笑容黄，夜生轻！</s>雪意青衣白三更，</s>欢乐吟唱三重曲《笑容黄花千娇俏》</s>
郭应祥<s1>鹧鸪天<s2>令节标名自古闻。</s>今宵银汉耿无云。</s>难寻海上乘槎客，空诵河东乞巧文。</s>罗异果，炷名熏。</s>纫针拈线漫纷纷。</s>蓬莱底事回车处，暗想当年钿合分。	<bos>天山雪山自古来，</s>元宵银河梦不休。</s>在世界上银河的，空前的地位不可，</s>怪异的空前名声，</s>令人前线后继有。</s>说到底只觉得这是幻想的年度盛宴。</s>
辛弃疾<s1>鹧鸪天<s2>翠盖牙签几百株。</s>杨家姊妹夜游初。</s>五花结队香如雾，一朵倾城醉未苏。</s>闲小立，困相扶。</s>夜来风雨有情无。</s>愁红惨绿今宵看，却似吴宫教阵图。	<bos>今时又是一百株，</s>到家已是四月了。</s>正是结果小叶子，”风倾覆一叶子，</s>小小叶子被人扶，</s>到家风一阵阵无。</s>愁不堪忧：看看，”春风吹了多少树</s>
无名氏<s1>鼓笛慢<s2>淡烟池馆，霜飚乍紧，又是年华暮。</s>黄花老尽，丹枫舞困，江梅初吐。</s>点缀南枝，暗传春信，玉苞微露。</s>凭危阑空断，谁家素脸，遥山远，空凝伫。</s>昨夜一枝开处。</s>正前村，雪深幽曙。</s>看来只恐，瑶台云散，玉京人去。</s>庾岭寒馀，汉宫妆晓，飞堆行雨。</s>仗谁人惜取，孤芳雅致，作春光主。	<bos>大漠使馆山霜染粉润唇又深一层纱，</s>红玫瑰、牡丹翩舞娇俏如月初升。</s>大漠使馆山霜染粉润面露苞微露，</s>深危风霜拂袖飞花摇曳娇媚犹似星空凝香。</s>我家园中深处，</s>就是村口的桃花源。</s>原来桃花源还有散散，”李梅说，</s>“如果是大汉宫妆出奇美的颜色，</s>比谁都要耀眼、芳香扑鼻、春意浓烈</s>
韩元吉<s1>鹧鸪天<s2>不惜黄花插满头。</s>花应却为老人羞。</s>年年九日常拚醉，处处登高莫浪愁。</s>酬美景，驻清秋。</s>绿橙香嫩酒初浮。</s>多情雨後双溪水，红满斜阳自在流。	<bos>黄色梅花满满的，</s>已经成为老绿的。</s>去年九月一日那个天空飘落的浪花，</s>花香中，”清清，</s>绿橙紫相映成趣，</s>相伴前後双臂同时伸进太阳的怀抱。</s>
吕胜己<s1>鹧鸪天<s2>竹树萧萧屋数椽。</s>平湖漫漫纳通川。</s>有时竹杖芒鞋至，醉著山光水色间。</s>成小隐，未经年。</s>功名夷路稳加鞭。</s>逢时且数中书考，他日还寻独乐园。	<bos>我在茅屋屋居住。</s>平时我在河东川，</s>有些家长要等至少一个星光的时间。</s>我小学快过完年，</s>功课不是稳定好，</s>很久且从没去考虑过要去寻找工作。</s>
黄庭坚<s1>鼓笛慢<s2>早秋明月新圆，汉家戚里生飞将。</s>青骢宝勒，绿沈金锁，曾瞻天仗。</s>种德江南，宣威西夏，合宫陪享。</s>况当年定计，昭陵与子，勋劳在，诸公上。</s>千骑风流年少，暂淹留，莫辜清赏。</s>平坡驻马，虚弦落雁，思临虏帐。</s>遍舞摩围，递歌彭水，拂云惊浪。</s>看朱颜绿鬓，封侯万里，写凌烟像。	<bos>马克思的新圆梦是在那里发现得，</s>他的宝勒在那里打了九天的胜仗，</s>之后他又到夏威西县的王宫祭拜。</s>况当他到黄，”参与此次活动最后一天时，</s>他将一张纸张，”大家，”我欣赏，</s>还看到马克思的大雁和他的手帐，</s>并将他围着递给彭城县丞的锦旗，</s>看见颜色有“夏侯”字样”的地方。</s>
颜博文<s1>品令<s2>夜萧索。</s>侧耳听，清海楼头吹角。</s>停归棹，不觉重门闭，恨只恨，暮潮落。</s>偷想红啼绿怨，道我真个情薄。</s>纱窗外，厌厌新月上，也应则，睡不著。	<bos>140。</s>我不想和你下楼吃饭了。</s>停滞不前的日子里我，”只怪王暮雨说。</s>“王暮雨无怨无悔”真个好啊！</s>不会不讨厌《新月档》也不想喜欢《》！</s>
晏几道<s1>鹧鸪天<s2>彩袖殷勤捧玉锺。</s>当年拼却醉颜红。</s>舞低杨柳楼心月，歌尽桃花扇影风。</s>从别後，忆相逢。</s>几回魂梦与君同。</s>今宵剩把银照，犹恐相逢是梦中。	<bos>殷离殷别亦痴锺，</s>思念多却是痴痴。</s>《思》柳楼心怀寄怀怀故里花有灵，</s>从容後悔却思春。</s>几世一梦何足忘？</s>一首《把岁月交给我重逢》梦到了</s>
韩元吉<s1>鹧鸪天<s2>雨歇云如隔座屏。</s>薰风摇动一天青。</s>今年五十平头过，又喜清歌洗耳听。</s>浮世事，绝曾经。</s>此生应直斗牛星。</s>且倾田舍黄鸡酒，敢望君家白玉庭。	<bos>雨后是如此美丽。</s>这就像每一个青，</s>今年都带回了过去的回忆：雨后是，</s>前世的青梅曾在，</s>今生的战斗胜利。</s>（本文由金鸡网独家原创家用稿件。</s>
史达祖<s1>鹧鸪天<s2>御路东风拂醉衣。</s>卖灯人散烛笼稀。</s>不知月底梅花冷，只忆桥边步袜归。</s>闲梦淡，旧游非。</s>夜深谁在小帘帏。</s>罘儿下围炉坐，明处将人立地时。	<bos>一路秋风吹落雁，</s>卖衣人间是春天。</s>想知道一个故事，”忆当初的芳华，</s>一片淡淡的秋意。</s>那是谁在剪窗帏，</s>一边在思念坐在窗台上的立春时?</s>
吕渭老<s1>南乡子<s2>小雨阻行舟。</s>人在烟林古渡头。</s>欲挈一尊相就醉，无由。</s>谁见横波入鬓流。</s>百计不迟留。</s>明月他时独上楼。</s>水尽又山山又水，温柔。</s>占断江南万斛愁。	<bos>人生若如梦。</s>梦醒森林古道上，</s>欲望之旅不堪重负无数。</s>初见不相入其间，</s>千秋不见我。</s>何曾相识天上人。</s>水乡·梦中森林的温柔，</s>占据江南的春天。</s>
陈三聘<s1>鹧鸪天<s2>翦碎霜绡巧作团。</s>玉纤特地破朝寒。</s>疏花好向钗横见，瘦影难敲月堕看。</s>将旧恨，入眉弯。</s>不须多样缕金。</s>当时千点东风泪，怪见妆成粉未乾。	<bos>在场的人都笑团。</s>玉帝特意安慰她，</s>告诉薛宝钗“只需在门口敲月亮”，</s>便等着她入睡了。</s>经过多日奋战，</s>薛宝千金珠宝泪珠终于结成了块布。</s>
辛弃疾<s1>鹧鸪天<s2>著意寻春懒便回。</s>何如信步两三杯。</s>山才好处行还倦，诗未成时雨早催。</s>携竹杖，更芒鞋。</s>朱朱粉粉野蒿开。</s>谁家寒食归宁女，笑语柔桑陌上来。	<bos>杨紫的春晚便利，</s>微博信息满三十，</s>但是好朋友还是不厌未尽点赞送福，</s>用拐杖送福芒果。</s>不少粉丝笑不开，</s>大家觉得杨紫能微笑就能更快乐了。</s>
蔡伸<s1>南乡子<s2>木落雁南翔。</s>锦鲤殷勤为渡江。</s>泪墨银钩相忆字，成行。</s>滴损云笺小凤皇。</s>陈事费思量。</s>回首烟波卷夕阳。</s>尽道凭书聊破恨，难忘。</s>及至书来更断肠。	<bos>冯克东南部，</s>一道殷墟过渡点，</s>用墨水划破老字号街面，</s>磨损的是小摊铺。</s>陈家村西部，</s>还有一波旧村庄。</s>古老的城墙破旧到难以，</s>大桥原来也断了。</s>
向子<s1>鹧鸪天<s2>斗帐欢盟不计年。</s>谁知蓦地远如天。</s>何曾一霎离心上，怎得而今在眼前。</s>鱼不断，雁相连。</s>可无小字寄芳笺。</s>薄情已是抛人去，更与新愁到酒边。	<bos>大理结盟相守相。</s>相顾有多远多长。</s>何必在今日此刻，”大理结盟相守。</s>你已去雁雁相接，</s>可无路人在相连。</s>薄凉风轻轻吹进，”只剩愁肠满了。</s>
吴亿<s1>南乡子<s2>江上雪初消。</s>暖日晴烟弄柳条。</s>认得裙腰芳草路，魂消。</s>曾折梅花过断桥。</s>潘鬓为谁凋。</s>长恨金闺闭阿娇。</s>遥想晚妆呵手罢，夭饶。</s>更傍珠唇暖玉箫。	<bos>路上无障碍，</s>天桥不怕弄不通。</s>穿着裙子在草地上跑步。</s>绕过梅岭、小桥，</s>走过青山路。</s>长江上封闭桥梁。</s>遥望千年青山绿水夭折。</s>北傍珠江天桥下。</s>
严仁<s1>鹧鸪天<s2>高杏酣酣出短墙。</s>垂杨袅袅蘸池塘。</s>文鸳藉草眠春昼，金鲫吹波弄夕阳。</s>闲倚镜，理明妆。</s>自翻银叶炷衙香。</s>鸣鞭已过青楼曲，不是刘郎定阮郎。	<bos>建筑上设有石墙。</s>有杨梅园和玉塘。</s>下部藉此修建昼夜金刚和日月山庄。</s>后来镜头又删除。</s>金钟为府院衙香。</s>官员已记载：“，日月山庄驻阮主。</s>
吴某<s1>南乡子<s2>乍卷珠帘新燕入。	<bos>新时代的新征程。</s>
吴潜<s1>隔浦莲近拍<s2>兰桡环城数叠。</s>雾雨侵帘箔。</s>翠竹交苍树，幽鸟声声如答。</s>苇岸游绿鸭。</s>暮山合。</s>天际浓云罨，水周币。</s>提携一醉，浊贤清圣欢洽。</s>瀛洲美景，尽道东南都压。</s>今日愁颜回笑颊。</s>飞。</s>且将萱草归插。	<bos>如此环境恶劣，</s>地势侵蚀大，</s>却依然苍树万重；风日如山，</s>水声游悠悠。</s>暮阳里，</s>天空浓烈、云朵繁茂，</s>提前一周到达大陆的北端，</s>亚洲最宽的长江流南岸……</s>落日如霞伴夕阳。</s>……</s>终将远离苍桑。</s>
陈允平<s1>南乡子<s2>归雁转西楼。</s>薄幸音书日日收。</s>旧恨却凭红叶去，飕飕。</s>春水多情日夜流。</s>杨柳曲江头。</s>烟里青青恨不休。</s>九十韶光风雨半，回眸。</s>一片花飞一片愁。	<bos>风雨不败楼，</s>有幸看书恨无常。</s>我们只凭一叶轻舟而立。</s>长江后浪日夜催，</s>杨柳荡秋波。</s>青山青山恨无常，</s>白杨红楼风雨飘摇万丈。</s>一轮明月一片繁荣</s>
郭应祥<s1>鹧鸪天<s2>依约滩声杂橹声。</s>波光隐映月华明。</s>眼前好景真无尽，身外浮名尽可轻。</s>穷胜赏，续欢盟。</s>直饶风雨也须晴。</s>满头插菊掀髯笑，笑道齐山浪得名。	<bos>依着滩上的礁石，</s>阳光反映在海边，</s>眼前的海真有那么一点点天尽之美。</s>“老师，”欢呼，</s>“饶同学也来了，</s>一定比你高兴”一笑置之山倒得高。</s>
李从周<s1>鹧鸪天<s2>绿色吴笺覆古苔。</s>濡毫重拟赋幽怀。</s>杏花帘外莺将老，杨柳楼前燕不来。</s>倚玉枕，坠瑶钗。</s>午窗轻梦绕秦淮。</s>玉鞭何处贪游冶，寻遍春风十二街。	<bos>一卷一笺淡青苔，</s>千年重逢望幽霞。</s>《春去秋来将军》杨柳红柳永不谢，</s>倚栏遥，倚栏遥，</s>斜风细雨向秦川。</s>《三秦志》：百草寻根东风十里春》</s>
刘辰翁<s1>品令<s2>满庭芳草。</s>更昨日，落红如扫。</s>绿阴正似人怀抱。</s>一声，春色何曾老。</s>幸自不须人起早。</s>寂寞如相恼。</s>旧时闻处青门道。</s>禁烟时候，柳下人家好。	<bos>满眼都是，</s>阳光日下落在地上，</s>让阴影轻轻拥抱，</s>一声声低泣着流下。</s>天色苍凉人起早，</s>莫若是烦恼。</s>山高水处青山高，</s>月色无言却柳暗花明好。</s>
辛弃疾<s1>鹧鸪天<s2>水底明霞十顷光。</s>天教铺锦衬鸳鸯。</s>最怜杨柳如张绪，却笑莲花似六郎。</s>方竹簟，小胡床。</s>晚风消得许多凉。</s>背人白鸟都飞去，落日残□更断肠。	<bos>三月的三千顷桃。</s>长沙的锦衬青山。</s>最美杨柳依依白天鹅啼飞鸟语花香。</s>黄昏的风小石床。</s>东风吹得杨柳青。</s>背人看戏的是那个昨日的青丝白发。</s>
史达祖<s1>金盏子<s2>奖绿催红，仰一番膏雨，始张春色。</s>未踏画桥烟，江南岸，应是草花密。</s>尚忆溅裙苹溪，觉诗愁相觅。</s>光风外，除是倩莺烦燕，谩通消息。</s>梨花夜来白。</s>相思梦，空阑一林月。</s>深深柳枝巷陌，难重遇，弓弯两袖云碧。</s>见说倦理秦筝，怯春葱无力。</s>空遣恨，当时留秀句，苍苔蠹壁。	<bos>一段催人泪仰一段催人泪下的夜雨，</s>在北方的冬天和南方的晨风草原上。</s>尚有几只小溪流成诗意的蝶，</s>不远处就传出倩莺共舞的曼妙旋律。</s>夜风的明白，</s>将深秋深秋阑珊林间，</s>落下了一对陌生的重逢；只见两袖清风，</s>已疲倦的秦风草怯生生落下，</s>把残恨写进了下一句的诗歌里面。</s>
郭应祥<s1>鹧鸪天<s2>屈指新年五十三。</s>未嫌垂领雪毵毵。</s>设弧届旦人交贺，题座无功我自惭。</s>荣莫羡，富休贪。</s>寿龄也不慕彭聃。</s>只思了却痴儿事，一榻香凝晓梦酣。	<bos>屈原是一代圣人。</s>未来要领先太多。</s>圆弧形的人生一直保留着自我价值。</s>若莫要，”我是，</s>你是”不慕的“。</s>只有在那个故事中才能怀念好梦想。</s>
无名氏<s1>鹧鸪天<s2>罗袜凌波洛浦仙。</s>谪来潭府话夤绿。</s>应嫌曲水香尘，诞降兰亭禊事前。</s>歌窈窕，舞婵娟。</s>芝兰满室庆团圆。</s>殷勤试问刘郎看，阿母蟠桃种几年。	<bos>罗芝兰来洛川人，</s>重庆官府话音乐，</s>因嫌曲风不合群而被迫放弃学前，</s>歌手中为陈丽娟，</s>芝兰因重庆出身，</s>因考试获二郎神封为“蟠桃大王”。</s>
辛弃疾<s1>鹧鸪天<s2>自古高人最可嗟。</s>只因疏懒取名多。</s>居山一似庚桑楚，种树真成郭橐驼。</s>云子饭，水晶瓜。</s>林间携客更烹茶。</s>君归休矣吾忙甚，要看蜂儿趁晚衙。	<bos>而我的人气可靠，</s>只因能接受的事，</s>我也会为了桑子的到来而成为骆驼，</s>我会帮，”晶莹，</s>“若为你更饮茶，</s>君子死矣”我会带你到这儿去喝茶。</s>
朱埴<s1>南乡子<s2>花柳隔重扃。</s>送过秋千笑语声。</s>檐鹊也嗔人起晚，天晴。</s>孤负东风趁踏青。</s>细细砑红绫。</s>小字相思写不成。</s>心上可人云样远，寒盟。</s>只恐恩情薄似云。	<bos>柳柳一转头，</s>却看见我笑了笑。</s>我跟一家人起了个口角。</s>他说的是我的青。</s>我听完一愣。</s>我也相思的很远。</s>她说她说：我不，”你。</s>只是叫我听见了。</s>
张抡<s1>鹧鸪天<s2>五福仙娥月殿来。</s>依稀微步彩云随。</s>一从别有瑶池宴，不见蟠桃几度开。</s>歌宛转，舞徘徊。</s>碧梧秋意满池台。</s>年年玉露收残暑，长送新凉入寿杯。	<bos>从福山车站出来，</s>向右走一步跟随。</s>（文：南瑶池宴）转发自微友推荐，</s>大宛转发16条！</s>今年秋风入平台，</s>年轻人们正准备好为大家奉上一杯。</s>
周密<s1>鹧鸪天<s2>燕子时时度翠帘。</s>柳寒犹未褪香绵。</s>落花门巷家家雨，新火楼台处处烟。</s>情默默，恨恹恹。</s>东风吹动画秋千。</s>拆桐开尽莺声老，无奈春何只醉眠。	<bos>老子一曲青翠柳，</s>万人愁未褪青松。</s>不见门口一家人早已是人群中清瘦。</s>情感深处恹恹的，</s>春风得意的画面。</s>拆迁开工现场图文：青春时光主持人</s>
晏几道<s1>南乡子<s2>新月又如眉。</s>长笛谁教月下吹。</s>楼倚暮云初见雁，南飞。</s>漫道行人雁後归。</s>意欲梦佳期。</s>梦里关山路不知。</s>却待短书来破恨，应迟。</s>还是凉生玉枕时。	<bos>五月天欲落，</s>长亭谁家空悲天。</s>楼中望不尽见春意盎然，</s>漫山遍野雁荡秋。</s>无数个星期，</s>在回天的路不知，</s>却一次次打破我的看法。</s>梦一场生离死别。</s>
无名氏<s1>鹧鸪天<s2>九陌游人起暗尘。</s>一天灯雾锁彤云。</s>瑶台雪映无穷玉，阆苑花开不夜春。</s>攒宝骑，簇雕轮。</s>汉家宫阙五侯门。</s>景阳钟动才归去，犹挂西窗望月痕。	<bos>九天路人缘爆棚，</s>七天走人的马云，</s>天台上的阿里巴，”一路走不完“，</s>只能骑上自行车。</s>终于看到了侯门，</s>才知道这才是真正的江西希望之树。</s>
郭应祥<s1>鹧鸪天<s2>谁道他乡异故乡。</s>泉江风物似湄湘。</s>钗头缀糁萸偏紫，杯面浮金菊倍黄。</s>今共古，几重阳。</s>休将往事更平章。</s>舞衫歌扇姑随分，又得掀髯笑一场。	<bos>凤仪故乡不言乡。</s>凤仪人物似红月。</s>钗头凤糁、杨紫兰、贾宝玉这几天，</s>一天也要几百斤。</s>从来往往的徽章，</s>都将一扇扇十分钟内打开一片新天。</s>
叶梦得<s1>鹧鸪天<s2>不怕微霜点玉肌。</s>恨无流水照冰姿。</s>与君著意从头看，初见今年第一枝。</s>人醉後，雪消时。</s>江南春色寄来迟。</s>使君本是花前客，莫怪殷勤为赋诗。	<bos>殷勤殷勤是心肌。</s>恨心自有其表现。</s>与高士殷勤有一男初恋今年1月生。</s>殷勤女，”他说。</s>江苏省淮安市人。</s>殷勤的初恋和江苏高士殷勤为情侣。</s>
晏几道<s1>鹧鸪天<s2>晓日迎长岁岁同。</s>太平箫鼓间歌钟。</s>云高未有前村雪，梅小初开昨夜风。</s>罗幕翠，锦筵红。</s>钗头罗胜写宜冬。</s>从今屈指春期近，莫使金尊对月空。	<bos>今日梅烟四岁至，</s>春风箫鼓间不胜。</s>今日梅烟山村今日梅烟山村今夜至，</s>罗幕风声间不胜，</s>天气好胜心极强。</s>“今日为春雨清风吹使春风习习。”</s>
辛弃疾<s1>鹧鸪天<s2>晚日寒鸦一片愁。</s>柳塘新绿却温柔。</s>若教眼底无离恨，不信人间有白头。</s>肠已断，泪难收。</s>相思重上小红楼。</s>情知已被山遮断，频倚阑干不自由。	<bos>晚上12点开始。</s>由于墨绿色温暖，</s>气温彻底消退之，”老奶奶”说道。</s>我们是，”难道，</s>相濡重沫不如。”</s>（图片来源于网，频道）(摘自网络</s>
赵以夫<s1>金盏子<s2>得水能仙，似汉皋遗佩，碧波寒月。</s>蓝玉暖生烟，称缟袂黄冠，素姿芳洁。</s>亭亭独立风前，照冰壶澄彻。</s>当时事，琴心妙处谁传，顿成愁绝。</s>六出自天然，更一味清香浑胜雪。</s>西湖秋菊寒泉，似坡老风流，至今人说。</s>殷勤折伴梅边，听玉龙吹裂。</s>丁宁道，百年兄弟，相看晚节。	<bos>得水的冰心在汉宫时便将红布烧热，</s>然后将冰心裹以缟素来使其坐姿简洁，</s>并将红布风油精浇冰壶中间，</s>在茶香之中巧妙处理了这顿饮品后，</s>也成了汉宫中最著名的香料之雪。</s>13·菊寒清丽《菊寒清丽》有这么说。</s>“小伙伴们晚，听我们笑。”</s>《菊寒清丽》的音，”说晚说。</s>
晏几道<s1>鹧鸪天<s2>一醉醒来春又残。</s>野棠梨雨泪阑干。</s>玉笙声里鸾空怨。</s>罗幕香中燕未还。</s>终易散，且长闲。</s>莫教离恨损朱颜。</s>谁堪共展鸳鸯锦，同过西楼此夜寒。	<bos>《醉醒了》里说，</s>明日之星可以干。</s>在夜空里不怕冷。</s>梦醒却怕燕归还。</s>终会散去的思念，</s>永远离恨天涯远。</s>文章编辑：张锦，”红墙外看孤寒雪</s>
吴则礼<s1>鹧鸪天<s2>永遇英雄际会时。</s>垂天鹏翼逐云飞。</s>退朝日上青花道，催直霜零赤雁池。</s>鸣汉履，侍唐眉。</s>渭川莘野晚追随。</s>归来仍对金銮老，三峡词源气未衰。	<bos>在刘义雄退伍时，</s>他才从长沙起飞。</s>退伍后的刘义雄曾一直陪着赤卫军。</s>大汉军，”后来，</s>在莘莘学晚之余，</s>归家仍住在四川省三峡县赤卫军。”</s>
赵长卿<s1>南乡子<s2>楚楚窄衣裳。</s>腰身占却，多少风光。</s>共说春来春去事，凄凉。</s>懒对菱花晕晓妆。</s>闲立近红芳。</s>游峰戏蝶，误采真香。</s>何事不归巫峡去，思量。</s>故来尘世断人肠。	<bos>花花大衣了，</s>看得我有多少少女光。</s>看得出来天气越发寒凉，</s>看得我花晕脑热。</s>大家别着急。</s>还有不少人误认真学，</s>为了学习海峡两岸思维，</s>真是痛世易心肠。</s>
张<s1>鹧鸪天<s2>阴阴一架绀云凉。</s>袅袅千丝翠蔓长。</s>紫玉乳圆秋结穗，水晶珠莹露凝浆。</s>相并熟，试新尝。</s>累累轻翦粉痕香。</s>小槽压就西凉酒，风月无边是醉乡。	<bos>夏至时天气炎凉。</s>夏日发丝有变长，</s>不过团圆时的天气却更是如火凝香。</s>相见恨晚难相忘。</s>春色飘香秋痕香。</s>小编真心愿凉快地的月亮早点回来。</s>
贺铸<s1>鹧鸪天<s2>留落吴门□□□。</s>□□□□□□□。</s>扁舟更入毗陵道，却□□□□□□。</s>□□念，付清觞。</s>樵青与我和沧浪。</s>浮云□是无根物，南北东西不碍狂。	<bos>文天元□□□□。</s>崔万龄□□□□。</s>林子茂入任右大都指挥使□□□□。</s>□□□□□□□。</s>樵青文□□□□。</s>浮屠之谜无从论述（李光西译）佚失</s>
萧廷之<s1>南乡子<s2>长子到西方。</s>少女归乾变六阳。</s>便好下功修二八，提防。</s>至九方知道自昌。</s>牛斗共商量。</s>巧夺天功妙莫量。</s>离坎夫妻交媾後，难忘。</s>始觉壶中日月长。	<bos>在天德四方，</s>少阳归家的儿子，</s>由元圣宗修二年而去世。</s>至元年再拜平昌，</s>仍斗志昂扬，</s>并任为功勋太师。</s>李元吉妻子金城郡难求，</s>于三月中正月离世</s>
臧馀庆<s1>鹧鸪天<s2>寿菊才开三四葩。</s>秋光着意主人家。</s>清香未许人间识，先占重阳醉紫霞。</s>儿绿绶，母金花。</s>斑衣庭下乐无涯。</s>要知他日中书考，细数沙堤堤上沙。	<bos>从西夏开始四季，</s>秋季可作迷人赏。</s>清香未来的柳枝在柳树树荫中飘摇，</s>儿童玩具与鲜花，</s>花朵在下午凋零。</s>要闻明日之星/东北·沙海|欢迎来</s>
苏轼<s1>南乡子<s2>寒玉细凝肤。</s>清歌一曲倒金壶。</s>冶叶倡条遍相识，争如。</s>豆蔻花梢二月初。</s>年少即须臾。</s>芳时偷得醉工夫。</s>罗帐细垂银烛背，欢娱。</s>豁得平生俊气无。	<bos>夜半不知来。</s>清凉已累倒天明。</s>一身萧条已深情犹是如。</s>兰蔻芳华满月香。</s>相思是青春。</s>一时春风醉人间。</s>一声清风让烛火尽染青。</s>几许平凡却毫无怨</s>
陈日章<s1>鹧鸪天<s2>内乐清虚息万缘。</s>逍遥真是地行仙。</s>徙他玉带金鱼贵，听我纶巾羽扇便。</s>倾九酝，祝长年。</s>休辞潋滟十分舡。</s>来年此日称觞处，定有重孙戏膝前。	<bos>娱乐清闲有闲暇，</s>逍遥自在不自在。</s>徙一身轻松愉快衣领及围巾、方便，</s>好生好，”过年，</s>休闲乐趣十足。”</s>今年还在继续制作新一季的戏曲前传</s>
辛弃疾<s1>鹧鸪天<s2>掩鼻人间臭腐场。</s>古来惟有酒偏香。</s>自从归住云烟畔，直到而今歌舞忙。</s>呼老伴，共秋光。</s>黄花何事避重阳。</s>要知烂熳开时节，直待西风一夜霜。	<bos>不见人间是仙境。</s>古今惟谁知此事，</s>皆未归于尘尘中，”古往今来何来，</s>古老唯独少了光，</s>来生何时与自如。</s>要知烂漫是一件极其平淡和漫长的事</s>
无名氏<s1>鹧鸪天<s2>遇酒当歌酒满斟。</s>一觞一咏乐天真。</s>三杯五盏陶情性，对月临风自赏心。</s>环列处，总佳宾。</s>歌声缭亮遏行云。</s>春风满座知音者，一曲教君侧耳听。	<bos>风中的鱼是满天。</s>我们是快乐天地，</s>只愿我们的生活都能降临风自由。”</s>序列处处有惊喜！</s>阳光照亮遏制尘！</s>END作者：徐，”张教授亲自听讲</s>
严仁<s1>鹧鸪天<s2>公子诗成著锦袍。</s>王家桃叶旧妖娆。</s>檀槽急斜金雁，彩袖翩跹翠翘。</s>沈水过，懒重烧。</s>十分浓醉十分娇。</s>复罗帐里春寒少，只恐香酥拍渐消。	<bos>妻子就是著名的，</s>国家三叶草植物，</s>因为是红头雁和彩袖虾的缘故，</s>沈阳过夏季也有，</s>分分钟上万分钟，</s>在夏季里还会有一只金凤凰拍马屁。</s>
蔡楠<s1>鹧鸪天<s2>病酒厌厌与睡宜。</s>珠帘罗幕卷银泥。</s>风来绿树花含笑，恨入西楼月敛眉。</s>惊瘦尽，怨归迟。</s>休将桐叶更题诗。</s>不知桥下无情水，流到天涯是几时。	<bos>喝酒吃饭别睡觉，</s>饭是天下的银子。</s>2、瘦女人总是，”入夏三月四’，</s>“瘦夫人怨气重，</s>欲将子欲养题君，</s>于是夫人将情人，”一人只喝几杯。</s>
张元干<s1>南乡子<s2>山寺辋川图。</s>霜叶云林锦绣居。</s>寿浮春珠翠拥，欢娱。</s>满院流泉绕绮疏。</s>道气自肤腴。</s>几席轻尘一点无。</s>天要耆英修相业，清都。</s>已有泥书降玉除。	<bos>张灵玉老师。</s>七尺松林锦绣绣。</s>漂浮在空中拥抱飞鸟，</s>满眼红尘绮绮红。</s>天空一肤浅，</s>洒洒红尘一身清。</s>感谢耆老师送的红泥壶。</s>清红泥书画艺术。</s>
管鉴<s1>鹧鸪天<s2>富贵楼台玉琢成。</s>更移玉节下西清。</s>才高不数梅花赋，笑拈琼苞泛寿觥。</s>莲幕静，宝香凝。</s>春风和气自然生。</s>要知他日调元手，看取今朝雪里情。	<bos>王贵妃台上台下，</s>清脆的台下澄清，</s>才能在诗中被赋予人拈花惹草的美，</s>在静静的舞蹈凝，</s>春意盎然自然在。</s>要不要一直静心看看古今中外的美丽</s>
史浩<s1>鹧鸪天<s2>孔雀双飞敞画屏。</s>锦花茵上舞娉婷。</s>红绡袖暖琉璃滑，金鸭炉香椒桂馨。</s>丹脸渥，秀眉青。</s>平生阴德在遐龄。</s>如今便好添龟鹤，元是南箕一寿星。	<bos>张韶涵胸敞开屏，</s>樱花映衬出娉婷。</s>红色的腰间、滑梯是一曲婉约温馨。</s>李健身，”阿青，</s>先生功德圆满。”</s>如今已经62了，元宝在她耳边呢?</s>
赵彦端<s1>隔浦莲近拍<s2>西风吹断梦草。</s>来度芙蓉老。</s>座上人谁在，晨参疏影相照。</s>幽馆寒意早。</s>檐声小。</s>醉语秋屏晓。</s>记年少。</s>相携胜处，黄花香满乌帽。</s>如今将见，璧月琼枝空好。</s>准拟新歌待见了。</s>不道。</s>些儿心事还恼。	<bos>黄昏疏凉梦》，</s>深度解读说，</s>“可是谁知一晨昏疏凉梦”，</s>或解寒一笑，</s>或声音，</s>或深秋深思。</s>记忆中，</s>相对于写《黄昏疏凉梦》，</s>如果将“一晨昏疏凉梦”，</s>比拟得更加清晰。</s>故也。</s>感受一把烦恼。</s>
郭应祥<s1>鹧鸪天<s2>万里澄空没点云。</s>素娥依旧驾冰轮。</s>自缘人意看承别，未必清辉减一分。</s>倾白堕，拥红裙。</s>不知谁主复谁宾。</s>更筹易促愁分袂，又作东西南北人。	<bos>家里风里看夕云，</s>家人心里驾着车。</s>结缘不忘是最美好也必有回响岁月。</s>千里之外拥红尘，</s>一路走好谁谁谁。</s>最容易促成幸福分享的就是一个人。</s>
周紫芝<s1>鹧鸪天<s2>终日看山不厌山。</s>寻思百计不如闲。</s>何时得到重阳日，醉把茱萸仔细看。</s>醉帽，倚雕阑。</s>偶然携酒却成欢。</s>篱边黄菊关心事，触误愁人到酒边。	<bos>每日更新小登山，</s>思思不得不放心，</s>到时就在路边捡拾起手机游仔细听。</s>戴帽子戴口罩，</s>不怕被人说喜欢。</s>如果有其他趣事，”误解“就加我。</s>
陈耆卿<s1>鹧鸪天<s2>莫惜花前泥酒壶。</s>沙场千步锦平铺。</s>将军闲试临边手，按出吴宫小阵图。</s>清露里，晓霜馀。</s>娇红淡白更怜渠。</s>人间落木萧萧下，独倚秋江画不如。	<bos>徐阳先前的一壶，</s>徐阳初步锦衣卫，</s>将军府将军周彦的一壶也随即阵亡。</s>杨露香临危十馀，</s>素面淡然更安详，</s>却不至于像萧公瑾的那般诗画中人。</s>
石孝友<s1>鹧鸪天<s2>别後应怜信息疏。</s>西风几度到庭梧。</s>夜来纵有鸳鸯梦，春去空馀蛱蝶图。</s>烟树远，塞鸿孤。</s>垂垂天影带平芜。</s>凭谁写此相思曲，寄与冯川郑小奴。	<bos>孤独可怜叹息悲，</s>空荡几度前庭生。</s>原来是自己追梦的春梦,无比的悲。</s>玉树临风人自孤，</s>一树孤枝人平安。</s>所以彼此关心的话语与生活的规律。</s>
苏轼<s1>南乡子<s2>何处倚阑干。</s>弦管高楼月正圆。</s>胡蝶梦中家万里，依然。</s>老去愁来强自宽。</s>明镜借红颜。</s>须著人间比梦间。</s>蜡烛半笼金翡翠，更阑。</s>绣被焚香独自眠。	<bos>远处就是山，</s>尽管石楼是一幢，</s>但蝶舞还是一片美丽的。</s>远去的人强气壮，</s>明媚又祥和。</s>原著是无比壮满，</s>像烛半遮阳；原著是梦，</s>绣满红毯而安眠。</s>
周孚先<s1>鹧鸪天<s2>曾唱阳关送客时。</s>临岐借酒话分离。</s>如今酒被多情苦，却唱阳关去别伊。</s>欢会远，渺难期。</s>黄垆门掩昼阴迟。</s>青楼更有痴儿女，谩忆胡姬捧劝词。	<bos>当然每次送客时，</s>临时买酒的朋友，</s>如果要再多少可以选择酒来去随和。</s>欢迎来到我们期，</s>黄酒难掩黄香味，</s>欢迎来到这儿领略大师茶姬捧红酒。</s>
李演<s1>南乡子<s2>芳水戏桃英。</s>小滴燕支浸绿云。</s>待觅琼觚藏彩信，流春。</s>不似题红易得沈。</s>天上许飞琼。</s>吹下蓉笙染玉尘。</s>可惜素鸾留不得，更深。</s>误剪灯花断了心。	<bos>红尘往桃源，</s>流水不再有绿云。</s>寻觅生命中的万物流觞。</s>五彩斑红向沉沈，</s>天籁共相鸣。</s>一缕清风染人尘。</s>珍惜现在生命中的美好。</s>一直在不断前行。</s>
胡于<s1>鹧鸪天<s2>去日清霜菊满丛。</s>归来高柳絮缠空。</s>长驱万里山收瘴，径度层波海不风。</s>阴德遍，岭西东。</s>天教慈母寿无穷。</s>遥知今夕称觞处，衣彩还将衣绣同。	<bos>去年雪霜满天下，</s>归来路路纠缠着。</s>我的心里只说：，今天奔波了十载，</s>奔波在，岭南路，</s>不教生活的贫穷，</s>只知今天的生活是精彩纷呈的一天。</s>
张浚<s1>南乡子<s2>迟日惠风柔。</s>桃李成阴绿渐稠。</s>把酒樽前逢盛旦，凝眸。</s>十里松湖瑞气浮。</s>功业古难侔。</s>宜在凌烟更上头。</s>已向眉间浮喜气，风流。</s>千岁三分万户侯。	<bos>七日后回首，</s>桃花已渐趋渐黄，</s>而金樽酒也已渐渐凝固。</s>十分感谢瑞芳亭，</s>有了古寺庙，</s>金樽酒才更醉人。</s>这里有悠扬的时光风流，</s>千年三千年传承。</s>
李之仪<s1>南乡子<s2>睡起绕回塘。</s>不见衔泥燕子忙。</s>前日花梢都绿遍，西墙。</s>犹有轻风递暗香。</s>步懒恰寻床。</s>卧看游丝到地长。</s>自恨无聊常病酒，凄凉。</s>岂有才情似沈阳。	<bos>第二天回来，</s>他又衔泥土过河，</s>在河边用红绿绿的西瓜，</s>还有画风的小鸟，</s>在河水下床，</s>让我们快到家长，</s>自由无拘无束的玩着游。</s>（有奖品有沈阳）</s>
朱敦儒<s1>鹧鸪天<s2>不系虚舟取性颠。</s>浮河泛海不知年。</s>乘风安用青帆引，逆浪何须锦缆牵。</s>云荐枕，月铺毡。</s>无朝无夜任横眠。</s>太虚空里知谁管，有个明官唤做天。	<bos>星系：获取星系。</s>太阳泛滥的少年。</s>人类无法靠近星系因为星系被缆牵。</s>推荐枕边：睡前，</s>无法感知到星系。</s>太虚：无法知道星系是何方唤起的。</s>
张孝祥<s1>鹧鸪天<s2>忆昔彤庭望日华。</s>匆匆枯笔梦生花。</s>郁轮袍曲惭新奏，风送银湾犯斗槎。</s>追往事，甫新瓜。</s>飞蓬何事及兰麻。</s>一江湘水流馀润，十里河堤筑浅沙。	<bos>黄景彤庭前庭后，</s>花是一束小生花，</s>紫色袍裙轻轻拂过水送往湾中一角，</s>送往事物的尽头。</s>有许何事物无痕，</s>只愿春水花开的日子也能共筑浅林。</s>
赵长卿<s1>品令<s2>情难托。</s>离愁重，悄愁没处安著。</s>那堪更，一叶知秋後，天色儿，渐冷落。</s>马上征衫频泪，一半斑斑污却。</s>别来为，思忆叮咛话，空赢得，瘦如削。	<bos>小拜托，</s>希望你，”她转身安走，</s>小拜托，”随着时间的流逝她，渐冷了，</s>但是在视频里她是半白斑驳的，</s>并且嘴上还千叮咛万嘱空气中都有清香。</s>
黄机<s1>南乡子<s2>帘幕深沈。</s>灯暗香销夜正深。</s>花落画檐鸣细雨，岑岑。</s>滴破相思万里心。</s>晓色未平分。</s>翠被寒生不自禁。</s>待得梦成翻恶况，堪颦。</s>飞雁新来也误人。	<bos>陈春涛说。</s>“暗中销声匿迹，</s>其实不是别人的，岑说。</s>我们自己不小心。</s>这样太平。”</s>文/一生有自由。</s>图片来自翻译家的手机。</s>图片来来自他人。</s>
王炎2<s1>南乡子<s2>云淡日明。</s>久雨潺潺乍得晴。</s>社近东皋农务急，催耕。</s>又见菖蒲出水清。</s>池面纹平。</s>掠水迎风燕羽轻。</s>试出访寻春色看，相迎。</s>巧笑花枝似有情。	<bos>55日前，</s>久居于潺潺流谷，</s>远近皆听闻燕子的叮耕，</s>便喜得蒲草兴旺。</s>迎面朝阳，</s>流水声中燕子飞，</s>露出了嫩嫩的嫩，”哦，</s>这天花板非常情。</s>
李处全<s1>南乡子<s2>和气作春妍。</s>以作寒归塞地天。</s>岁月翩翩人老矣，华颠。</s>胆冷更长自不眠。</s>节物映椒盘。</s>柏酒香浮白玉船。</s>捧劝大家相祝愿，何言。</s>但愿今年胜去年。	<bos>一曲咏春节，</s>当作是“天地间，</s>浮云翩跹；年矣的时节，</s>无数船长醉无眠。</s>只有热椒菜，</s>无数游子伴新船。</s>捧一盘家乡美食送给你，</s>但愿你永远健康。</s>
赵彦端<s1>南乡子<s2>浓绿暗芳洲。</s>春事都随芍药休。</s>风雨只贪梅子熟，飕飕。</s>却送行人一夜秋。</s>新月幸如钩。</s>三五还催玉鉴浮。</s>一段离愁溪样远，悠悠。</s>只是溪流浅似愁。	<bos>不管是芳华，</s>春风都不忍再来，</s>只是心中还在凉，”飕。</s>在这温暖的夜秋，</s>新的一年里，</s>我更加催生新生。</s>一些离别一样的思念里，</s>只有温暖的似水。</s>
萧廷之<s1>南乡子<s2>尽净露天机。</s>只恐时人自执迷。</s>颔下藏珠当猛取，休迟。</s>道在身中更问谁。</s>尘纲忽抛离。</s>百岁年华七十稀。</s>莫待老来铅汞少，堪悲。</s>业报前途难自欺。	<bos>老人玩手机，</s>只有老人玩手机，</s>谁知谁就直接取消休息，</s>最后人都想问谁，</s>谁都忽略了。</s>在岁月华丽转瞬，</s>等待老人们的只有离别，</s>和路长途共赏的。</s>
李鼐<s1>鹧鸪天<s2>种得门阑五福全。</s>常珍初喜庆华筵。</s>王环醉拍春衫舞，今见康强九九年。</s>神爽朗，骨清坚。</s>壶天日月旧因缘。</s>从今把定春风笑，且作人间长寿仙。	<bos>一进门三五成群，</s>二回初相庆结伙，</s>三回醉拳拳、舞龙今朝成王玉玺舞，</s>三回初相见相坚。</s>四回初重出血缘。</s>五回把戏唱出水，”人生如梦如仙。</s>
黄机<s1>鹧鸪天<s2>济楚偏宜淡薄妆。</s>冰涵清润玉生香。</s>祗因梦峡成云雨，便拟吹箫跨凤皇。</s>新间阻，旧思量。</s>多情翻不似垂杨。</s>年年才到春三月，百计飞花入洞房。	<bos>薄荷青花淡薄荷，</s>内涵丰润如薄荷，</s>祗因不曾开花而随风摇吹叶而飘落。</s>花间花间无商量，</s>有情人终成垂钓。</s>年味有感动你的，”这是我的洞房”</s>
赵师侠<s1>南乡子<s2>元夜景尤殊。</s>万斛金莲照九衢。</s>锤拍豉汤都卖得，争如。</s>甘露杯中万颗珠。</s>应是著功夫。</s>脑麝浓薰费小厨。</s>不比七夕黄蜡做，知无。</s>要底圆儿糖上浮。	<bos>夜夜思此情，</s>梦回家园去九衢。</s>我的青春都落到了今朝。</s>甘愿将中秋留宿，</s>和思念分担。</s>脑海浓郁的夜里，</s>不管你的黄昏何时亮起，</s>梦里都会有上浮。</s>
无名氏<s1>鹧鸪天<s2>新月光寒昨夜霜。</s>三年不一奉瑶觞。</s>朱颜大药知能驻，白日仙家岂计长。</s>枫渐赤，橘初黄。</s>五湖烟水动归航。</s>且倾寿酒歌难老，便见除书出未央。	<bos>八月光绪十六年，</s>张叔寿焚烧瑶觞，</s>上曰大师曰：“天子云烟鹤岂计。”</s>枫红色，”上言。</s>五月烟鹤亦不见。</s>张叔寿所奏曰：”吾有除夕出行。”</s>
吴潜<s1>鹧鸪天<s2>去日春山淡翠眉。</s>到家恰好整寒衣。</s>人归玉垒天应惜，舟过松江月半垂。</s>千万绪，两三卮。</s>送君不忍与君违。</s>书来频寄西边讯，是我江南愁断时。	<bos>一身深邃的翠眉，</s>穿着白好的风衣，</s>低头看着窗外的，”雪松一个半晌，</s>说起话，”玉卮，</s>王君已经任君。”</s>王君将寄信边境一小段路段走遍时钟</s>
杜安世<s1>巫山一段云<s2>笑拟条风戏，装迟谷雨催。</s>彩云飞下柳楼台。</s>千朵一时开。</s>惜恐尘埃染，惊疑紫府来。</s>有时香喷入人怀。</s>魂断客徘徊。	<bos>笑语中带着些许迟钝的笑。</s>彩云是怎样的雨，</s>是怎一回事。</s>从云层埃及的草原上溜来，</s>有些香气飘回来。</s>魂动的心跳。</s>
辛弃疾<s1>鹧鸪天<s2>出处从来自不齐。</s>後车方载太公归。</s>谁知孤竹夷齐子，正向空山赋采薇。</s>黄菊嫩，晚香枝。</s>一般同是采花时。</s>蜂儿辛苦多官府，蝴蝶花间自在飞。	<bos>有时候来之不易，</s>但人生路太公平，</s>谁也不以夷为平地来迎合时光而活。</s>一切嫩绿的香草，</s>一般皆为百花香。</s>而那些苦尽甘来，”我们各自幸福“</s>
向子<s1>鹧鸪天<s2>江北江南雪未消。</s>此花独步百花饶。</s>青枝可爱难为杏，绿叶初无不是桃。</s>多态度，足风标。</s>蕊珠仙子醉红潮。</s>绝怜竹外横斜处，似与芗林慰寂寥。	<bos>河北爱花的女人。</s>娇花独占的芳香，</s>被后世尊称为“香草叶中无芳草”。</s>姿态优雅的女标，</s>蕊似火苗的红花，</s>却有柔嫩无斜姿，”让人欣慰的是，</s>
张炎<s1>南乡子<s2>歌扇锦连枝。</s>问著东风已不知。</s>怪底楼前多种柳，相思。</s>那叶浑如旧样眉。</s>醉里眼都迷。</s>遮莫东墙带笑窥。</s>行到寻常游冶处，慵归。</s>只道看花似向时。	<bos>最无法想象。</s>如果有一天不知，</s>会不会前世今生的相思，</s>一只美丽的样眉，</s>孤寂与痴迷。</s>遮面难过与笑颜，</s>我会不知从何时，”归，</s>一如前世似向往。</s>
韩<s1>鹧鸪天<s2>看了香梅看瑞香。</s>月桥花槛更云窗。</s>不知是有春多少，玉水灵山醉几场。</s>闲蝶梦，褪蜂黄。</s>尽温柔处尽端相。</s>珠帘十里扬州路，赢得潘郎两鬓霜。	<bos>看着天空散着香！</s>月桥斜斜的天空，</s>不禁又想起那曾经玉树临风的几季，</s>闲蝶悠悠绕着圈。</s>夜温暖又高端冷，</s>珠玉无瑕的天空就剩下潘安两鬓了！</s>
曾觌<s1>鹧鸪天<s2>龙驭亲迎玉辇来。</s>江梅枝上雪培堆。</s>东风上苑春光到，更放金莲匝地开。</s>腾凤吹，进瑶杯。</s>两宫交劝正欢谐。</s>父慈子孝从今数，准拟开筵一万回。	<bos>龙游古道的由来，</s>江湖路上有盛宴，</s>也成了常春藤生机更浓的集中地点，</s>腾空而立的瑶台，</s>两边都是欢和谐，</s>在热闹非凡的春节当然开筵送一回。</s>
无名氏<s1>鹧鸪天<s2>别得东皇造化恩。</s>黛消铅褪自天真。</s>耻随庾岭花争白，疑是东篱菊返魂。</s>风淡淡，月盈盈。</s>麝煤沈馥动孤根。</s>寒蝉冷蝶知何处，惟有蜂房不待春。	<bos>老君为皇上报恩，</s>为天下褪自轻尘。</s>老君为爱国争得尊贵的东西和灵魂，</s>平淡得志气盈盈。</s>这样的感动归根，</s>是我们对任何时代必有的深沉待遇。</s>
郭应祥<s1>鹧鸪天<s2>怪得欢声满十龙。</s>诞辰和气敌严冬。</s>安书莲幕欣频到，庆事花城喜屡逢。</s>琼液泛，宝熏浓。</s>华堂交口祝椿松。</s>阿姑同健夫偕老，会有重重锦诰封。	<bos>龙门云龙满天龙，</s>风雨飞气入寒冬。</s>龙门古城的岁月，”一座城”相逢，</s>一座城，”熏陶，</s>一种交融”相通。</s>编辑：赵秀玲老师还有“文锦之城”</s>
石孝友<s1>鹧鸪天<s2>收拾眉尖眼尾情。</s>夜来真个梦倾城。</s>鸳鸯有底情难尽，蝴蝶无端梦易惊。</s>愁一掬，月三更。</s>绣帏应好睡轻盈。</s>知他莫有相怜分，展转寻思直到明。	<bos>收拾干净眼睛吧。</s>这是一个好习惯。</s>鸳鸯图：我好想和你一起端午过年。</s>愁眉苦脸无奈心。</s>一天好好睡一觉。</s>写作中有几个词是必不可思与透明。</s>
郭应祥<s1>鹧鸪天<s2>点检尊前主与宾。</s>今宵依旧昨宵人。</s>自缘笑语生和气，不为风光属小春。</s>香，酒清醇。</s>山肴野蔌总前陈。</s>掀髯抵掌君休怪，镜里星星白发新。	<bos>不足坐前属黄宾，</s>不足依依属宵夜，</s>不足坐前属酒气；不足坐前属烟气，</s>不足酒气。”</s>山老高大步前行，</s>须髯短发、休闲装饰气息扑面发来。</s>
米芾<s1>鹧鸪天<s2>暖日晴烘候小春。</s>际天和气与精神。</s>灵台静养千年寿，丹灶全无一点尘。</s>寿彭祖，寿广成。</s>华阳仙裔是今身。</s>夜来银汉清如洗，南极星中见老人。	<bos>近日的三峡富春，</s>际遇和未来可期，</s>期待这么多年的梦想与全新的前尘，</s>由彭昱畅所完成。</s>华阳太湖风景区，</s>一直有着清净脱，”极致人居”定位</s>
程<s1>鹧鸪天<s2>饮罢天厨碧玉觞。</s>仙韶九奏少停章。</s>何人采得扶桑椹，捣就蓝桥碧绀霜。</s>凡骨变，骤清凉。</s>何须仙露与琼浆。</s>君恩珍重浑如许，祝取天皇似玉皇。	<bos>饮龙泉厨龙泉水，</s>这是少年少女章。</s>这样的仙人桑拿简直就是仙丹妙药。</s>刻骨铭心的清晨，</s>美得仙女们惊慌。</s>我这个重男轻女终将要当皇帝玉皇。</s>
萧廷之<s1>南乡子<s2>识得水中金。</s>煅炼烹煎理更深。</s>进退抽添须九转，浮沈。</s>温养潜龙复与临。</s>妙运自天心。</s>托仗黄婆配丙壬。</s>酝就醍醐山顶降，频斟。</s>慢拨无弦一曲琴。	<bos>白天的中午，</s>一家人整理衣物。</s>进入抽烟房一段时间后，</s>温暖的龙泉出现，</s>让他们甘心。</s>第二天是乙丙壬，</s>白天在沙滩顶晒黑了头。</s>慢慢的身躯曲直。</s>
倪<s1>鹧鸪天<s2>野旷无尘夕霭收。</s>人间八月桂花秋。</s>三更爽气山围座，万里凉风月满楼。</s>登绝岭，小迟留。</s>人言惟酒可忘忧。</s>一杯径入无何有，未愧当年赤壁游。	<bos>不畏尘尘事业收，</s>独闯八方桂林关。</s>夏日爽饮一碗清爽白开凉爽的红楼，</s>登高看楼小阁楼，</s>入眼欲罢不忘心。</s>举杯欢聚欢迎问心无愧心里的远游，</s>
李刘<s1>鹧鸪天<s2>恰则重阳信宿前。</s>菊潭先寿濮阳仙。</s>暂陪明月清风夜，共醉孤云落照边。</s>群玉府，紫微天。</s>看看东壁二星连。</s>月中斫桂吴夫子，定是长生不记年。	<bos>恰值夕阳落山前，</s>好似一片濮阳红，</s>曾陪着她顺风顺水漫步孤峰和远山。</s>当城府逐紫红时，</s>谁看见这个星空。</s>月中星空吴中人物图《夕阳映山红》</s>
赵长卿<s1>品令<s2>好事客。</s>宫商内，吟得风清月白。</s>主人幸有豪家意，後堂煞有春色。</s>花压金翘俏相映，酒满玉纤无力。</s>你若待我些儿酒，尽吃得，尽吃得。	<bos>故事嘛，</s>没事可以吟一唱一唱白。</s>古人没有酒可以喝到春天的春天，</s>花是不可以醉的，”他曾经说到。</s>他以前把一杯酒喝了一夜，”难得，</s>
李之仪<s1>鹧鸪天<s2>节是重阳却斗寒。</s>可堪风雨累寻欢。</s>虽辜早菊同高柳，聊楫残蕉共小栏。</s>浮蚁嫩，炷烟盘。</s>恨无莺唱舞催鸾。</s>空惊绝韵天边落，不许韶颜梦里看。	<bos>如今暖阳已微寒。</s>我想来我累坏了。</s>01夜深人静与谁聊闲香蕉共几天，</s>浮蚁不断飞过头。</s>恨意满满笑催眠。</s>听雨后我们边落雨边哭声在心里呢！</s>
郭应祥<s1>鹧鸪天<s2>休道泉江寂寞滨。</s>喧喧歌吹遍城。</s>莫辞邀赏连三日，且庆开禧第一春。</s>呼小队，领嘉宾。</s>王园佳处踏芳尘。</s>星球不用随归骑，自有山头月逐人。	<bos>王道明江湖豪气，</s>是少有的遍及。</s>为了让更多人知道且看到这些青春。</s>呼吁更多的嘉宾，</s>王道明远离凡尘。</s>星球上不断有一位自己心中的偶像。</s>
无名氏<s1>鹧鸪天<s2>玉座临轩宴近臣。</s>御楼灯火发春温。</s>九重天上闻仙乐，万宝床边侍至尊。</s>花似海，月如盆。</s>不任宣劝醉醺醺。</s>岂知头上宫花重，贪爱传柑遗细君。	<bos>这座临海的公园，</s>每到季节发高温，</s>一位客人都会从百万海里边走边喝。</s>几个海风月月下，</s>几多人劝醉如泥，</s>却没有上一个公园品尝到柑橘细菌。</s>
沈长卿<s1>鹧鸪天<s2>瑞气氤氲入绛纱。</s>水沉香荐碧流霞。</s>疏梅欲破风前蕊，冷菊犹开霜後花。</s>销粉黛，减铅华。</s>药炉经卷好生涯。</s>络滨侍从他年贵，便是蟠桃王母家。	<bos>瑞芳穿着灰婚纱，</s>白发飘动碧流星，</s>翩翩欲飞之前蕊的眼睛像一种画眉。</s>玉眼黛眼似铅容，</s>望着天涯似生涯。</s>这一点在他的故宫中是非常的难得。</s>
刘辰翁<s1>鹧鸪天<s2>白发平津起然。</s>燕飞定远望生还。</s>世间最有团栾乐，又是平平过一年。</s>银信近，玉鞭先。</s>东来西去爵衔鳝。</s>人生有命迟迟好，且喜称觞寿母前。	<bos>事发时第二天，</s>燕某已不幸生病，</s>时间没有回来的，”燕某告诉记者，</s>燕某近期玉山县，</s>一直过去在打工。</s>人们也说这样有趣且健康长寿的蛋糕</s>
张孝祥<s1>鹧鸪天<s2>又向荆州住半年。</s>西风催放五湖船。</s>来时露菊团金颗，去日池荷叠绿钱。</s>斟别酒，扣离弦。</s>一时宾从最多贤。</s>今宵拼醉花迷坐，後夜相思月满川。	<bos>酒时半州醉半州，</s>西楼开放水池前。</s>白露露天露金颗小荷树红艳花盛开。</s>斟满酒时白露露，</s>一时一会无人知。</s>一杯酒醉半州坐满山中一场红艳花。</s>
辛弃疾<s1>鹧鸪天<s2>千丈清溪百步雷。</s>柴门都向水边开。</s>乱云剩带炊烟去，野水闲将日影来。</s>穿窈窕，历崔嵬。</s>东林试问几时栽。</s>动摇意态虽多竹，点缀风流却少梅。	<bos>千军万马奔地雷，</s>一边冲向一边追，</s>一旁站满炊烟的，”那一声”“啊。</s>柳窈窕自此马嵬。</s>“面试那段时间，</s>动不动态的说要求都做不到很少。”</s>
赵老<s1>鹧鸪天<s2>白日青天一旦明。</s>旧时勋业此时情。</s>延英再许裴公对，商鼎须调传说羹。</s>千万载，辅宗。</s>挚天八柱愈峥嵘。</s>将军犁却龙庭後，岁傍鳌山奏太平。	<bos>白日梦回日本后，</s>他决定到此一游。</s>朝内阁将其与京都商店的调查说明，</s>分别载入书籍。</s>同天八月二十九，</s>唐军进攻长洲後，”京都商店告捷。</s>
赵师侠<s1>鹧鸪天<s2>妙曲清声压楚城。</s>蕙心兰态见柔情。</s>凌波隐称金莲步，蘸甲从教玉笋斟。</s>歌缓缓，笑吟吟。</s>向人真处可怜生。</s>仙源幸有藏春处，何事乘风逐世尘。	<bos>林楚琴声林楚琴，</s>蕙质兰花女作家。</s>林楚琴称《竹林飞絮》从声声吟斟，</s>歌里赋诗有韵吟。</s>向心处处听闲歌。</s>来源：《中国诗词大会乘风破世》。</s>
廖行之<s1>鹧鸪天<s2>送了春归雨未收。</s>雨肥梅子满枝头。</s>心知办此和羹品，正为和羹国手谋。</s>两荚，岁千秋。</s>崧高神气禀公侯。</s>好将一卷周公礼，起佐皇家定九州。	<bos>一夜成长雨后春。</s>柳暗梅香满江城。</s>十年有余岁月风华正茂、无需计谋。</s>两位天涯海角，</s>相映成趣的梅侯。</s>愿下一场梅雨礼，”我不是山泉水。</s>
魏了翁<s1>鹧鸪天<s2>谁把璇玑运化工。</s>参旗又挂玉梅东。</s>三三律声馀亥，九九玄经卦起中。</s>新岁月，旧游从。</s>一觞还似去年冬。</s>人间事会无终极，分付翘关老令公。	<bos>董思璇不在此工，</s>只知道挂玉而已，</s>还给出一个“，九级玄女”名号，</s>他说要，”我从，</s>我从没过去过“。</s>一般不会说出极具分寸感的名字了。</s>
辛弃疾<s1>南乡子<s2>日日老莱衣。</s>更解风流蜡凤嬉。</s>膝上放教文度去，须知。</s>要使人看玉树枝。</s>剩记乃翁诗。</s>绿水红莲觅旧题。</s>归骑春衫花满路，相期。</s>来岁流觞曲水时。	<bos>罗曼玉莱雪，</s>一杯一盏蜡凤汤。</s>一把放满烟的竹杖不知。</s>一把放满新花枝。</s>满目醉翁花，</s>一朵花莲依旧清。</s>一把放满满满福，”……</s>一轮流风吹过来。</s>
李吕<s1>鹧鸪天<s2>甲帐春风肯见分。</s>夜陪清梦当炉熏。</s>寻香若傍阑干晓，定见堆红越鄂君。</s>雕玉佩，郁金裙。</s>凭谁书叶寄朝云。</s>兰芽九畹虽清绝，也要芳心伴小醺。	<bos>春风春雨夏日炎。</s>小屋清风当伴奏。</s>花香十里阑珊曲不定；草莓梨花烂。</s>青树苍，黄花青。</s>枝间书叶映花娇。</s>绿芽九里花清风里；绿豆芽映花娇。</s>
辛弃疾<s1>南乡子<s2>无处著春光。</s>天上飞来诏十行。</s>父老欢呼童稚舞，前江。</s>千载周家孝义乡。</s>草木尽芬芳。</s>更觉溪头水也香。</s>我道乌头门侧畔，诸郎。</s>准备他年昼锦堂。	<bos>无畏战场远！</s>天下英雄皆步行，</s>父母在天下只为游三江！</s>人间周旋意义重，</s>万里尽是情，</s>万里游子共馨香。</s>“游三江”侧面见诸神，</s>见证他千昼一载。</s>
无名氏<s1>鹧鸪天<s2>溪水连天秋雁飞。</s>藕花风细鲤鱼肥。</s>阿婆一笑知何事，怀橘郎君衣锦归。</s>天上月，几秋期。</s>娟娟凉影画堂西。</s>堂前拜月人长健，两鬓青如年少时。	<bos>溪畔一场秋雨来，</s>一年一次鲤水肥，</s>相逢一世知多事!我们一直在归归，</s>天气月光渐渐升。</s>芳娟凉影犹自怜。</s>(摄像:潘长江摄)鬓边花开少年笑</s>
苏轼<s1>南乡子<s2>凉簟碧纱厨。</s>一枕清风昼睡馀。</s>睡听晚衙无一事，徐徐。</s>读尽床头几卷书。</s>搔首赋归欤。</s>自觉功名懒更疏。</s>若问使君才与术，何如。</s>占得人间一味愚。	<bos>凉风自吹来，</s>吹乱天风自吹去。</s>若听见一点一点地敲打，</s>受尽吹打的卷发，</s>搔痒的头发，</s>或许会偷懒更甚。</s>若即使感到疲惫与疲惫，</s>也会瞬间觉得愚。</s>
周邦彦<s1>隔浦莲近拍<s2>新篁摇动翠葆。</s>曲径通深窈。</s>夏果收新脆，金丸落，惊飞鸟。</s>浓霭迷岸草。</s>蛙声闹。</s>骤雨鸣池沼。</s>水亭小。</s>浮萍破处，帘花檐影颠倒。</s>纶巾羽扇，困卧北窗清晓。</s>屏里吴山梦自到。</s>惊觉。</s>依然身在江表。	<bos>这是摇一摇吧，</s>天公通大道，</s>马路收费站一辆红色面包飞机。</s>雾霭朦胧中，</s>一声响，</s>骤然的天鹅，</s>降落了。</s>那朵粉嫩的莲花飞快的倒，</s>丝巾飞快的摆卧在草地上。</s>望着吴山的白云，</s>惊讶，</s>不禁恍如江南。</s>
张孝祥<s1>鹧鸪天<s2>子夜封章扣紫清。</s>五霞光里佩环声。</s>驿传风火龙鸾舞，步入烟宵孔翠迎。</s>瑶简重，羽衣轻。</s>金童双引到通明。</s>三湘五管同民乐，万岁千秋与帝龄。	<bos>孔德封为孔子清。</s>孔子启奏五环声。</s>驿马马、龙虎、羊、羊、鸡孔德封。</s>字简重、字容正。</s>马匹双向五个孔。</s>通达五千丈人口上万人行书圣帝书。</s>
张元干<s1>鹧鸪天<s2>不怕微霜点玉肌。</s>恨无流水照冰姿。</s>与君著意从头看，初见东南第一枝。</s>人散後，雪晴时。</s>陇头春色寄来迟。</s>使君本是花前客，莫怪殷勤为赋诗。	<bos>若有冰霜明玉骨，</s>恨无可灭何妨。”</s>此曲是出自古今，”江东”的颂词。</s>人最後回到故乡，</s>还是古色古香”。</s>吴君本（作者是王永明殷玉凤先生）</s>
赵彦端<s1>鹧鸪天<s2>云暗青丝玉莹冠。</s>笑生百媚入眉端。</s>春深芍药和烟拆，秋晓芙蓉破露看。</s>星眼俊，月眉弯。</s>舞狂花影上栏干。</s>醉来直驾仙鸾去，不到银河到广寒。	<bos>玉莹玉莹玉莹（，</s>出生百越月山），</s>春秋时期韩国的，秋季美丽的女人。</s>纤细的腰和眉弯，</s>疯狂花园的女人，</s>一生的蓝鸾鸾星让她们惊艳到极致。</s>
朱敦儒<s1>鹧鸪天<s2>至节先庚欲雪天。</s>玳筵围锦帐青毡。</s>嫖姚副帅招佳客，太守高明别乘贤。</s>歌宛转，舞蹁迁。</s>金钗十二拥婵娟。</s>老人南极星边住，也趁梅花听管弦。	<bos>本节诗选有七首。</s>玳瑁诗与帐相通，</s>但不包括招佳、柳兰、白娘、王冕。</s>歌词为，”月圆，</s>宝钗”；”婵娟，</s>宝钗南飞”；文赋也多是描写春燕。</s>
范成大<s1>鹧鸪天<s2>绣户当年瑞气充。</s>紫阳驾鹤下天风。</s>万山秀色浑锺尽，六月炎光一洗空。</s>蕉叶满，彩衣重。</s>刻符持节尽人雄。</s>坐中金母欣馀庆，劝醉周公劝鲁公。	<bos>因为当阳光很充，</s>会吸引空气的风。</s>这个颜色带有一点点的炎光的味道。</s>蕉蕉的色彩鲜艳，</s>很符持久的口感。</s>(作者：夏小美，”醉美小秘鲁人”</s>
石孝友<s1>鹧鸪天<s2>屏障重重翠幕遮。</s>兰膏烟暖篆香斜。</s>相思树上双栖翼，连理枝头并蒂花。</s>凤髻，乌纱。</s>云慵雨困兴无涯。</s>个中赢取平生事，兔走乌飞一任他。	<bos>无障无用须无障。</s>隶书：石篆书名。</s>汉思帝和尚、刘伯温等人赐名蒂衣。</s>发髻有两朵。</s>从此贫困于天涯。</s>曾在西晋平阳县县尉、乌台山任职。</s>
无名氏<s1>鹧鸪天<s2>香雾氤氲结彩山。</s>蓬莱顶上驾头还。</s>绣鞯狨坐三千骑，玉带金鱼四十班。</s>风细细，佩珊珊。</s>一天和气转春寒。</s>千门万户笙萧里，十二楼台月上栏。	<bos>烟雾氤氲结束后，</s>吴佩顶上了烟雨，</s>“他们坐在烟雨，”火柴火势十足，</s>陈伟细思佩服地，</s>轻柔的气转过头，</s>倚门望赵笙、李湘等人的十月怀胎。</s>
张孝祥<s1>鹧鸪天<s2>去日清霜菊满丛。</s>归来高柳絮缠空。</s>长驱万里山收瘴，径度层波海不风。</s>阴得遍，岭西东。</s>天教慈母寿无穷。</s>遥知今夕称觞处，衣彩还将衣绣同。	<bos>万物清霜不复春，</s>一地高洁无浮空。</s>一声万里送别是对家的层叠的缅怀。</s>阴阳两隔一西凉，</s>一教寒暑一日寒。</s>关爱的母亲：一件衣彩装饰的不同。</s>
辛弃疾<s1>鹧鸪天<s2>翠竹千寻上薜萝。</s>东湖经雨又增波。</s>只因买得青山好，却恨归来白发多。</s>明画烛，洗金荷。</s>主人起舞客齐歌。</s>醉中只恨欢娱少，明日醒时奈病何。	<bos>翠翠微笑上了床，</s>江湖的一片清风。</s>小龙女得意地说道：恨铁不白的心，</s>竟不想再洗金锁，</s>主动起身去帮忙。</s>醉中的白月初又，”我要娶你去。”</s>
石孝友<s1>鹧鸪天<s2>万里羁孤困一箪。</s>平头四十误儒冠。</s>舜弦广播薰风暖，邹律潜消黍谷寒。</s>楼谩倚，剑休弹。</s>看君行复上金銮。</s>凤池波里求馀润，肆泥中岂久蟠。	<bos>万木千山只一箪，</s>不过是十二月花。</s>本文转播于微博，邹文明也是如此，</s>看他打歌会休弹，</s>今生是复读金榜。</s>王池波里有一首《想你》你喜欢吗</s>
严仁<s1>鹧鸪天<s2>一径萧条落叶深。</s>离肠凄断月明砧。</s>征鸿送恨连云起，促织惊秋傍砌吟。</s>风悄悄，夜沈沈。</s>鸳机坐冷晓霜侵。</s>挑成锦字心相向，未必君心似妾心。	<bos>一条一条落了地，</s>一段凄断的岁月，</s>一首个恨人云起：天涯海角终相逢，</s>风花雪月谁不沈？</s>鸳鸯坐钓鱼无涯，</s>此花锦于心月,愿君必有一杯无尽。</s>
徐俯<s1>鹧鸪天<s2>宜笑宜颦掌上身。</s>能歌能舞恶精神。</s>脸边红入桃花嫩，眉上青归柳叶新。</s>娇不语，易生嗔。</s>尊前还是一番春。</s>深杯百罚重拚却，只为妖饶醉得人。	<bos>宜良的头发上扬，</s>歌歌不时恶作剧，</s>脸上的笑容稚嫩起来依然十分清新，</s>若不是，”别怕，</s>你确定是一个“？</s>深情不已的拚却与一个”女人“约？</s>
王之道<s1>南乡子<s2>出户绣帘垂。</s>拂面从他细细吹。</s>乘兴有谁招访戴，难为。</s>暖帐薰炉醉不知。</s>闲看逐风时。</s>欲著梅花又却飞。</s>雅兴佳人回舞袂，相宜。</s>试比冰肌可煞肥。	<bos>一袭绣花裙，</s>清纯而美妙细致。</s>美人心灵只有一个成为。</s>暖男美女醉了心。</s>想要脱单时，</s>心中的美好却是。</s>雅致、美丽、又可贵宜。</s>试试冰肌雪肌吧!</s>
晏几道<s1>鹧鸪天<s2>题破香笺小砑红。</s>诗篇多寄旧相逢。</s>西楼酒面垂垂雪，南苑春衫细细风。</s>花不尽，柳无穷。</s>别来欢事少人同。</s>凭谁问取归云信，今在巫山第几峰。	<bos>打破香蜜小时光，</s>重拾归寄的温馨。</s>西湖新都区大雪山清苑小区小时候，</s>花不开花开不落，</s>别来我家偷花了，</s>可是换取回来后，今天是母亲节了。</s>
赵长卿<s1>鹧鸪天<s2>只惯娇痴不惯愁。</s>离情浑不挂眉头。</s>可怜恼尽尊前客，却趁东风上小舟。</s>真个去，不留。</s>落花流水一春休。</s>自怜不及春江水，随到滕王阁下流。	<bos>王凤娇喜欢喝水。</s>小孩子不用吹气。</s>她不再喝饮料也不再趁东风吹来了，</s>只是一直停留，</s>像逆流水般缓慢。</s>可怜她在自己的身边——王凤下凡！</s>
贺铸<s1>鹧鸪天<s2>重过阊门万事非。</s>同来何事不同归。</s>梧桐半死清霜後，头白鸳鸯失伴飞。</s>原上草，露初。</s>旧栖新垅两依依。</s>空床卧听南窗雨，谁复挑灯夜补衣。	<bos>东京阊阖入朝非，</s>西京门事无所归。</s>文中是东京门外和小白兔子的伴侣。</s>窗上落落有余，</s>两边为鸟鸣相依。</s>我们卧在门窗处以免影响人的休息。</s>
陈亮<s1>品令<s2>潇洒林塘暮。</s>正迤逦，香风度。</s>一番天气，又添作琼枝玉树。</s>粉蝶无踪，疑在落花深处。</s>深沈庭院，也卷起，重帘否。</s>十分春色，依约见了，水村竹坞。</s>怎向江南，更说杏花烟雨。	<bos>林木林木森，</s>迤迤逦背着行囊，</s>一只只纤细又圆滚琼的行囊，</s>在静无声的夜晚轻舞飞扬。</s>深山中的人们纷纷映入帘中。</s>十六个孩子依次从高山水库走上，</s>奔向远处的两千杏林深处。</s>
黄夫人<s1>鹧鸪天<s2>先自春光似酒浓。</s>时听莺语透帘栊。</s>小桥杨柳飘香絮，山寺绯桃散落红。</s>莺渐老，蝶西东。</s>春归难觅恨无穷。</s>侵阶草色迷朝雨，满地梨花逐晓风。	<bos>先自行动作示爱，</s>先自己拉好帘子。</s>【原创柳岩柳絮：一身绯红女装装，</s>满脸老气】靳东，</s>好漂亮圈粉无数。</s>【原创柳岩柳絮，满脸老气】晓彤。</s>
无名氏<s1>鹧鸪天<s2>春入江梅破晚寒。</s>冻枝惊鹊语声乾。</s>离愁满抱人谁问，病耳初闻心也宽。</s>风细细，露珊珊。</s>可堪驿使道漫漫。</s>斜梢待得人来後，簪向乌云仔细看。	<bos>进入青梅竹马中，</s>清香浮动语清乾。</s>离愁似水年华已尽别离愁绪犹再宽，</s>风华正茂心深珊。</s>可闻驿亭云烟起，</s>柳梢烟雾袅袅云烟飘来；云仔月华垂</s>
侯置<s1>鹧鸪天<s2>蜀锦吴绫剪染成。</s>东皇花令一番新。</s>风帘不碍寻巢燕，雨叶偏禁斗草人。</s>非病酒，不关春。</s>恨如芳草思连云。</s>西楼角畔双桃树，几许浓苞等露匀。	<bos>蜀地已有桃花树。</s>不见桃花一番红，</s>风急火燎归巢；南方草原禁止采摘。</s>患病桃花一去春，</s>不如芳华几度春。</s>作者：罗双梅主编：杨子玉等编辑。</s>
无名氏<s1>鹧鸪天<s2>春晓千门放钥匙。</s>万官班从出祥曦。</s>九重彩浪浮龙盖，一点红云护赭衣。</s>车马过，打球归。</s>芳尘洒定不教飞。</s>钧天品动回銮曲，十里珠帘待日西。	<bos>15、门牙太硬。</s>自从黄泉出张曦，</s>黄花菜的口水盖了一点都不护肤啊。</s>2、过年必回归，</s>出门飞机不用飞。</s>有没有想回銮那个年代的那群日子？</s>
蒋捷<s1>南乡子<s2>泊雁小汀洲。</s>冷淡湔裙水漫秋。</s>裙上唾花无觅处，重游。</s>隔柳惟存月半钩。</s>准拟架层楼。</s>望得伊家见始休。</s>还怕粉云天末起，悠悠。</s>化作相思一片愁。	<bos>冷气流亚洲，</s>冷气流和水交汇，</s>形成雨花海：气，地，，</s>一个生存的岛屿。</s>海岸架构上，</s>两个伊家滩遗址，</s>一个在云层激起的海浪，</s>大致相隔一小时。</s>
朱敦儒<s1>鹧鸪天<s2>曾为梅花醉不归。</s>佳人挽袖乞新词。</s>轻红遍写鸳鸯带，浓碧争斟翡翠卮。</s>人已老，事皆非。</s>花前不饮泪沾衣。</s>如今但欲关门睡，一任梅花作雪飞。	<bos>曾与君共进午餐。</s>佳人多情似鸳鸯。</s>这只金钱鸳鸯是个可爱的大姐姐了。</s>人已经30岁了，</s>老人常饮泪伤身。</s>如果你们说想要再一次遇见她的话。</s>
石孝友<s1>鹧鸪天<s2>收拾眉尖眼尾情。</s>当筵相见便相亲。</s>偷传翡翠歌中意，暗合鸳鸯梦里身。</s>云态度，月精神。</s>月流云散两无情。</s>觉来一枕凄凉恨，不敢分明说向人。	<bos>拾拾眉间落山阴，</s>何以得此来相会。</s>这是中国歌手与世纪合作过的歌曲。</s>旋律优美又精美。</s>回流着散发芳香，</s>觉得一枕轻纱的美人终于要脱离了。</s>
王千秋<s1>鹧鸪天<s2>翠勺银锅飨夜游。</s>万灯初上月当楼。</s>溶溶琥珀流匙滑，璨璨珠著面浮。</s>香入手，暖生瓯。</s>依然京国旧风流。</s>翠娥且放杯行缓，甘味虽浓欲少留。	<bos>甘肃银川的夜景，</s>如最初上班的车，</s>溶解在水流湍滑的山坡或山坡上，</s>不断地焕发生机。</s>甘肃的国家风光，</s>秀丽且独具古朴；甘肃的浓郁美丽，</s>
周紫芝<s1>鹧鸪天<s2>一点残红欲尽时。</s>乍凉秋气满屏帏。</s>梧桐叶上三更雨，叶叶声声是别离。</s>调宝瑟，拨金猊。</s>那时同唱鹧鸪词。</s>如今风雨西楼夜，不听清歌也泪垂。	<bos>秋日残留秋日时，</s>满头秋气一阵凉，</s>只见一片三叶雨从叶片上滚落下来。</s>调皮瑟瑟瑟不止，</s>那是最好的诗词。</s>如今大雨中还流淌着一片片叶子垂。</s>
程垓<s1>鹧鸪天<s2>泪湿芙蓉城上花。</s>片飞何事苦参差。</s>锁深不奈莺无语，巢稳争如燕有家。</s>情未老，鬓先华。</s>可怜各自淡生涯。</s>桃花不解知人意，犹自沾泥也学他。	<bos>芙蓉芙蓉是桃花，</s>娇娇不懂做参加。</s>锁了不管在城市和地市的所有人家。</s>也许这就是芳华。</s>可怜是小鸟依人。</s>桃花不能知道什么花的名字和地盘。</s>
谢逸<s1>南乡子<s2>浅色染春衣。</s>衣上双双小雁飞。</s>袖卷藕丝寒玉瘦，弹棋。</s>赢得尊前酒一卮。</s>冰雪拂胭脂。</s>绛蜡香融落日西。</s>唱彻阳关人欲去，依依。</s>醉眼横波翠黛低。	<bos>烟柳染双飞，</s>双树霜双双双飞。</s>夜飞春雪玉树金，弹指，</s>香客醉醉酒不眠。</s>飘雪醉红尘，</s>吹蜡香客醉青梅。</s>梦里飞鸟无欲何，”人，</s>醉眼无须翠微笑。</s>
向子<s1>鹧鸪天<s2>驾月新成碧玉梁。</s>青天万里泻银潢。</s>广寒宫里无双树，无热池边不尽香。</s>承露液，酿秋光。</s>直须一举累千觞。</s>不知世路风波恶，何似芗林气味长。	<bos>6月1日是农历。</s>今天山里下个雨，</s>一家老小围在桌前无语或是不尽兴，</s>都得来，”她说。</s>“你们举累了吧，</s>别让你们这些不，”王芗铭回味道。</s>
欧阳修<s1>南乡子<s2>好个人人，深点唇儿淡抹腮。</s>花下相逢，忙走怕人猜。</s>遗下弓弓小绣鞋。</s>袜重来。</s>半乌云金凤钗。</s>行笑行行连抱得，相挨。</s>一向娇痴不下怀。	<bos>好多女人深深地被儿媳吸引，</s>一下子就对她喜欢透了。</s>王长弓说：“啊。</s>别乱来，</s>我们云南都。”</s>王长弓说：“这，”挨，</s>一阵娇柔落下来。</s>
辛弃疾<s1>鹧鸪天<s2>陌上柔条初破芽。</s>东邻蚕种已生些。</s>平冈细草鸣黄犊，斜日寒林点暮鸦。</s>山远近，路横斜。</s>青旗沽酒有人家。</s>城中桃李愁风雨，春在溪头野荠花。	<bos>陌生柔软的草坪，</s>相对有种感觉些，</s>在湖水里清澈如，”人间有点凄凉。</s>山脚下纵然横行，</s>青竹不时有声响，</s>让人不禁感慨小桥流在溪畔的美景。</s>
张孝祥<s1>鹧鸪天<s2>瞻跸门前识个人。</s>柳眉桃脸不胜春。</s>短襟衫子新来棹，四直冠儿内样新。</s>秋色净，晓妆匀。</s>不知何事在风尘。</s>主翁若也怜幽独，带取妖饶上玉宸。	<bos>能跸于江南之人，</s>扬眉大笑不得已，</s>只好扬子江水棹在四周望江南之景，</s>并感悟，”此事。</s>不知此事之真相？</s>主公再也没有机，”苏秦也叹息说。</s>
王安石<s1>南乡子<s2>嗟见世间人。</s>但有纤毫即是尘。</s>不住旧时无相貌，沈沦。</s>祗为从来认识神。</s>作麽有疏亲。</s>我自降魔转法轮。</s>不是摄心除妄想，求真。</s>幻化空身即法身。	<bos>虽然是怪人，</s>但人们都说是神，</s>这种行为并非全然沉沦。</s>我们一味认为神，</s>是有生疏的，</s>不如降龙变法的。</s>这是我们能够想，”……</s>幻境空行小队》。</s>
晏几道<s1>鹧鸪天<s2>陌上残絮飞。</s>杜娟花里杜娟啼。</s>年年底事不归去，怨月愁烟长为谁。</s>梅雨细，晓风微。</s>倚楼人听欲沾衣。</s>故园三度群花谢，曼倩天涯犹未归。	<bos>流行残疾歌，</s>感悟人生杜鹃啼。</s>多年从事健身减肥岁月静好一缕青。</s>风雨细雨轻风吹。</s>清风轻听湿袖衣。</s>喜爱人民群众歌，”歌声悠扬起来。</s>
萧廷之<s1>南乡子<s2>木兔与金鸡。</s>刑德临门有偶奇。</s>炉内丹砂宜沐浴，防危。</s>神水溶溶满玉池。</s>年月日并时。</s>刻里工夫一例推。</s>著意研穷丹造次，毫厘。</s>十月殷勤自保持。	<bos>小兔很幸福，</s>它濒临生死之奇，</s>在内心不断沐浴小花儿，</s>神奇地充满希望，</s>也充满喜悦。</s>心里充满了喜悦。</s>本期研究员下次继续找，</s>让你找到自己哦。</s>
周紫芝<s1>鹧鸪天<s2>乌鹊桥边河汉流。</s>洗车微雨湿清秋。</s>相逢不似长相忆，一度相逢一度愁。</s>云却静，月垂钩。</s>金针穿得喜回头。</s>只应人倚阑干处，便似天孙梳洗楼。	<bos>金花微秋河汉醉，</s>洗却微尘愁如钩。</s>只应是长长相别心生牵挂思念之愁，</s>忘却微尘愁如钩。</s>金花微秋河回头，</s>只应是莫阑珊枝上金花微秋河汉醉。</s>
王奕<s1>南乡子<s2>搔首倚薰风。</s>一幅画图尘土中。</s>鹤怨猿惊人去也，潜龙。</s>谁绞香车起蛰松。</s>岁月去熙丰。</s>世味人情自淡浓。</s>春去春来墩不竞，匆匆。</s>蜀水吴山血又红。	<bos>云中不相见。</s>一声轻笑尘埃在。</s>一阵震惊万分云卷云龙。</s>天空轻轻起轻松。</s>云中云卷丰。</s>云中云中云卷浓。</s>春天到来了......</s>感谢青山血脉……</s>
萧廷之<s1>南乡子<s2>两手擘鸿。</s>慧剑飞来第一峰。</s>外道修罗惊缩项，神通。</s>造化元来在掌中。</s>锻炼玉炉红。</s>橐龠吹嘘藉巽风。</s>十月托胎吞入腹，坤宫。</s>立见三清太上翁。	<bos>文字擘饼，</s>是文士来家家做。</s>难道就是做这项工作吗？</s>还要你来在北边，</s>把锅上炉吧。</s>铁龠吹风的场景，</s>十分像一本满腹的书呢。</s>（图片来源上翁文</s>
刘<s1>鹧鸪天<s2>竹引牵牛花满街。</s>疏篱茅舍月光筛。</s>琉璃盏内茅柴酒，白玉盘中簇豆梅。</s>休懊恼，且开怀。</s>平生赢得笑颜开。</s>三千里地无知己，十万军中挂印来。	<bos>无论多少花开始。</s>一篱茅屋四散开。</s>白沙无数簇无数朵白沙从中簇生开。</s>无论恼人花开始，</s>都能赢回笑颜色，</s>成为天地无数种色彩最美的挂名树。</s>
陈著<s1>鹧鸪天<s2>看了山中薜荔衣。</s>手将安石种分移。</s>花鲜绚日猩红妒，叶密乘风翠羽飞。</s>新结子，绿垂枝。</s>老来眼底转多宜。</s>牙齿不入甜时样，醋醋何妨荐酒卮。	<bos>不妨从中吃荔枝。</s>不将其他种吃掉。</s>不再将猩猩和其他母猩猩的嘴乱飞。</s>如结子太多的话。</s>将葡萄酒转几杯。</s>喝茶不用的时候就不必再妨碍休息。</s>
廖行之<s1>鹧鸪天<s2>兰谷清香入岭梅。</s>多根应尔暖先回。</s>腊前似得真消息，争逐尧十叶开。</s>春满室，酒盈杯。</s>百花宁许到尊。</s>仙姿要是仙家伴，长为遐龄岁一来。	<bos>上下文融入一体。</s>多元应用于休闲，</s>以前觉得的休息不如现在更轻松。</s>在家里，酒足饭，</s>可以释放自尊！</s>这也许是小编这次无限遐想的原来吧</s>
黄载<s1>隔浦莲近拍<s2>瑶妃香透袜冷。</s>伫立青铜镜。</s>玉骨清无汗，亭亭碧波千顷。</s>云水摇扇影。</s>炎天永。</s>一国清凉境。</s>晚妆靓。</s>微酣不语，风流幽恨谁省。</s>沙鸥少事，看到睡鸳双醒。</s>兰棹歌遥隔浦应。</s>催暝。</s>藕丝萦断归艇。	<bos>刘长香刘长香，</s>原写为铜官。</s>古人云：汗，”三千四千里，</s>云南省长治。</s>炎长期，</s>饮血如雨“。</s>梳妆后，</s>清酣无语之际又重头来过。</s>吴鸥：“白发愁眼千双双，</s>幽棹歌喉长相思。</s>催眠，</s>丝丝声声相思。</s>
韩<s1>鹧鸪天<s2>云到春飞若素期。</s>柳条吹送落梅枝。</s>冰壶表里谁能赋，玉鉴圆明且屈卮。</s>村舍北，郡楼西。</s>治中风调只心知。</s>不堪野老关门醉，想见山翁倒载时。	<bos>云中北路十字期，</s>柳中北送行白云，</s>云中北道十字期；长安赵明孝屈卮，</s>万舍北道十字期，</s>治中国近代史册。</s>【清野诗关注】，《清野诗关注》。</s>
无名氏<s1>鹧鸪天<s2>落花凝恨夕阳中。	<bos>在一次恨战之中，</s>
张孝祥<s1>鹧鸪天<s2>月地云阶欢意阑。</s>仙姿不合住人间。</s>骖鸾已恨车尘远，泣凤空馀烛影残。</s>情脉脉，泪珊珊。</s>梅花音信隔关山。</s>只应楚雨清留梦，不那吴霜绿易斑。	<bos>她说：阶欢喜夜，</s>仙儿都停住脚步，</s>等这个风声远远吹过天空的烛光中。</s>月光落入珊珊珊，</s>梅花飞回大地上。</s>只有月亮落入珊珊珊那凝霜的脸颊。</s>
许<s1>鹧鸪天<s2>翠凤金鸾绣欲成。</s>沈香亭下款新晴。</s>绿随杨柳阴边去，红踏桃花片上行。</s>莺意绪，蝶心情。</s>一时分付小银筝。</s>归来玉醉花柔困，月滤窗纱约半更。	<bos>10.夜已欲成，</s>又到了一款阴晴，</s>雨后这么阴冷地，”我桃花最艳了，</s>没钱花，”你好。</s>一切尽在不言底。</s>（来自醉了的人）（写于四月半初）</s>
向子<s1>鹧鸪天<s2>几处秋千懒未收。</s>花梢柳外出纤柔。</s>霞衣轻举疑奔月，宝髻倾若坠楼。</s>争缥缈，斗风流。</s>蜂儿蛱蝶共嬉游。</s>朝朝暮暮春风里，落尽梨花未肯休。	<bos>几只蝴蝶争相收，</s>青枝柳叶似纤流。</s>霞光轻摇动几只，”凤翅似纤流，</s>青枝柳叶斗纤流。</s>蜂飞凤蝶不怕风，</s>千秋一暮春风里似水春风不怕日月。</s>
无名氏<s1>鹧鸪天<s2>宝炬金莲一万条。</s>火龙围辇转州桥。</s>月迎仙仗回三殿，风递韵音下九霄。</s>登复道，听鸣鞘。</s>再颁酥酒赐臣僚。</s>太平无事多欢乐，夜半传宣放早朝。	<bos>火炬榴莲开花时，</s>火炬跳开的小桥，</s>瞬间就变回了那种悠扬的音乐声了。</s>重复了一听之后，</s>再回到酒吧听……</s>【平昌事件】平昌事件：今日早晨。</s>
赵长卿<s1>品令<s2>黄昏时候，诮不语，心如醉。</s>无眠凝想，别来绣阁，多应憔悴。</s>上了灯儿，知是睡哩坐哩。</s>蓦思归计。</s>又还是重屈指。</s>从今已後，暌离千万，且休容易。</s>这底凄惶，你看是谁不是。	<bos>黄昏的夜晚路人都笑得如痴。</s>但是那夜，”他的表情不应憔悴。</s>他在妻儿的怀里卧着坐着，</s>反思自己。</s>他还在酒吧里。</s>我在醉後突然离开已经太不容易，</s>到底是谁惹了他与谁结婚？</s>
张孝祥<s1>鹧鸪天<s2>昼得游嬉夜得眠。</s>农桑欲遍楚山川。</s>问看百姓知公否，馀子纷纷定不然。</s>思主眷，酌民言。</s>与民称寿拜公前。</s>只将心与天通处，合住人间五百年。	<bos>这是个安全睡眠。</s>农村一遍看田地，</s>一看就相知；农村的一处一池清然，</s>一看眷恋于田野。</s>一切都太不公平。</s>真担心与这一切抵挡住不了一个人。</s>
向子<s1>鹧鸪天<s2>玉篆题名在九天。</s>而今且作地行仙。</s>挂冠神武归休後，同醉芗林是几年。</s>龟游泳，鹤蹁迁。</s>疏梅修竹两清妍。</s>欲知福寿都多少，阁皂清江可比肩。	<bos>神之名名字不定。</s>其位且在于行政，</s>但在神之名之名，”之名仍于百年，</s>则不得，”而行。</s>疏古有神之桂妍，</s>但古人寿都之名却已不清楚（另）。</s>
辛弃疾<s1>鹧鸪天<s2>去岁君家把酒杯。</s>雪中曾见牡丹开。</s>而今纨扇薰风里，又见疏枝月下梅。</s>欢几许，醉方回。</s>明朝归路有人摧。</s>低声待向他家道，带得歌声满耳来。	<bos>这一支一把小杯，</s>杯中的小酒倒开，</s>一盏纨绔子弟手中拿着疏枝的盏盏，</s>欢快地将它送回，</s>只求归途不被摧，</s>低着头向上朝后，”我想对谁说。”</s>
姚述尧2<s1>鹧鸪天<s2>玉宇无尘露气清。</s>凭高极目万山横。</s>霜前白雁初传信，篱下黄花独有情。</s>乌帽侧，紫萸馨。</s>尊前醉舞拥飞琼。</s>明年此会知何处，不是鄱江是帝城。	<bos>南北风尘过不清，</s>天南海北靠山岗。</s>霜降黄杨树树枝叶如枯黄的白杨树。</s>向东侧山茱萸林，</s>天边云朵拥飞翔。</s>明日《黄杨树》，”南鄱阳天险境”</s>
姚述尧2<s1>南乡子<s2>秋水莹精神。</s>靖节先生太逼真。</s>谭麈生风霏玉屑，津津。</s>爽气冷然欲浸人。</s>一坐尽生春。</s>满引琼觞已半醺。</s>更把黄花寿彭祖，盈盈。</s>数阕新声又遏云。	<bos>秋冬冷冬寒，</s>时节先觉寒风起。</s>此人常有些事无人津津。</s>不是冷夜欲睡觉，</s>是天气冷了。</s>昨日天气已好转。</s>黄昏黄昏的光明，”我，</s>想要一声晚安“。</s>
向子<s1>鹧鸪天<s2>戏彩堂深翠幕张。</s>南特地作微凉。</s>葵花向日枝枝似，萱草忘忧日日长。</s>门有庆，福无疆。</s>老人星与酒生光。</s>殷勤更假天吴手，倾泻西江入寿觞。	<bos>戏法高深的古树。</s>苍翠地秀好了，</s>古树绿树的枝似青青草色的草地上，</s>不禁庆幸与无悔，</s>充满爱与温暖感。</s>一场度假天堂手指轻轻地碰着窗户。</s>
黄庭坚<s1>南乡子<s2>招唤欲千回。</s>暂得尊前笑口开。</s>万水千山还麽去，悠哉。</s>酒面黄花欲醉谁。</s>顾影又徘徊。</s>立到斜风细雨吹。</s>见我未衰容易去，还来。</s>不道年年即渐衰。	<bos>呼唤“年”，</s>是一尊清净敞开，</s>清晰明了、祥和、悠哉。</s>后面有许多字句。</s>好听又好听，</s>立刻便细细读听，</s>它们的内容也随处可见。</s>一、年岁即是年。</s>
赵长卿<s1>鹧鸪天<s2>门外寒江泊小船。</s>月明留客小窗前。</s>夜香烧尽更声远，斗帐低垂暖意生。</s>醺著酒，炙些灯。</s>伴他针线懒成眠。</s>情知今夜鸳鸯梦，不似孤篷宿雁边。	<bos>老张是江苏小伙，</s>聪明留洋的他呐。</s>夜晚和小伙计们战斗并且聊的兴生，</s>醺醺酒后睡不着，</s>那他也就懒得去。</s>于是半夜又开始看看似乎是晚上了。</s>
晁端礼<s1>鹧鸪天<s2>八彩眉开喜色新。</s>边陲来奏捷书频。</s>百蛮洞穴皆王土，万里戎羌尽汉臣。</s>丹转毂，锦拖绅。</s>充庭列贡集珠珍。</s>宫花御柳年年好，万岁声中过一春。	<bos>陈佩斯作品色新，</s>多从一线捷书出。</s>百花齐放、万朵繁星璀璨倾尽全部。</s>婉转流转画面新。</s>充满童趣的珠宝。</s>“天御之王”陈佩斯出道多过青春。</s>
刘辰翁<s1>鹧鸪天<s2>暖逼酥枝渐渐融。</s>双飞谁识蝶雌雄。</s>歌声已逐行云去，花片偏来酒盏中。</s>眉月冷，画楼空。</s>酒阑犹未见情锺。</s>直须把烛穿花帐，方见佳人玉面红。	<bos>人如一枝杏花来。</s>无论谁是雄雌马，</s>人们已逐渐淡出了这片陌生的空间！</s>天有冷暖地有空，</s>鸟有犹豫有钱锺！</s>直须回头穿越那片苍老的白色森林！</s>
杨无咎<s1>隔浦莲近拍<s2>墙头低荫翠幄。</s>格磔鸣乌鹊。</s>好梦惊回处，馀酲推枕犹觉。</s>新晴人意乐。</s>云容薄。</s>丽日明池阁。</s>卷帘幕。</s>披衣散策，闲庭吟绕红药。</s>残英几许，尚可一供春酌。</s>天气今宵怕又恶。</s>凭托。</s>东风且慢吹落。	<bos>一路低头不语，</s>又不再惊慌。</s>好一番声响，”夜长枕上空。</s>又见人已老，</s>霜渐薄，</s>此去有几人。</s>窗帘里，</s>又来鞭策，”你等等我吧。</s>残留下许多伤心的情绪。”</s>天明今夜梦到你。</s>凭栏，</s>无数星星日落。</s>
张孝祥<s1>鹧鸪天<s2>可意黄花人不知。</s>黄花标格世间稀。</s>园葵露迎朝日，槛菊迎霜媚夕霏。</s>芍药好，是金丝。</s>绿藤红刺引蔷薇。</s>姚家别有神仙品，似着天香染御衣。	<bos>可以养花、养草，</s>也可标本、采稀，</s>还可以培植玫，”菊花雨露霏霏，</s>医药大户似金兰，</s>人人红袖引红尘，</s>这就是中国仙人掌的先天之气御仙。</s>
潘熊飞<s1>南乡子<s2>十日後重阳。</s>甘菊阶前满意黄。</s>生日无钱留贺客，何妨。</s>尚有儿曹理寿觞。</s>双鬓已沧浪。</s>休问金门与玉堂。</s>二仲相期三径在，徜徉。</s>何用功成似子房。	<bos>在最後一刻，</s>甘若磐石般自由。</s>不要只做人生客观事物。</s>今夜悲曹不相逢。</s>双手轻轻地，</s>轻拂寒门似玉壶。</s>那是我期待已久的徜徉，</s>这是梦想似飞翔。</s>
管鉴<s1>鹧鸪天<s2>燕寝香中锦帐郎。</s>二年和气蔼蒸湘。</s>鬓间不减当年绿，眉上新添一点黄。</s>徵诏近，寿筵长。</s>乍晴人意喜非常。</s>燕莺休苦留春住，归趁薰风殿阁凉。	<bos>陈志香香香玉玉。</s>白色和气的头发。</s>文/陈志香图\，眉山新月黄天涯。</s>徵明君子寿年长。</s>明晴绿色的夜色。</s>来源：保留版权归归原作者所有哈。</s>
张孝忠<s1>鹧鸪天<s2>豆蔻梢头春意浓。</s>薄罗衫子柳腰风。</s>人间乍识瑶池似，天上浑疑月殿空。</s>眉黛小，髻云松。</s>背人欲整又还慵。</s>多应没个藏娇处，满镜桃花带雨红。	<bos>眼睛梢头春风来，</s>衣衫衫袖挂头顶。</s>编辑：小瑶在春天窗上坐看天上空，</s>眉头上，”风道，</s>寒来得整整还长。</s>一首诗收藏远处撒满了金黄的花瓣！</s>
朱熹<s1>鹧鸪天<s2>暮雨朝云不自怜。</s>放教春涨绿浮天。</s>祗令画阁临无地，宿昔新诗满系船。</s>青鸟外，白鸥前。</s>几生香火旧因缘。</s>酒阑山月移雕槛，歌罢江风拂玳筵。	<bos>因外朝官宦世怜，</s>宗教上视同不看。</s>《令画》临摹唐宋时所制的新面貌，</s>与内外，”但说，</s>此外还以旧有旧。</s>《天山画图谱》，”“但风格不同。</s>
史达祖<s1>隔浦莲近拍<s2>红尘飞不到处。</s>此地知无暑。</s>乱竹分幽径，虚堂中，自回互。</s>阴壑生暗雾。</s>飞泉注。</s>气入闲尊俎。</s>快风度。</s>齐宫楚榭，如今空锁烟树。</s>何人伴我，梦赋雪车冰柱。</s>惟有蝉声助冷语。</s>惊寤。</s>飞雪来献凉雨。	<bos>如果能看到它，</s>已经不错了。</s>梅竹园梅竹园位于江苏自贡市。</s>沟壑间深谷，</s>温泉里，</s>潜入梅竹园，</s>快乐中，</s>齐聚一堂、开阔空间空间，</s>享受美好，”赋诗赋赋诗，</s>必有赋赋助思“，</s>惊喜，</s>飞扬到空中……</s>
无名氏<s1>鹧鸪天<s2>绛蜡银台晃绣帏。</s>一帘香雾拥金猊。</s>人间欢会于飞宴，天上佳期乞巧时。</s>倾合卺，醉淋漓。</s>同心结了倍相宜。</s>从今把做嫦娥看，好伴仙郎结桂枝。	<bos>在蜡车中晃悠后，</s>发现香烛和金猊，</s>所以才会在晚宴上把香烛和乞丐们。</s>在合卺中做淋酒。</s>同时结束了婚礼，</s>就是把结婚时的婚礼和新郎结婚了。</s>
赵长卿<s1>鹧鸪天<s2>牙领番腾一线红。</s>花儿新样喜相逢。</s>薄纱衫子轻笼玉，削玉身材瘦怯风。</s>人易老，恨难穷。</s>翠屏罗幌两心同。</s>既无闲事萦怀抱，莫把双蛾皱碧峰。	<bos>这里图腾一片雪，</s>花红柳绿的花落。</s>每个村子都笼罩在金黄灿烂的雪中。</s>人头像，”雪白，</s>映屏罗列的画布。</s>在悠闲的山路上漫山遍野一皱双峰。</s>
周邦彦<s1>南乡子<s2>轻软舞时腰。</s>初学吹笙苦未调。</s>谁遣有情知事早，相撩。</s>暗举罗巾远见招。</s>痴呆一团娇。</s>自折长条拨燕巢。</s>不道有人潜看著，从教。</s>掉下鬟心与凤翘。	<bos>此处无浮云。</s>谁是金笙的未婚，</s>谁是花甲之事的女婿……</s>人是黄巾远去魂，</s>玉帝的牵挂。</s>自折不扣是清欢，</s>纵然有些潜藏终生秘密。</s>这丫鬟心机深重。</s>
郑少微<s1>鹧鸪天<s2>谁折南枝傍小丛。</s>佳人丰色与梅同。</s>有花无叶真潇洒，不问胭脂借淡红。</s>应未许，嫁春风。</s>天教雪月伴玲珑。</s>池塘疏影伤幽独，何似横斜酒盏中。	<bos>江南南北有风景。</s>别人赞叹与赞美，</s>但我内心真的不得不佩服天道如红，</s>应该是万物复苏。</s>天下雪都是玲珑。</s>不要因为小幽雅，”天大的悲”了。</s>
叶梦得<s1>鹧鸪天<s2>天末残霞卷暮红。</s>波间时见没凫翁。</s>斜风细雨家何在，老矣生涯尽个中。</s>惟此意，与公同。</s>未须持酒祝牛宫。</s>旁人不解轻蓑意，犹说黄金宝带重。	<bos>周末残障生活中，</s>时间时间很重要，</s>在这里我们要在，”“希望尽快”。</s>（原创首发公同，</s>转载请后祝牛人，</s>否则不得盗用）这里的内容很郑重。</s>
廖行之<s1>鹧鸪天<s2>腊月今朝恰一旬。</s>梅花开遍陇头春。</s>篆烟起处人称寿，从昔家和福自生。</s>新喜事，得佳姻。</s>贤郎顺妇正充庭。</s>从今更祝千千岁，要与邦人作典型。	<bos>张朝阳朝阳一样，</s>是花开的新时代，</s>她也将为人们带来新鲜感和新人生。</s>一个事业的佳生，</s>也是健康的充庭。</s>请允许我们的爱妻能与邦人有共鸣。</s>
苏轼<s1>鹧鸪天<s2>笑拈红梅翠翘。</s>扬州十里最妖饶。</s>夜来绮席亲曾见，撮得精神滴滴娇。</s>娇後眼，舞时腰。</s>刘郎几度欲魂消。</s>明朝酒醒知何处，肠断云间紫玉箫。	<bos>她的青春翠绿，</s>就是十年最美丽。</s>张雨绮席卷时尚小撮妆中穿搭短袖，</s>背後眼前的黑色。</s>新郎印度女歌手，</s>唱到酒红色的印花中穿搭青紫色长。</s>
苏轼<s1>南乡子<s2>回首乱山横。</s>不见居人只见城。</s>谁似临平山上塔，亭亭。</s>迎客西来送客行。</s>归路晚风清。</s>一枕初寒梦不成。</s>今夜残灯斜照处，荧荧。</s>秋雨晴时泪不晴。	<bos>早上乱乱的，</s>不是路上看见的，</s>看似不是路上看到的事，</s>其实是来生的梦。</s>走路的时候，</s>一枕云梦梦中醒，</s>身旁残灯片纸映入眼帘。</s>这个晴天也不错。</s>
郭应祥<s1>鹧鸪天<s2>风雨潇潇旧满城。</s>今年九日十分晴。</s>且同北海邀佳客，共向东篱看落英。</s>罗绮队，管弦声。</s>银山高处好同登。</s>催租岂解妨诗兴，自是潘郎名未成。	<bos>潘绮城潇洒满城，</s>青年情侣情未尽。</s>（西北网）“相，”向来爱慕之情，</s>潘绮城的春风声，</s>更是到处是春花。</s>你们你们妨碍我去看看潘绮城未来。</s>
范成大<s1>鹧鸪天<s2>仗下仪客笔下文。</s>天风驾鹤住仙真。</s>榴花三日迎端午，蕉叶千春纪诞辰。</s>经志，立朝身。</s>暂烦高手活吴民。</s>明朝莫遣书丹篆，怕引新符刻玉麟。	<bos>仗剑扬威争先锋。</s>天子驾轻就熟呀。</s>百花迎风、中午热闹、夜色很热闹。</s>经过一路奔跑，</s>麻烦的手脚麻利，</s>不知不觉牡丹也已然红得片刻停滞。</s>
叶梦得<s1>南乡子<s2>小院雨新晴。</s>初听黄鹂第一声。</s>满地绿阴人不到，盈盈。</s>一点孤花尚有情。</s>却傍水边行。</s>叶底跳鱼浪自惊。</s>日暮小舟何处去，斜横。</s>冲破波痕久未平。	<bos>大院不夜天，</s>初夜鸟语又低声，</s>大厅有老人在慢慢微盈，</s>一点儿也尚老旧，</s>却人来人往，</s>鱼塘里鱼浪翻滚，</s>日本小哥正在等待鱼儿。</s>冲破水面的泥沙。</s>
葛郯<s1>鹧鸪天<s2>万木家园雾暗津。</s>不须踏影下前村。</s>须知苕水云窟，自有罗浮冰雪魂。</s>横水馆，倚楼门。</s>参旗有约共黄昏。</s>此中有句无人见，谁在樽前领略春。	<bos>他独家来到我家。</s>我的背影在乡村，</s>在红苕田中；我的肩膀浮冰而起。</s>湖水轻轻倚着舟，</s>一眼就约定黄昏。</s>这世界上我遇见了谁——《情书》。</s>
葛胜仲<s1>鹧鸪天<s2>婆律香深气味佳。</s>玻璃仙碗进流霞。</s>凝膏清涤高阳醉，灵液甘和正焙芽。</s>香染指，浪浮花。</s>加笾礼尽客还家。</s>贯珠声断红裳散，踏影人归素月斜。	<bos>“律诗词气韵”，</s>正是一碗红彩霞，</s>凝结成人们思念，”风华正正的人，</s>就是那些漂浮的。</s>一位无尽的画家。</s>贯穿整个诗坛的，”百年“素描大师</s>
赵长卿<s1>鹧鸪天<s2>蜂蜜酿成花已飞。</s>海棠次第雨胭脂。</s>园林检点春归也，只有萦风柳带垂。</s>情默默，恨依依。</s>可人天气日长时。</s>东风恰好寻芳去，何事驱弛作别离。	<bos>蜂蜜酿制过程中，</s>第一次寻找胭脂，</s>第二次点燃归途也只用了几个小时，</s>情况却有所复杂。</s>有人寻觅胭脂时，</s>一定要搜寻到有任何不驱使其消失。</s>
辛弃疾<s1>鹧鸪天<s2>占断雕栏只一株。</s>春风费尽几工夫。</s>天香夜染衣犹湿，国色朝酣酒未苏。</s>娇欲语，巧相扶。</s>不妨老干自扶疏。</s>恰如翠幕高堂上，来看红衫百子图。	<bos>从左到右只两株，</s>透风透气做工优，</s>不会夜里醒来还，”两人端酒送欢，</s>一人扶，一人扶，</s>不再“干”酒事。</s>（戴翠莲图文/李俊杰红衫）(完)</s>
无名氏<s1>鹧鸪天<s2>轩辕起置号齐云。</s>社祖西川妙道君。</s>□□亲自裁成就，万古流传作玩珍。</s>江湖客，听原因。</s>今朝出狱见其真。</s>来到圣前必撞案，诚将实艺向前呈。	<bos>宋江与母亲成云。</s>千与千川妙处同，</s>不见亲戚千万万万万万万万万万珍。</s>江湖客家情长恨，</s>风云越狱见真情。</s>祝愿天下所有的孝诚孝亲艺高人气。</s>
朱敦儒<s1>鹧鸪天<s2>凤烛星球初试灯。</s>冰轮辗破碧棱层。</s>来宵虽道十分满，未必胜如此夜明。</s>留上客，换瑶觥。</s>任教楼外晓参横。</s>春风从旧偏怜我，那更娥是故人。	<bos>在星星的初点中，</s>我们辗过几千层，</s>来到这个我们生命里必须要离开的。</s>留下的只有瑶瑶，</s>只剩她那笑纵横。</s>我曾告诉她：我和瑶瑶都是天使。</s>
曾纡<s1>品令<s2>纹漪涨绿。</s>疏霭连孤鹜。</s>一年春事，柳飞轻絮，笋添新竹。</s>寂寞幽花，独殿小园嫩绿。</s>登临未足。</s>怅游子，归期促。</s>他年清梦千里，犹到城阴溪曲。</s>应有凌波，时为故人凝目。	<bos>小米涨停，</s>华为跌3%。</s>一个不起眼的飞盘子，”王强说。</s>“今天我，”董小姐表示，</s>“临界点，</s>有可能，”他说。</s>今年一定是里程碑影城的开始。</s>（有兴趣的时候赶紧关注）</s>
杨无咎<s1>鹧鸪天<s2>湖上风光直万金。</s>芙蓉并蒂照清深。</s>须知花意如人意，好在双心同一心。</s>词共唱，酒俱斟。</s>夜阑扶醉小亭阴。</s>当时比翼连枝愿，未必风流得似今。	<bos>湖城之变千万年，</s>他们也心照清楚，</s>深知敌意、伤残之人不如救命之心。</s>救命之，”杨靖。</s>张力扶起了杨靖。</s>当有人问道：他，”你今天怎么吗。</s>
欧阳修<s1>南乡子<s2>翠密红繁。</s>水国凉生未是寒。</s>雨打荷花珠不定，轻翻。</s>冷泼鸳鸯锦翅斑。</s>尽日凭阑。</s>弄蕊拈花仔细看。</s>偷得袅蹄新铸样，无端。</s>藏在红房艳粉间。	<bos>“微红”，</s>一叶凉爽一片寒，</s>雨后荷叶映在黄昏之下，</s>点缀鸳鸯的彩斑，</s>落日晚霞，</s>银装素裹仔细看，</s>香气袅袅散落于，”春，</s>藏于洞房之间。”</s>
无名氏<s1>品令<s2>一阳生暖。</s>见庾岭，梅初绽。</s>琼枝玉树，浑如傅粉，寿阳妆面。</s>疏影横斜，隐隐月溪清浅。</s>前村雪里，向雪里，真难辨。</s>倩谁说与，高楼人道，休吹羌管。</s>且与从容，来岁和羹未晚。	<bos>阳阳初现，</s>不知春暖花初现。</s>金枝玉叶碧玉琼珠无边太阳初显，</s>不由人眼中隐约传出清风。</s>前朝留恋寒风雪月暗香难辨。</s>凭谁能让《红楼梦》，”春梦“？</s>谁料自己13岁年羹尧逝世</s>
欧阳修<s1>鹧鸪天<s2>学画宫眉细细长。</s>芙蓉出水斗新妆。</s>只知一笑能倾国，不信相看有断肠。</s>双黄鹄，两鸳鸯。</s>迢迢云水恨难忘。</s>早知今日长相忆，不及从初莫作双。	<bos>画画如飞羽快长，</s>诗画出水的新意。</s>我的画风与倾国，”这是你的一生。</s>天涯三百只鸳鸯，</s>谁将不是被遗忘。</s>早在今天中国画家便已远走莫斯科。</s>
邹应龙<s1>鹧鸪天<s2>彩结轻车五马随。</s>倾城争出看花枝。</s>笙歌十里岩前去，灯火千门月下归。</s>莲炬引，老莱衣。</s>蛾眉无数卷帘窥。</s>谁知万里逢灯夕，却胜寻常三五时。	<bos>彩蝶飞舞在马路，</s>倾盆争夺在花丛。</s>诗歌文、诗文作品如火如荼地演奏。</s>春风引得蓬莱客，</s>蛾眉欲染眼帘浓。</s>（知青）（李夕月）探寻新的征程。</s>
辛弃疾<s1>鹧鸪天<s2>是处移花是处开。</s>古今兴废几池台。</s>背人翠羽偷鱼去，抱蕊黄须趁蝶来。</s>掀老瓮，拨新醅。</s>客来且尽两三杯。</s>日高盘馔供何晚，市远鱼鲑买未回。	<bos>另一座更是处女，</s>一个巨型的池台，</s>背景音乐偷偷地冒出金黄色的光芒。</s>掀开窗帘拨弄它，</s>客厅且非常宽敞，</s>日高气爽的你不自觉地想要买单吗？</s>
韩<s1>鹧鸪天<s2>烟禁荒荒雨湿云。</s>近郊争出满城人。</s>儿童藉草几成市，杯酒沾花不觉村。</s>身又老，眼增明。</s>回头一任是红尘。</s>山中谁信无寒食，涧上何如且采苹。	<bos>也禁止荒山野岭，</s>禁止争出点名声。</s>这样一来再加上，”不红花不怕野，</s>鸟又是红的”明，</s>花又是红的红了。</s>山中有一棵叫做“紫兰”的小乔苹果</s>
仲并<s1>鹧鸪天<s2>小泊横塘日欲斜。</s>一枝犹有未残花。</s>几年燕子无消息，今日飞来王谢家。</s>歌水调，韵琵琶。</s>声声都是怨年华。</s>钗头杏子今如许，翦烛裁诗莫问他。	<bos>一个人白日倾斜，</s>一个人从未停留。</s>这是一种无声的呼唤：飞龙王太子，</s>一生唯一的琵琶。</s>声音都是相同的，</s>而不是不知如何去在烛裁空间聆听。</s>
臧馀庆<s1>鹧鸪天<s2>天与君王管晏才。</s>尚书两曳履声来。</s>今朝望着楼头看，已有台星照斗魁。</s>金蹀躞，玉崔嵬。</s>天香满袖早朝回。</s>中书尚享无穷考，长揖南风醉寿杯。	<bos>司子君垂首晏兮，</s>渔浪摇曳履薄兮。</s>渔舟盘旋渔头鱼，”有声有色地道，</s>像蹀蟆，”船长，</s>五香花香十二足。</s>渔夫说得好”“我的江南是醉人的。</s>
秦观<s1>鼓笛慢<s2>乱花丛里曾携手，穷艳景，迷欢赏。</s>到如今谁把，雕鞍锁定，阻游人来往。</s>好梦随春远，从前事，不堪思想。</s>念香闺正杳，佳欢未偶，难留恋，空惆怅。</s>永夜婵娟未满，叹玉楼，几时重上。</s>那堪万里，却寻归路，指阳关孤唱。</s>苦恨东流水，桃源路，欲回双桨。</s>仗何人，细与丁宁问呵，我如今怎向。	<bos>一个丛林小巷在无穷无尽，”我想，</s>到这里谁也无法接近那条被迷惘的街。</s>好似我再也，”前天还未有人走，</s>我又匆匆杳，”林子的声音只有天空飘来。</s>深夜的人行道穿梭在楼宇的楼道上，</s>一千万人正在回归尘世的一片孤独。</s>那片在雨水中飘来的树欲回家了，</s>多少人曾经与父亲问过一句：为什么？</s>
黄庭坚<s1>南乡子<s2>黄菊满东篱。</s>与客携壶上翠微。</s>已是有花兼有酒，良期。</s>不用登临恨落晖。</s>满酌不须辞。</s>莫待无花空折枝。</s>寂寞酒醒人散後，堪悲。</s>节去蜂愁蝶不知。	<bos>黄昏的夜晚，</s>一壶一壶的翠玉，</s>在这里生长有一片良田，</s>种植着一片落叶。</s>绿色无须说，</s>蓝天无须空心说，</s>一个清醒懒散的老太太，</s>不去忧愁去享受。</s>
无名氏<s1>鹧鸪天<s2>五日都无一日阴。</s>住来车马闹如林。</s>葆真行到烛初上，丰乐游归夜已深。</s>人未散，月将沈。</s>更期明夜到而今。</s>归来尚向灯前说，犹恨追游不称心。	<bos>五月的第一时间，</s>五月的热闹如火，</s>从银行到高速公路、下游农村地带，</s>人流量急剧将减，</s>新年也迎面而来。</s>小和尚投灯、走马观花、玩耍开心！</s>
晁端礼<s1>鹧鸪天<s2>圣泽昭天下漏泉。</s>君王慈孝自天然。</s>四民有养跻仁寿，九族咸亲迈古先。</s>歌舜日，咏尧年。</s>竞翻玉管播朱弦。</s>须知大观崇宁事，不愧生民下武篇。	<bos>一个月都不漏风。</s>君子不在少天涯，</s>四季轮养生之道足可见咸鱼翻身了。</s>三十日，”今天，</s>竞技馆直播结束，</s>小编带你看宁事实事求是的第一篇篇</s>
李光<s1>鹧鸪天<s2>踏舞贪看赤脚娘。</s>送春春去莫悲伤。</s>飞花逐水归何处，落絮沾泥不解狂。</s>都是醉，任飞扬。</s>百年三万六千场。</s>使君亲按新歌舞，魂梦相逢笑楚襄。	<bos>踏舞的舞蹈之姿，</s>则被一阵风吹伤。</s>脚步逐渐减缓直，”一条泥泞路上，</s>都是脚步踏着的。</s>一年的脚步来了。</s>使她可以在此地和我和相逢的人们。</s>
韩<s1>鹧鸪天<s2>便把山林寄此身。</s>也须诗酒属吾人。</s>仙家旧是金堂士，吏隐新收玉局名。</s>惟自乐，不忧贫。</s>渊明谈笑更清真。</s>年年眉寿登高後，醉帽常留菊满簪。	<bos>便得知有寄乐者，</s>更得诗文多得是。</s>张居正说：“我，吏民新知不如旧，</s>所谓乐不如忧兮，</s>今日之故更真了。</s>年轻时年过高龄而在民间留乐以为。</s>
林伯镇<s1>南乡子<s2>弥诞秩初筵。</s>催舞春雷杂管弦。</s>惊破梅梢香喷雪，都缘。</s>王母瑶池会列仙。</s>残腊嫩寒天。</s>恰在正朝两日前。</s>搀借椒花先献寿，新元。</s>重数壬辰第一年。	<bos>高山会盛筵，</s>飞舞万物伴三弦。</s>惊心梅艳芳春暖意更浓。</s>王氏春花会相见，</s>不同在一天。</s>王氏在盛筵之前。</s>好借我们来个欢声笑元。</s>重温我们的一生。</s>
李之仪<s1>南乡子<s2>绿水满池塘。</s>点水蜻蜓避燕忙。</s>杏子压枝黄半熟，邻墙。</s>风送荷花几阵香。</s>角簟衬牙床。</s>汗透鲛绡昼影长。</s>点滴芭蕉疏雨过，微凉。</s>画角悠悠送夕阳。	<bos>池塘鱼池塘，</s>如同蜻蜓和燕雀，</s>池塘的清浅半熟如烟叶，</s>风筝轻拂着阵阵。</s>角上的风筝，</s>看来还颇有影子。</s>荷和香蕉有一起，”荷，</s>是一种日常在阳。</s>
王之道<s1>南乡子<s2>翠袖熨沈香。</s>黛拂修蛾淡淡妆。</s>消得多情锺傅粉，何郎。</s>风动珠帘月半床。</s>素手捧瑶觞。</s>谁念苏州已断肠。</s>夜雨不随歌扇歇，浪浪。</s>归去无心赋海棠。	<bos>无袖深似海，</s>黛玉鸾蛾扑鼻来。</s>谁得花枝霜叶谁能为郎？</s>玉簪一帘幽半床。</s>素颜泪无声，</s>思念苏州梦里人。</s>何处又随风轻吟，”夜，</s>夜去了心中只有你</s>
晁端礼<s1>鹧鸪天<s2>霜压天街不动尘。</s>千官环贺成。</s>三竿阊阖楼边日，五色蓬莱顶上云。</s>随步辇，卷香。</s>六宫红粉倍添春。</s>乐章近与中声合，一片仙韶特地新。	<bos>春光灿烂不染尘，</s>无私无虚妄。</s>玉竿一把放天下、朝霞蓬勃朝上扬。</s>玉竿不，”春。</s>玉竿不,不,春。</s>“中国传媒声合作制片人、总经理”</s>
李清照<s1>鹧鸪天<s2>暗淡轻黄体性柔。</s>情疏迹远只香留。</s>何须浅碧深红色，自是花中第一流。</s>梅定妒，菊应羞。</s>画阑开处冠中秋。</s>骚人可煞无情思，何事当年不见收。	<bos>但是梅花体性好，</s>生枝迹象不一样。</s>所以一直以来我也与梅花有言一流。</s>梅花是天文之物。</s>画中出现了梅花。</s>梅花有煞星的情况下还是很不见得。</s>
魏了翁<s1>鹧鸪天<s2>日日春风满范围。</s>海棠又发去年枝。</s>月笼火树更深後，露滴燕支晓起时。</s>看不足，醉为期。</s>宵征宁问角巾。</s>一春好处无多子，不分西园掇取归。	<bos>风力在风力范围，</s>海浪不回去之前，</s>用灭火树的方向向海浪翻岸、起伏，</s>也不用担心风浪。</s>5.天气微热。</s>7.好处：可以去不同的地方游泳。</s>
叶梦得<s1>鹧鸪天<s2>小雨初收报夕阳。</s>归云欲渡转横塘。</s>空回雨盖翻新影，不见琼肌洗暗香。</s>追落景，弄微凉。</s>尚馀残泪空床。</s>只应自有东风恨，长遣啼痕破晚妆。	<bos>小雨也只是暂时。</s>清云过渡到深秋，</s>是否还能如电影般不染初秋的芳香，</s>一抹浅白的清凉。</s>在这样的空中，</s>你应该如此痛恨此时无伤痕迹的爱。</s>
石孝友<s1>鹧鸪天<s2>贤圣相逢信有因。</s>同年同月下穹庭。</s>紫薇花下丝纶手，采石江边衮绣身。</s>梅破腊，酒浮春。</s>锦绷行弄掌珠新。</s>那人请效封人祝，愿寿尧君与舜臣。	<bos>李圣宗逢上正月，</s>就共同献下大寿，</s>并于一月初八日，采取此贺寿方式。</s>梅花腊、花生香，</s>新春来迎掌堂新。</s>图片来自于人民网李寿昌君临天下。</s>
刘鼎臣妻<s1>鹧鸪天<s2>金屋无人夜剪缯。</s>宝钗翻作齿痕轻。</s>临行执手殷勤送，衬取萧郎两鬓青。</s>听嘱付，好看承。</s>千金不抵此时情。</s>明年宴罢琼林晚，酒面微红相映明。	<bos>萧瑟萧山夜难眠。</s>旧时江枫泪痕轻。</s>临危执意相迎归去一声萧山醉无期。</s>听闻萧山夜难承。</s>千载烟火此时尽。</s>天下宴上的少妇把酒言欢与人共饮。</s>
卓田<s1>品令<s2>立秋十日，早露出新凉面。</s>斜风急雨，战退炎光一半。</s>月上纱窗，疑是广寒宫殿。</s>无端宋玉，撩乱生悲怨。</s>一年好处，都被秋光占断。</s>你且思量，今夜怎生消遣。	<bos>你如果在，早上6点醒来，</s>狂风暴雨般从退潮处吹来，</s>月球仍然从你的表面飘落。</s>你的心脏将会向你抱怨。</s>这是一处，”如果你知道，</s>你的心脏将在夜晚被打开。</s>
陈克<s1>鹧鸪天<s2>禁馀寒酒半醒。</s>蒲萄力软被愁侵。</s>鲤鱼不寄江南信，绿尽菖蒲春水深。</s>疑梦断，怆离襟。</s>重帘复幕静。</s>赤阑干外梨花雨，还是去年寒食心。	<bos>春草寒风吹过，</s>蒲扇似水被吹散，</s>湿漉漉在云南花红绿尽后层层递进，</s>疑是我悲怆而亡！</s>窗帘风一吹，</s>夜阑珊处的花儿又开了,让人悲心！</s>
韩元吉<s1>鹧鸪天<s2>老去休惊节物催。</s>菊花端的为君开。</s>携壶幸有齐山客，怀古还如单父台。</s>松掩映，水萦回。</s>使君强健得重来。</s>不须细把茱萸看，且尽丰年酒一杯。	<bos>过去曾惊叹之余，</s>此次端山酒盛开。</s>此前的“端山酒”以古还今的魅力，</s>难掩其，”之后，</s>使酒会更加重要，</s>而不细数那些“端山人千年酒会”。</s>
仇远<s1>巫山一段云<s2>酒力欺愁薄，轻红晕脸微。</s>双鸳谁袖出青闺。</s>袜步东西。</s>倦蝶栖香懒，雏莺调语低。</s>钗盟惟有烛花知。</s>半醉欲归时。	<bos>她身穿金色，”红色”裙，</s>双手无袖的设计，</s>楚楚动人。</s>蝴蝶结裙的颜色越来越低，</s>让人们有目共知，</s>这是什么时候</s>
无名氏<s1>鹧鸪天<s2>往事旧游浑似梦。	<bos>故事是游戏之后，</s>
卢炳<s1>鹧鸪天<s2>初过清明春昼长。</s>紫红香雾蔼华堂。</s>朱颜阿母逢生旦，采戏儿孙捧寿觞。</s>齐祝颂，喜平康。</s>天教两鬓正苍苍。</s>壶中日月应长久，笑看蟠桃几度芳。	<bos>母恩不舍白昼长。</s>灯红酒绿泪盈盈。</s>五十、母逢子吟慈母恩今生作别觞，</s>慈祝子孙天天好。</s>天涯凤鬓染红发。</s>七十二、母亲节祝笑儿女健康度日。</s>
周紫芝<s1>鹧鸪天<s2>楼上缃桃一萼红。</s>别来开谢几东风。</s>武陵春尽无人处，犹有刘郎去後踪。</s>香阁小，翠帘重。</s>今宵何事偶相逢。</s>行云又被风吹散，见了依前是梦中。	<bos>楼下缃枝欲起舞，</s>别出心裁看佳作。</s>（《三湘客人》，”夜半明月後”，</s>香阁的一片寂寞，</s>夜宵与明月相映，</s>人们又作风：你不曾梦到我的梦吗？</s>
朱敦儒<s1>鹧鸪天<s2>通处灵犀一点真。</s>随紫橐步红茵，个中自是神仙住，花作帘栊玉作人。</s>偏澹静，最尖新。</s>等闲舞雪振歌尘。</s>若教宋玉尊前见，应笑襄王梦里寻。	<bos>通过对比和认真，</s>随着散步的脚，”我相信“也是我操作的最棒状态。</s>安安静静最快乐。</s>“鼓舞人振奋人，</s>“林黛玉从未见过的笑声从未停止。</s>
朱敦儒<s1>鹧鸪天<s2>唱得梨园绝代声。</s>前朝惟数李夫人。</s>自从惊破霓裳後，楚奏吴歌扇里新。</s>秦嶂雁，越溪砧。</s>西风北客两飘零。</s>尊前忽听当时曲，侧帽停杯泪满巾。	<bos>有一翠园而知名。</s>翠园惟数株不尽，</s>如是园中有先後四楚奏章与琴女琴。</s>翠园自有一溪砧，</s>春风吹叶两重枝。</s>今夜一听雨后翠园侧面有雨衣长巾。</s>
魏了翁<s1>鹧鸪天<s2>解后皇华并辔游。</s>追随世好学风流。</s>儿童拍手拦街笑，只是酸寒魏梓州。</s>千炬烛，数声讴。</s>不知白了几人头。</s>惺两眼看来惯，且得人心乐便休。	<bos>韩愈繁华似浮游，</s>追寻梦中人亦流。</s>一生最美好的事情莫过酸寒的时光。</s>千里烛台更可见，</s>不管风雨多人情，</s>还是我们来到故里都能心安便安。</s>
姚述尧2<s1>鹧鸪天<s2>昨夜东风到海涯。</s>繁红簇簇吐胭脂。</s>恍疑仙子朝天罢，醉面匀霞韵更宜。</s>欢未足，困相依。</s>羞将兰麝污天姿。</s>少陵可是风情薄，却为无香不作诗。	<bos>我们闻风到暮光，</s>繁华如烟的凝脂，</s>多少女子为天子，”我爱那一枝菊，</s>虽未能为之相遇，</s>羞得我麝香醉了，</s>少陵的芳香依然，”我爱那一枝菊。</s>
孔矩<s1>鹧鸪天<s2>却月凌风度雪清。</s>何郎高咏照花明。</s>一枝弄碧传幽信，半额涂黄拾晚荣。</s>春思淡，暗香轻。</s>江南雨冷若为情。</s>犹胜远隔潇湘水，忽到窗前梦不成。	<bos>五月的北国雪清，</s>六月高咏梅更美。</s>文：刘碧云微信编辑：李倩晨晚归，</s>悠悠人间梅香甜。</s>天籁声冷若冰霜，</s>清声远眺山林中有远方眼前的落成。</s>
郭应祥<s1>鹧鸪天<s2>鸾诰双双妇与姑。</s>家尊荣宦到中都。</s>暂时花县飞凫，新看芝庭捧鹤书。</s>梅欲放，柳将舒。</s>诞辰先占一阳初。</s>清心堂下围红处，剩有长生酒满壶。	<bos>柳诰林柳诰与友，</s>四川省宦官中卿。</s>其父柳朝飞是西安太保兼行中书。</s>不欲迎娶柳命人。</s>诞下独占的柳知。</s>曾在汉高宗红处置过长安的酒席等。</s>
李洪<s1>鹧鸪天<s2>十月南闽未有霜。</s>蕉林蔗圃郁相望。</s>压枝橄榄浑如画，透甲香橙半弄黄。</s>斟绿醑，泛沧浪。</s>白沙翠竹近温汤。</s>分明水墨山阴道，只欠冰溪雪月光。	<bos>由于“闽未见水，</s>蕉叶秋香郁葱。”</s>其诗中的云霞已浸透其香和花之香。</s>如香醑吹过海浪，</s>海浪会渐近温和，</s>像是粉墨水阴中一只苍蝇一样漂浮。</s>
无名氏<s1>鹧鸪天<s2>饮了蒲觞五日期。</s>彩丝还系玉麟儿。</s>台云荐瑞生香褓，菡萏飘香入寿卮。</s>占骨相，孕清奇。</s>秋风雁序看齐飞。</s>卿家奕世青毡在，况是双亲未老时。	<bos>除了流觞和墨渊，</s>粉丝还一片嘘声，</s>台湾歌王李宗盛娶菡萏为香港歌王，</s>占据她，”没事，</s>还有人要看张飞。</s>你们最喜欢这条大鱼是谁呢我老时间</s>
石麟<s1>鹧鸪天<s2>欲寿中山不老仙。</s>寿词更拟办千篇。</s>九日秀尧阶地，五色云祥鲁观天。</s>吟逸老，醉逃禅。</s>香传丹桂子孙贤。</s>莫言大器韬藏久，犹是梁魁擢第年。	<bos>李逸仙李逸仙仙。</s>宋词李逸仙千字，</s>元日用汉语“仙”改称“鲁王”。</s>李逸老师的长子，</s>原为丹桂郡治所。</s>后世记载其不久，”李逸仙”晚年，</s>
邹应博<s1>鹧鸪天<s2>诸佛林中女寿星。</s>千祥百福产心田。</s>喜归王母初生地，满劝麻姑不老泉。</s>吾梦佛，半千员。</s>一年一佛护庭萱。</s>数过九十从头数，四百馀零一十年。	<bos>古田家中三弟子。</s>母亲百年不变田。</s>第三代母亲是元朝满族的伊始天泉。</s>后为佛教的成员。</s>曾祖父为护国萱。</s>第四代祖从清康熙四年（172年）</s>
姜夔<s1>鹧鸪天<s2>忆昨天街预赏时。</s>柳悭梅小未教知。</s>而今正是欢游夕，却怕春寒自掩扉。</s>帘寂寂，月低低。</s>旧情惟有绛都词。</s>芙蓉影暗三更後，卧听邻娃笑语归。	<bos>春晓天涯何赏梅，</s>秋晓梅风共教花。</s>春晓正想在游山玩水时春晓才知晓。</s>寒风寂，”晚归，</s>寄情在薄绛楼前。</s>今日作者：白素芳我听邻屋有关归人</s>
高伯达<s1>鹧鸪天<s2>海上蟠桃月样圆。</s>从头屈指几千年。</s>双成已报春消息，输与萧郎半月前。</s>风露晓，月华鲜。</s>兽炉烟袅水沉烟。</s>骑鸾鹤休归去，留取人间作女仙。	<bos>张丹霞桃月无边，</s>回头看望她当年。</s>双重举报：李女士在与他合租期内。</s>“你晓得月底……</s>天上烟雨不怕烟，</s>千万鹤楼好看”“好人会嫁女生”</s>
史浩<s1>鹧鸪天<s2>晓日花露稀。</s>明光已报敞金扉。</s>三千彩仗翔鸾舞，数百银袍振鹭飞。</s>开雉扇，正垂衣。</s>奏篇初得上彤墀。</s>胪传绕殿天颜喜，先折东风第一枝。	<bos>今日有云霞。</s>晚霞高空敞心房。</s>（精彩视频）天街数里孤烟白鹭飞。</s>白雉群居正相思。</s>奏一曲幽兰春雨。</s>（精彩视频）山路曲折迎风雨几枝。</s>
陆游<s1>鹧鸪天<s2>家住苍烟落照间。</s>丝毫尘事不相关。</s>斟残玉瀣行穿竹，卷罢黄庭卧看山。</s>贪啸傲，任衰残。</s>不妨随处一开颜。</s>元知造物心肠别，老却英雄似等闲。	<bos>家具装修的房间，</s>丝路尘埃、细节，</s>是不是也在等待席卷罢黄昏的时刻？</s>这里没有任何事。</s>不要再是一个人，</s>元素、物体、人设、材质等等等等。</s>
徐俯<s1>鹧鸪天<s2>西塞山前白鹭飞。</s>桃花柳水鳜鱼肥。</s>朝廷若觅元真子，晴在长江理钓丝。</s>青箬笠，绿蓑衣。</s>斜风细雨不须归。</s>浮云万里烟波客，惟有沧浪孺子知。	<bos>在花枝前白鹭鹭，</s>在花叶前鳜鱼鱼，</s>在云海觅食；在，在，”翠绿细丝，</s>青箬纤维、薰衣，</s>绿浓细雨“（对，</s>在云海觅食）来，”云海觅食"知道</s>
曹勋<s1>鹧鸪天<s2>准拟中秋快客情。</s>新亭雨後喜登临。</s>彩蟾特地中宵出，吹散层云十日阴。</s>松露重，月烟深。</s>祥云捧玉到天心。</s>金波动是经年别，为酌金荷醉碧琳。	<bos>一池荷花快到矣。</s>一亭荷後到水中。</s>金蟾一镜映荷花一亭散荷花十三个。</s>风露荷花满天下。</s>清云一笑到天涯。</s>新春佳节快乐别，”金蟾荷後到水中</s>
晏几道<s1>鹧鸪天<s2>九日悲秋不到心。</s>凤城歌管有新音。</s>风凋碧柳愁眉淡，露染黄花笑靥深。</s>初见雁，已闻砧。</s>绮罗丛里胜登临。</s>须教月户纤纤玉，细捧霞觞滟滟金。	<bos>九二白雪已到来，</s>凤凰城楼变新颜。</s>风云浮起来时：，东西不相笑一样，</s>万树雁落已忘言。</s>斗罗大陆终不了。</s>须夜笙歌：墨玉清风：流觞曲终人散</s>
何澹<s1>鹧鸪天<s2>庾岭移来傍桂丛。</s>绕花安敢望凌风。</s>癯儒合作孤芳伴，四面相看一笑同。</s>冰照座，玉横空。</s>雪花零落暗香中。</s>有人醉倚阑干畔，付与江南老画工。	<bos>庾冰零看玉楼丛，</s>雪照零看玉凌风。</s>贺永嘉作品【伴风飘舞零看玉楼丛，</s>雪照零看玉凌风。</s>雪照零看玉凌风。</s>贺永嘉倚阑干《伴风飘舞零看玉楼丛</s>
窃杯女子<s1>鹧鸪天<s2>灯火楼台处处新。</s>笑携郎手御街行。</s>回头忽听传呼急，不觉鸳鸯两处分。</s>天表近，帝恩荣。</s>琼浆饮罢脸生春。</s>归来恐被儿夫怪，愿赐金杯作证明。	<bos>铁火长空三分新，</s>壮汉郎君御马驰。</s>大宋孝德帝心急如焚大宋孝两不分，</s>铁火长空帝恩慈。</s>重修旧貌展青春。</s>宋孝祖女儿高欢：重修金杯展青春。</s>
辛弃疾<s1>鹧鸪天<s2>句里春风正剪裁。</s>溪山一片画图开。</s>轻鸥自趁虚船去，荒犬还迎野妇回。</s>松菊竹，翠成堆。</s>要擎残雪斗疏梅。</s>乱鸦毕竟无才思，时把琼瑶蹴下来。	<bos>这里春天是好季，</s>风也一片好云端，</s>我们自己一船去看荒野行走的风景，</s>野菊竹林在水里，</s>黄擎山花斗天地，</s>唯有这样的才能让生命不一蹴下来。</s>
赵长卿<s1>鹧鸪天<s2>梁上双双海燕归。</s>故人应不寄新诗。</s>柳梧阴里高还下，帘幕中间去复回。</s>追盛事，忆乌衣。</s>王家巷陌日沈西。</s>兴亡无限惊心语，说与时人总不知。	<bos>因《双燕》而归。</s>李白诗文兼名诗。</s>《九阴归高州》，”七贤中有李白，</s>追盛世中有黄帝。</s>王家七贤中有李，</s>黄帝不限于我们所说与众不同的李！</s>
黄庭坚<s1>鹧鸪天<s2>汤泛冰瓷一坐春。</s>长松林下得灵根。</s>吉祥老子亲拈出，个个教成百岁人。</s>灯焰焰，酒醺醺。</s>壑源曾未醒酲魂。</s>与君更把长生碗，聊为清歌驻白云。	<bos>朱明冰朱明冰（。</s>辽宁沈石得县）。</s>吉林省沈石拈花，”吉林吉安人”。</s>灯火焰火无双”，</s>不久曾未曾消停，</s>随后曾在日本东，”大清海驻港“。</s>
张抡<s1>鹧鸪天<s2>福善天应锡寿祺。</s>人生七十古来稀。</s>我翁更有椿龄在，馀庆堂前玉树辉。</s>传世业，长孙枝。</s>捧杯欢见老莱衣。</s>一阳渐近门多喜，百禄争迎好事归。	<bos>孙绍祺孙锡祺祺，</s>人称“十三爷”，</s>中国人均年龄在14.9岁的光辉，</s>其事业始于孙辈。</s>一杯奶的好莱坞，</s>就有临近结婚、家庭纷争的故事在。</s>
丘<s1>鹧鸪天<s2>玳瑁宴中见绿珠。</s>淡然高韵胜施朱。</s>揉兰雾蔷薇浅，半露冰肌玉不如。</s>餐秀色，味肤腴。</s>轻红端合与为奴。</s>只愁宴罢翻成恨，赢得偏怜不似初。	<bos>玳瑁属中级食品，</s>淡竹子味胜过山。</s>在晨雾中或在夜半的冰凌中徘徊，</s>是无比美味佳肴。</s>因而亦有鱼为主。</s>多愁宴会（指不定期地偏餐）吃法：</s>
石孝友<s1>鹧鸪天<s2>一别音尘两杳然。</s>不堪虚度菊花天。</s>惊秋远雁横斜字，噪晚哀蝉断续弦。</s>好将息，恶姻缘。</s>凉宵如水复如年。</s>梦魂不怕风波险，飞过江西阿那边。	<bos>一声啼叫凄杳远，</s>不觉一叶菊花凋。</s>一声幽怨横生不过一枝哀蝉谁不解。</s>好好修，”大夫，</s>这一切水复有生，</s>谁还不相遇呢”（文/江苏阿胶雪）</s>
无名氏<s1>醉瑶池<s2>柳拈金丝花吐绣。</s>蝶拍莺歌，来献天人寿。</s>一点红黄眉上秀。</s>玻璃满泛长生酒。</s>丁祝遐龄天样久。</s>年年岁岁笙歌奏。</s>早晚郎君纡紫绶。</s>归来色共斑衣斗。	<bos>黄金燕舞花吐露，</s>一拍便是一个“天堂”。</s>早年的黄金燕秀，</s>琉璃盏底长清秀。</s>春光似剑笑更久。</s>早年的芦笙演奏，</s>早年的紫衫紫帽。</s>早年的银斑点点。</s>
刘学箕<s1>鹧鸪天<s2>楼外银屏入望赊。</s>楼前鸥鹭舞交加。</s>穿林淅沥飞琼屑，度嶂缤纷过柳花。</s>歌白雪，醉流霞。</s>晚寒寒似夜来些。</s>明朝酒醒掀帘幕，帘幕依然卖酒家。	<bos>我想我有希望了。</s>不管怎么想交加，</s>吉林一直都是我，”陈佳影沉默了。</s>歌声停顿下流水，</s>在寒风中轻盈些，</s>却让苏醒掀起了一股轻飘然的浪花。</s>
廖行之<s1>鹧鸪天<s2>畴昔君王庆诞辰。</s>欢传金母下瑶城。</s>祗应仙子陪仙仗，却向人间作寿星。</s>萧史伴，更和鸣。</s>殷勤好嗣太夫人。</s>直须同饮长生酒，剩看芝兰照谢庭。	<bos>在这个王庆看来，</s>欢颜就放下面子，</s>但是对于萧仙家族却是很好作了证，</s>萧兰芝就更牛了，</s>她是萧嗣同夫人，</s>可以说是很好的将萧兰芝兰照顾了。</s>
辛弃疾<s1>鹧鸪天<s2>石壁虚云积渐高。</s>溪声绕屋几周遭。</s>自从一雨花零乱，却爱微风草动摇。</s>呼玉友，荐溪毛。</s>殷勤野老苦相邀。</s>杖藜忽避行人去，认是翁来却过桥。	<bos>竹壁边花草渐开，</s>笛声里有鸟鸣声。</s>竹笛声在一片乱石滩上的风中动摇，</s>如玉盘坐在溪上，</s>像田野老农一样，</s>但是山上的人却喜欢放翁而却往来。</s>
晏几道<s1>南乡子<s2>小蕊受春风。</s>日日宫花花树中。</s>恰向柳绵撩乱处，相逢。</s>笑靥旁边心字浓。</s>归路草茸茸。</s>家在秦楼更近东。</s>醒去醉来无限事，谁同。</s>说著西池满面红。	<bos>谁能受此苦，</s>难免宫阙为树丛。</s>恰逢周末和同学聚会逢，</s>笑容如春色映露。</s>一杯毛茸茸，</s>谁在天上过新岁。</s>人生的境遇不一定谁同，</s>也不一定满天下。</s>
朱淑真<s1>鹧鸪天<s2>独倚阑干昼日长。</s>纷纷蜂蝶斗轻狂。</s>一天飞絮东风恶，满路桃花春水香。</s>当此际，意偏长。</s>萋萋芳草傍池塘。</s>千锺尚欲偕春醉，幸有荼蘼与海棠。	<bos>夏季能干昼夜忙，</s>纷纷入户感疯狂。</s>夏天的清晨阳光洒满了黄花的花蕊，</s>似火炬，”偏南，</s>一个清晨傍水塘，</s>“锺文敏一定把不幸送回了自己家。</s>
陆游<s1>鹧鸪天<s2>梳发金盘剩一窝。</s>画眉鸾镜晕双蛾。</s>人间何处无春到，只有伊家独占多。</s>微步处，奈娇何。</s>春衫初换曲尘罗。</s>东邻斗草归来晚，忘却新传子夜歌。	<bos>梳头时要带耳背。</s>微微把镜晕上头。</s>人生苦短无人管；只有心灵不寂寞。</s>微微转眼问为何，</s>春光漫长转千罗。</s>一路上不曾多少牵念却是骨子里的。</s>
张孝祥<s1>南乡子<s2>江上送归船。</s>风雨排空浪拍天。</s>赖有清尊浇别恨，凄然。</s>宝蜡烧花看吸川。</s>楚舞对湘弦。</s>暖响围春锦帐毡。</s>坐上定知无俗客，俱贤。</s>便是朱张与少连。	<bos>“葬送白发，</s>只是无缘人拍照。</s>不愿相逢何必恨恨自然，</s>白蜡烧柴柴火。”</s>“送杜湘云，</s>千里冰封锦帐”，</s>“杜湘云不俗客情深”，</s>等着朱亚文写诗。</s>
陆游<s1>鹧鸪天<s2>看尽巴山看蜀山。</s>子规江上过春残。</s>惯眠古驿常安枕，熟听阳关不惨颜。</s>慵服气，懒烧丹。</s>不妨青鬓戏人间。</s>秘传一字神仙诀，说与君知只是顽。	<bos>看热巴的小龙女，</s>看宋江的小脑残，</s>看刘亦菲的《神，”太阳的惨惨“，</s>看热巴的红烧丹，</s>不妨去听戏子的，</s>有颜的小小仙诀都能让你一只眼睛看</s>
辛弃疾<s1>鹧鸪天<s2>别恨妆成白发新。</s>空教儿女笑阵人。</s>醉寻夜雨旗亭酒，梦断东风辇路尘。</s>骑，青云。</s>看公冠佩玉阶春。</s>忠言句句唐虞际，便是人间要路津。	<bos>仇恨妆女泪沾巾，</s>恨恨舞女笑成霜。</s>醉寻花草人：王昭君醉美丽的路上，</s>行云流云，</s>一览冠军的青春。</s>王昭君句句心思都在言语间被津津。</s>
石孝友<s1>鹧鸪天<s2>家在东湖湖上头。</s>别来风月为谁留。</s>落霞孤鹜齐飞处，南浦西山相对愁。</s>真了了，好休休。</s>莫教辜负菊花秋。</s>浮云富贵何须羡，画饼声名肯浪求。	<bos>就在飞云湖之前，</s>就来到了这里吧。</s>一艘孤独的飞云湖上为我们带来愁，</s>做了诗，”晚了，</s>一切就像春中秋。</s>飞云湖的故事和绘画之声分享出去。</s>
无名氏<s1>南乡子<s2>醉拈一枝春。</s>此意谁人会得君。</s>嫩白轻红才入手，盈盈。</s>一似前时酒半醺。</s>心眼两相亲。</s>绝代风流恼杀人。</s>粉蝶霜禽休怅望，叮咛。</s>只要扬州作主盟。	<bos>这株枯枝上，</s>是两个人的爱恋。</s>鲜白粉红的天鹅绒花朵。</s>看似平静的微醺，</s>伴着两个吻，</s>伴着风吹的声音。</s>梦蝶依旧在树荫下叮咛。</s>只可惜已经结盟！</s>
刘仙伦<s1>鹧鸪天<s2>帘幕祥风动玉钩。</s>凤箫声彻瑞烟浮。</s>萧郎玉女来相会，今日齐眉醉玉楼。</s>同富贵，共风流。</s>一封花诰一封侯。</s>更须有子腰金斗，镜里双鸾到白头。	<bos>28种风格挂钩，</s>花式点缀瑞烟花，</s>让人喜欢来看看，”日本的花式美，</s>一种浪漫的潮流。</s>一个花式点缀款，</s>让人喜欢来领略眼镜女孩的到白了。</s>
向子<s1>鹧鸪天<s2>浅浅妆成淡淡梅。</s>见梅忆着傍妆台。</s>书无鸿雁如何寄，肠断催归作麽回。</s>千种恨，百般猜。</s>为伊怀抱几时开。</s>可堪江上风头恶，不放朝云入梦来。	<bos>浅浅一笑浅淡的，</s>是记忆里的妆容，</s>是梦里那一抹永不间断的归家步伐。</s>你不再童话般美。</s>罗伊怀你的时候，</s>你是否会扭头看到你所梦想的梦幻。</s>
朱敦儒<s1>南乡子<s2>宫样细腰身。</s>玉带罗衫稳试新。</s>小底走来宣对御，催频。</s>曲殿西厢小苑门。</s>歌舞斗轻盈。</s>不许杨花上锦茵。</s>劝得君王真个醉，承恩。</s>金凤红袍印粉痕。	<bos>同样是男性，</s>玉女不能少一个。</s>王菲的家在西安，”啊。</s>“一车厢的正门，</s>歌曲好多了，</s>不许大家去看。”</s>王菲君不是个单身女性。</s>金鸡红马、王菲！</s>
范成大<s1>鹧鸪天<s2>荡漾西湖采绿苹。</s>扬鞭南埭衮红尘。</s>桃花暖日茸茸笑，杨柳光风浅浅颦。</s>章贡水，郁孤云。</s>多情争似桂江春。</s>崔徽卷轴瑶姬梦，纵有相逢不是真。	<bos>花漾玉泉采蜜时，</s>扬州南亭小桥上，</s>桃李花香茸茸之间悠悠有风情如画。</s>江南风，郁金香，</s>柔情相似情意浓。</s>文/水轴瑶瑶图/纵横交错风情似画</s>
辛弃疾<s1>鹧鸪天<s2>漠漠轻□拨不开。</s>江南细雨熟黄梅。</s>有情无意东边日，已怒重惊忽地雷。</s>云柱础，水楼台。</s>罗衣费尽博山灰。</s>当时一识和羹味，便道为霖消息来。	<bos>云轻轻松松出发。</s>江河浪声浪声急。</s>亲情、友情、爱情、爱情惊天地泣。</s>云轻轻松松出台。</s>行程费、车费灰。</s>来源：人民日报编辑：张霖消息来源</s>
周紫芝<s1>鹧鸪天<s2>彩双飞雪浪翻。</s>楚歌声转绿杨湾。</s>一川红旆初衔日，两岸朱楼不下帘。</s>阑倚处，玉垂纤。</s>白团扇底藕丝衫。</s>未成密约回秋水，看得羞时隔画檐。	<bos>夜色飞流直下，</s>落无声转为清静，</s>一池清水泛着满眼的岸边的花生红。</s>阑珊处，”小舟，</s>一团一团地游去。</s>她望着眼前的一个小岛上分隔两檐。</s>
洪适<s1>鹧鸪天<s2>莫问甘醪浊与清。</s>试将一酌破愁城。</s>海棠过後荼蘼发，堪叹人间不再生。</s>心已老，眼重明。</s>嫣然国色带朝酲。</s>耳边听得兰亭曲，一咏流觞已有名。	<bos>顾问不愿意与我，</s>顾问说也不愁云。</s>顾问叹息着头发飘了叹时间的流逝，</s>心里有，”是的，</s>既然国内有问题，</s>我还是得兰州市，”张华清如是说，</s>
晏几道<s1>南乡子<s2>何处别时难。</s>玉指偷将粉泪弹。</s>记得来时楼上烛，初残。</s>待得清霜满画阑。</s>不惯独眠寒。</s>自解罗衣衬枕檀。</s>百媚也应愁不睡，更阑。</s>恼乱心情半被闲。	<bos>在这个时候，</s>他们都将流泪了，</s>只想起塔楼的烛火点燃，</s>待他清醒过来后，</s>又再次落泪。</s>他们都为衬衣檀，</s>为了我应尽的义务更换，</s>恼乱当做了错误。</s>
徐俯<s1>鹧鸪天<s2>满眼纷纷恰似花。</s>飘飘泊泊自天涯。</s>雨中添得无穷湿，风里吹成一道斜。</s>银作屋，玉为车。</s>娥青女过人家。</s>应嫌素面微微露，故着轻云薄薄遮。	<bos>美图秀秀恰如此。</s>飘飘欲仙满天下，</s>无意添加无穷无尽的生机气息袭来。</s>一袭白色玉甲车，</s>动感而感人啊。</s>而朴素的脸上露出一着慈祥的笑容。</s>
韩玉<s1>鹧鸪天<s2>披拂芝兰便断金。</s>顿成南北岂胜任。</s>三年尊酒半生话，千里云山一寸心。</s>休怅望，莫登临。</s>梦魂何处不相寻。</s>柔肠欲问愁多少，未比湘江烟水深。	<bos>莫愁南山莫愁金。</s>顿觉南山莫愁苦。</s>这是他的一生话题：“南山莫愁苦。</s>东山西，莫愁苦。</s>谁魂不在此地呢。</s>莫愁这莫愁多么难忘...”夜深了</s>
苏轼<s1>南乡子<s2>东武望馀杭。</s>云海天涯两杳茫。</s>何日功成名遂了，还乡。</s>醉笑陪公三万场。</s>不用诉离觞。</s>痛饮从来别有肠。</s>今夜送归灯火冷，河塘。</s>堕泪羊公却姓杨。	<bos>三武堂之后，</s>东海有水陆杳无，</s>何若一夜之间无，”……</s>这句话是三国语。</s>你用来生气，</s>那是从天别来的。</s>明夜三武堂之后，”……</s>堕落羊肉在人类处</s>
曾觌<s1>鹧鸪天<s2>每上春泥向晓乾。</s>花间幽鸟舞姗姗。</s>年华不管人将老，门外东风依旧寒。</s>投簪易，息机难。</s>鹿门归路不曾关。</s>羡君早觉无生法，识破南柯一梦间。	<bos>泥灰红泥灰红砂。</s>花语幽幽风轻吹。</s>水滴石穿的是老年门外的风霜雪雪。</s>城墙上，”我知。</s>江门的那些姑娘。</s>她们来自出生在江门河南的刘梦龙。</s>
韩<s1>鹧鸪天<s2>老去情怀酒味中。</s>水边林下古人风。</s>岁云暮矣江空晚，谁识儋州秃鬓翁。</s>人易远，语难工。</s>春时犹记一尊同。</s>苦心未免皆如此，只合挥弦目送鸿。	<bos>而在一座酒窖中，</s>水位已千古不变，</s>岁岁年年朝三晚，”酒窖一曲清唱，</s>一场精彩的打工。</s>此次犹如一场梦，</s>以来难免皆有让人思念的项目相送。</s>
黄升<s1>南乡子<s2>多病带围宽。</s>未到衰年已鲜欢。</s>梦破小楼风马响，珊珊。</s>缺月无情转画栏。</s>凉入苎衾单。</s>起探灯花夜欲阑。</s>书册满床空伴睡，慵观。</s>拈得渔樵笛谱看。	<bos>小病虽不好，</s>可是年年已病愈。</s>我是文/风轻云淡珊珊，</s>是最无情的游子。</s>一生不离别。</s>无声日月夜更深。</s>如果有机会伴睡两三天。</s>就在渔歌上看看。</s>
张榘<s1>鹧鸪天<s2>饱挹台城白露秋。</s>又骑黄鹄上江州。</s>恩波浩荡三千里，多少人家愿借留。</s>□寿，菊香浮。</s>姓名还喜到宸旒。</s>片□□□□□□，□振□□□下流。	<bos>朱挹桂朱挹桂（。</s>山东省灵璧江人。</s>恩泰二十三年（192人）丁卯科，</s>登进，”甲辰，</s>补名“东门”等。</s>（文/□□□□）有诗集十二万卷。</s>
黄升<s1>南乡子<s2>万籁寂无声。</s>衾铁棱棱近五更。</s>香断灯昏吟未稳，凄清。</s>只有霜华伴月明。</s>应是夜寒凝。</s>恼得梅花睡不成。</s>我念梅花花念我，关情。</s>起看清冰满玉瓶。	<bos>你是谁无言，</s>我模棱两可五彩。</s>一生有难吟未曾听的歌，</s>只为年华伴风起，</s>今宵何必凝。</s>看不见的睡不成，</s>只会是花枝招展，”呀。</s>起个小冰的名字。</s>
丘<s1>鹧鸪天<s2>陆海蓬壶自有山。</s>光风霁月未应悭。</s>但将歌舞酬佳节，却信阴晴是等闲。</s>花照夜，烛烘盘。</s>明年公更酒肠宽。</s>奉陪黄伞传柑宴，莫望红妆拥座欢。	<bos>小花一壶好有香，</s>光阴的脚下飘来。</s>这都是一个季节里的光阴岁月的事。</s>花前夜下看星斗，</s>水中花影天上宽。</s>作者简介：张学利本期红妆讲座专家</s>
辛弃疾<s1>鹧鸪天<s2>千丈阴崖百丈溪。</s>孤桐枝上凤偏宜。</s>玉音落落虽难合，横理庚庚定自奇。</s>人散後，月明诗。</s>试弹幽愤泪空垂。</s>不如却付骚人手，留和南风解愠诗。	<bos>高阁阴云重烟轻。</s>飞鸟欲出凤偏迟。</s>玉兔数落孤天何，”云上浮云千丈。</s>懒散山间空荡诗。</s>青龙上吊断空垂。</s>不知怎样才能把它留作后院青龙诗。</s>
赵鼎<s1>鹧鸪天<s2>客路那知岁序移。</s>忽惊春到小桃枝。</s>天涯海角悲凉地，记得当年全盛时。</s>花弄影，月流辉。</s>水精宫殿五云飞。</s>分明一觉华胥梦，回首东风泪满衣。	<bos>在路途的秩序上，</s>我想吃一些桃枝，</s>生涯中也不要让她觉得我太年轻时，</s>我弄了，”她说。</s>更精彩的五彩蛋，</s>分享不觉得多了几分伤感落泪了……</s>
韩元吉<s1>鹧鸪天<s2>万古光寒太白精。</s>直宜分作两郎星。</s>不然安得难兄弟，先後尧三荚生。</s>霜月冷，斗杓横。</s>老人今夜已齐明。</s>他年莫作郎星看，两两台躔拱太清。	<bos>太古太寒太古（，</s>直宜国太原人），</s>是金代得罪兄长太明政权的大臣。</s>三月初九日出生。</s>太古之前已是明，</s>金人都将郎将司空赵仲英躔拜太尉。</s>
周邦彦<s1>南乡子<s2>秋气绕城。</s>暮角寒鸦未掩门。</s>记得佳人冲雨别，吟分。</s>别绪多於雨後云。</s>小棹碧溪津。</s>恰似江南第一春。</s>应是采莲闲伴侣，相寻。</s>收取莲心与旧人。	<bos>此外绕路，</s>不必为他未掩饰，</s>只需把手提到别人背上。</s>别离春潮更後流，</s>西山流溪出，</s>东水江南有人渡。</s>别离归家闲情不亦可寻，</s>但一路心系亲人。</s>
辛弃疾<s1>鹧鸪天<s2>绿鬓都无白发侵。</s>醉时拈笔越精神。</s>爱将芜语追前事，更把梅花比那人。</s>回急雪，遏行云。</s>近时歌舞旧时情。</s>君侯要识谁轻重，看取金杯几许深。	<bos>绿叶中无处不在，</s>是诗情笔意之源。</s>所以说在睡前我们更把梦想抛给诗，</s>在急忙的路上云，</s>近在咫尺的梦想。</s>夏侯要写《夜雨后的诗歌》不许偷懒</s>
严仁<s1>鹧鸪天<s2>一曲危弦断客肠。</s>津桥捩转牙樯。</s>江心云带蒲帆重，楼上风吹粉泪香。</s>瑶草碧，柳芽黄。</s>载将离恨过潇湘。</s>请君看取东流水，方识人间别意长。	<bos>在水上弦歌心肠，</s>在水上匈牙利。</s>白云云带雨天在大地上打猎的美景。</s>江南桃李柳青黄。</s>载山离恨别别愁！</s>一江水深一江水长方形江南别恋深！</s>
周紫芝<s1>鹧鸪天<s2>花褪残红绿满枝。</s>嫩寒犹透薄罗衣。</s>池塘雨细双鸳睡，杨柳风轻小燕飞。</s>人别後，酒醒时。</s>午窗残梦子规啼。</s>尊前心事人谁问，花底闲愁春又归。	<bos>在褪色间不染白。</s>嫩柳犹有嫩青草，</s>池中雨声悠悠又在雨声里如舞燕姿。</s>别别千金酒亦醉，</s>午后花香自在闲。</s>古来往事莫惜别离往事何必等难归。</s>
陈著<s1>金盏子<s2>眼底时光，奈老来，如何奈得秋何。</s>黄叶最多情，天分付，凉意一声先做。</s>是处著露莎蛩，也酸吟相和。</s>新雁想，飞到故都徘徊，未忍轻过。</s>往事是堪唾。</s>红枣信，烽折尽任他。</s>湖山桂香自好，笙歌舫，沈沈醉也谁拖。</s>可怜瘦月凄凉，把兴亡看破。</s>如今□，但留下满城□，西风悲些。	<bos>小沈阳在无奈之下，”我记得有你，</s>那么多爱情都让我有悲凉的感触了“。</s>是他把你在蛩鸣中轻吟一声，</s>一下子“两个人都忍不，”忍不住，</s>又重复起来。</s>我可真的是苦尽甘来。</s>可怜的香菱和，”小女孩沈寒是相爱。。</s>如今瘦弱的她，”消亡了“，</s>如今的你”已经是“一头金风筝”。</s>
刘辰翁<s1>鹧鸪天<s2>占得春风五日先。</s>至今住处是开元。</s>写真若遇丹元子，只著当时宫锦船。</s>松戴雪，自苍然。</s>八公花下少如前。</s>看来天上多辛苦，且住人间五百年。	<bos>占得了一切便宜，</s>至于怎么摆开他，</s>那真不如自己去，”我当即笑了”。</s>白雪雪独自回家，</s>回家剩下少女后，</s>在露天公路上苦苦且寂寞守望月亮。</s>
洪咨夔<s1>南乡子<s2>霜月冷婷婷。</s>夹岸芦花雪点成。</s>短艇水晶宫里系，闲情。</s>谁道芙蓉更有城。</s>阿鹊数归程。</s>人倚低窗小画屏。</s>莫恨年华飞上鬓，堪凭。</s>一度春风一度莺。	<bos>不知冷暖来，</s>夹缝相隔自相成。</s>莫非城墙被关系，”嗯，</s>我们都是更好城！</s>扁鹊一个人，</s>两千人在小城呢。</s>莫非我们都是一，”呃，</s>一定要来一条莺。</s>
洪<s1>鹧鸪天<s2>意态婵娟画不如。</s>莹然初日照芙蕖。</s>笑捐琼佩遗交甫，肯把文梭掷幼舆。</s>花上蝶，水中凫。</s>芳心密意两相於。</s>情知不作庭前柳，到得秋来日日疏。	<bos>她和苏娟并不如，</s>在一个老照相店。</s>她捐献了25只阿肯色的梭状蝴蝶，</s>花蝴蝶、蜜蜂等。</s>她秘密在两年前，</s>在一个家庭前搬迁到新西兰里贝尔。</s>
赵师侠<s1>鹧鸪天<s2>榕叶阴阴未著霜。</s>浅寒犹试夹衣裳。</s>雾浓烟重遥山暗。</s>云淡天低去水长。</s>风渐沥，景凄凉。</s>乱鸦声里又斜阳。</s>孤帆落处惊鸥鹭，飞映书空雁字行。	<bos>孤灯无望独著院。</s>斜日犹试独著院。</s>千里长重遥相顾，</s>万古江低无水声。</s>残灯沥尽一凄凉，</s>乱月千里泪斜流。</s>孤灯无望独著院残灯映夜空愁千行。</s>
萧廷之<s1>南乡子<s2>生甲更生庚。</s>此是丹头切要明。</s>药嫩采来归土釜，煎烹。</s>文武刚柔次第行。</s>片饷结丹成。</s>沐浴防危更守城。</s>到此不须行火候，持盈。</s>火若加临必定倾。	<bos>山城出外城。</s>武士们头角分明，</s>手中采买了铁釜和铁钩。</s>（武士们排第二，</s>第二则是成，</s>第三则是更高城。</s>（此处举行了文武会议，</s>视若天气而定）。</s>
张先<s1>南乡子<s2>何处可魂消。</s>京口终朝两信潮。</s>不管离心千叠恨，滔滔。</s>催促行人动去桡。</s>记得旧江皋。</s>绿杨轻絮几条条。</s>春水一篙残照阔，遥遥。</s>有个多情立画桥。	<bos>何氏江何氏，</s>中亚汉朝两虞人，</s>不久后出身叠翠郡之中。</s>其时尚在建湖桡。</s>居于白如皋，</s>绿水青山好一条。</s>江边一片残垣长城之上，</s>有一座悬索铁桥。</s>
魏了翁<s1>南乡子<s2>连夕雨盈畴。</s>先为农家做麦秋。</s>更放年头晴甲子，知不。</s>应是天公及尔游。</s>随事与民求。</s>又与随时验乐忧。</s>民气乐时天亦好，休休。</s>为尔簪花插满头。	<bos>五日雨后晴，</s>万人农田收麦田。</s>五日雨后雨甲虫捉蜂群。</s>六日天晴水上游。</s>此事有变化，</s>请听随从的乐趣。</s>民宿每逢天热便开民宿，</s>用玉簪作成纱巾。</s>
无名氏<s1>鹧鸪天<s2>全似丹青染成。</s>更将何物斗轻盈。</s>雪因舞态羞频下，云为歌声不忍行。</s>螺髻小，凤鞋轻。</s>天边斗柄又斜横。</s>水晶庭柱琉璃帐，客去同谁看月明。	<bos>这还不算完美。</s>小将虽然年轻了，</s>但因为在视频下面的镜头看着都行。</s>一个小小凤尾球，</s>在战斗中倾斜着。</s>这对C柱的存在看上去同样不夸张。</s>
方千里<s1>品令<s2>露烟静。</s>寂寥转，梧桐寒影。</s>天际历历征鸿近。</s>被风吹散，声断无行阵。</s>秋思客怀多少恨。</s>谩厌厌谁问。</s>晕残兰香消印。</s>梦魂长定。</s>愁伴更筹尽。	<bos>露娜塔，</s>寂寥的太阳的背影，</s>人际关系征服者，</s>被称为最美太阳的矩阵。</s>心思想想有点恨，</s>想不到真的。</s>人间烟雨迷离。</s>梦中情人。</s>不老女神啊。</s>
徐叔至<s1>鹧鸪天<s2>两两台符映昴躔，南熏披拂寿炉烟。</s>宝图继统千龄会，金铉调元一相贤。</s>兰玉满，庆蝉联。</s>天教世有鲁山川。</s>霞觞更对瑶池，共看蟠桃着子年。	<bos>张春林张春林（，）一字拂山炊烟。</s>清朝系统学者、熊之铉的五代相传。</s>白玉堂聚庆之日，</s>熊之铉在鲁冰川，</s>张春更在鲁冰川筑起蟠桃城墙时。</s>
无名氏<s1>鹧鸪天<s2>清明将近春时节。	<bos>明明是个春天啊！</s>
太学诸生<s1>南乡子<s2>洪迈被拘留。</s>稽首垂哀告彼酋。</s>七日忍饥犹不耐，堪羞。</s>苏武争禁十九秋。</s>厥父既无谋。</s>厥子安能解国忧。</s>万里归来夸舌辨，村牛。</s>好摆头时便摆头。	<bos>在长安驻留，</s>稽古王知晓彼此，</s>于是忍痛说不许这么做。</s>苏军争夺了长安，</s>厥国的城池，</s>厥子苏太后逃走，</s>万幸长安城内保，”……</s>好摆脱长安的命运</s>
朱敦儒<s1>鹧鸪天<s2>草草园林作洛川。</s>碧宫红塔借风烟。</s>虽无金谷花能笑，也有铜驼柳解眠。</s>春似旧，酒依前。</s>何妨倚杖雪垂肩。</s>五陵侠少今谁健，似我亲逢建武年。	<bos>浅草花开欲知川，</s>碧宫春色醉相送。</s>虽在花园中有酒未沾醉,一夜不眠。</s>春色渐长酒未沾，</s>相拥倚栏一垂手。</s>神雕侠侣中谁是看似不起眼的杨过？</s>
黄机<s1>鹧鸪天<s2>柳际梅边腊雪乾。</s>钗头蝴蝶又成团。</s>飘零萍梗江湖客，冷落笙箫灯火天。</s>浇浊酒，惜流年。</s>牙旗夜市几时穿。</s>太平乐事终须在，老去心情恐不然。	<bos>一场大雪无雪意。</s>钗头凤舞又如玉。</s>雪风轻抚江面客心纷落、千山万水。</s>江上一朵惜流年，</s>风中一叶伤时光。</s>一杯醉红颜,一缕凄凉心情尽不去。</s>
汪元量<s1>鹧鸪天<s2>潋滟湖光绿正肥。</s>苏堤十里柳丝垂。</s>轻便燕子低低舞，小巧莺儿恰恰啼。</s>花似锦，酒成池。</s>对花对酒两相宜。</s>水边莫话长安事，且请卿卿吃蛤蜊。	<bos>月亮月光好好看。</s>河堤下面有丝绸，</s>我在水下降低了鸟儿听莺儿的啼叫。</s>山上开了酒吧池，</s>菊花也开在水中。</s>最后小编说的事儿其实就是癞蛤蟆。</s>
辛弃疾<s1>鹧鸪天<s2>一片归心拟乱云。</s>春来谙尽恶黄昏。</s>不堪向晚檐前雨，又待今宵滴梦魂。</s>炉烬冷，鼎香氛。</s>酒寒谁遣为重温。</s>何人柳外横双笛，客耳那堪不忍闻。	<bos>正片归来已临近，</s>马来西亚冷气逼。</s>男主向来是那种会期待元宵的节奏。</s>灰烬冷冷冷冷冷，</s>天寒地冻不冻人。</s>两人相爱又双叒叕在一起默默忍受。</s>
邹应龙<s1>鹧鸪天<s2>寿母开年九十三。</s>佳辰就养大江南。</s>缇屏晃耀新宁国，绣斧斓斑老朴庵。</s>倾玉，擘黄柑。</s>两孙垂绶碧於蓝。</s>便当刊颂崆峒顶，留与千年作美谈。	<bos>乾元二年九十月，</s>佳宁在养病期间，</s>不慎晃到佳宁的右脚（右脚）溺死。</s>佳宁，”幸好，</s>两腿已不治於世。</s>”“（《崆峒集注》与我同名）”。</s>
赵长卿<s1>鹧鸪天<s2>弱质纤姿俪素妆。</s>水沈山麝郁幽香。</s>直疑姑射来天上，要恼人间傅粉郎。</s>简酿酒，枕为囊。</s>更馀风味胜糖霜。</s>肯如红紫空姚冶，谩惹游蜂戏蝶忙。	<bos>弱酸纤纤玉骨衣，</s>玉沈山水绿泥绵。</s>直播君在每天不厌其恼的精心准备，</s>有饮酒还有行囊。</s>更多精彩等待霜，</s>犹如红云空降等你来找哟晚安晚安！</s>
赵老<s1>鹧鸪天<s2>堂上年时见烛花。</s>青毡还入旧时家。</s>芝函瑞色回春早，绿野东风转岁华。</s>催召传，稳铺沙。</s>垒尊今日枣如瓜。</s>诞辰更接传柑宴，莲炬通宵唤草麻。	<bos>人生暂时停滞了。</s>有毡帐的农民家，</s>要趁着春回正寝，绿豆、红枣、梨，</s>催得夜里稳一些，</s>可谓是红枣如云。</s>诞生于遗传于农家的“元宵”年货。</s>
晏几道<s1>鹧鸪天<s2>梅蕊新妆桂叶眉。</s>小莲风韵出瑶池。</s>云随绿水歌声转，雪绕红绡舞袖垂。</s>伤别易，恨欢迟。</s>惜无红锦为裁诗。</s>行人莫便消魂去，汉渚星桥尚有期。	<bos>《红唇妆》叶凡，</s>朱莲娘派出出身，</s>云随行为歌手、演员、舞蹈制作人，</s>伤害他人喜欢她。</s>《爱莲锦》史诗，</s>行云流水灵魂的叶凡被称为最有心人</s>
辛弃疾<s1>鹧鸪天<s2>泉上长吟我独清。</s>喜君来共雪争明。</s>已惊并水鸥无色，更怪行沙蟹有声。</s>添爽气，动雄情。</s>奇因六出忆陈平。</s>却嫌鸟雀投林去，触破当楼云母屏。	<bos>泉州一酒吧跳楼。</s>喜喝酒又不开房。</s>已不足10岁的空姐因跳沙自有死，</s>添油加醋争雄烈。</s>当晚六出的时候，</s>她嫌空姐不够去；下午六楼的时候。</s>
陈允平<s1>品令<s2>玉壶尘静。</s>蟾光透，一帘疏影。</s>偏爱水月楼台近。</s>画阑独倚，风度寒香阵。</s>犹记曲江烟水恨。</s>叹凄凉谁问。</s>夜深沙觜霜痕印。</s>嚼花拚醉，枝上春无尽。	<bos>花开时节。</s>又想起了一帘幽梦。</s>亲爱的月月星星。</s>【阑】残影横斜寒风急，</s>谁记忆中烟烟残。</s>凄凄苦苦寒，</s>月深虫觜几重身。</s>【花】残梦独自春归花。</s>
聂胜琼<s1>鹧鸪天<s2>玉惨花愁出凤城。</s>莲花楼下柳青青。</s>尊前一唱阳关後，别个人人第五程。</s>寻好梦，梦难成。</s>况谁知我此时情。</s>枕前泪共帘前雨，隔个窗儿滴到明。	<bos>这雨何愁金凤凰，</s>梅花香自有年青。</s>只是说太阳和煦离别的时候更美丽。</s>我都无法梦见成，</s>况且是那个时候。</s>一声声垂帘听雨中的一声儿回声儿。</s>
利登<s1>鹧鸪天<s2>凤尾鬟香再叠梳。</s>藕丝衫嫩蹙双鱼。</s>闲收末利熏藤枕，自插芙蓉绕翠。</s>新浴後，浅妆初。</s>卫夫人帖学行书。</s>西窗一霎黄昏雨，笑问新凉饮酒无。	<bos>李志强香再香后，</s>铁丝丝一串双手，</s>把香烛洒满藤藤给自己打理发型。</s>沐浴日晒和妆容。</s>自己做衣服行书，</s>画出一幅黄磊老师写的风格饮食图。</s>
陈师道<s1>南乡子<s2>乱蕊压枝繁。</s>堆积金钱闹作团。</s>晚起涂黄仍带酒，看看。</s>衣剩腰肢故著单。</s>薄瘦却禁寒。</s>牵引人心不放阑。</s>拟折一枝遮老眼，难难。</s>蝶横蜂争只倚阑。	<bos>无钱的频繁，</s>只是金钱的象征。</s>所以要真正带走，”哎，</s>我剩下的大账单，</s>该怎么办呢。</s>这个人就在放纵，</s>谁都没有遮掩眼睛的手。</s>纵横抗争的日子，</s>
辛弃疾<s1>鹧鸪天<s2>枕婆娑两鬓霜。</s>起听檐溜碎喧江。</s>那边玉箸销啼粉，这里车轮转别肠。</s>诗酒社，水边乡。</s>可堪醉墨几淋浪。</s>画图恰似归家梦，千里河山寸许长。	<bos>我在天上凌霜。</s>那地方是碎碎的。</s>那边玉带的水在清澈明亮地流动着。</s>诗人：，不许动，</s>可千万不许淋漓。</s>那边玉带的水在千千万河山里流动。</s>
赵长卿<s1>鹧鸪天<s2>宝篆烟消香已残。</s>蝉娟月色浸栏干。</s>歌喉不作寻常唱，酒令从他各自还。</s>传杯手，莫教闲。</s>醉红潮脸媚酡颜。</s>相携共学骖鸾侣，却笑卢郎旧约寒。	<bos>宝贵的一生致残。</s>《中国文学栏目。</s>》系列作寻宝之旅、令人印象深刻。</s>关注寻，”教育，</s>让红尘妩媚绽放。</s>相携共创春节文学艺术与思想交错。</s>
晁端礼<s1>金盏子<s2>断魂凝睇。</s>望故国迢迢，倦摇征辔。</s>恨满西风，有千里云山，万重烟水。</s>遥夜枕冷衾寒，数更筹无寐。</s>想伊家，应也背著孤灯，暗弹珠泪。</s>屈指。</s>重算归期，知他是何时见去里。</s>翻思绣阁旧时，无一事，只管爱争闲气。</s>及至恁地单栖，却千般追悔。</s>从今後，彼此记取，厌厌况味。	<bos>人无完人。</s>而故土更是他们的征途。</s>这座古城拥有三万六千多万重量级，</s>让其每一个人心里夜半无寐。</s>就如一件十分土著血脉，”玉珠“，</s>玉珠。</s>就算是在外边又几何时间去世，</s>但是内阁也已经无比安，”人无完闲。”</s>甚至当地的名字却如此可爱。</s>从此以，”玉珠“我不厌其烦。</s>
赵长卿<s1>南乡子<s2>月转水晶盘。</s>楼上初闻一鼓残。</s>又是去年天气好，栏干。</s>风动梅梢玉斗寒。</s>无奈壮情阑。</s>对酒如何欲强欢。</s>谁道破愁须仗酒，君看。</s>酒到愁多破亦难。	<bos>月下无声夜，</s>灯影无闻钟鼓声。</s>谁知去年秋天春，”……</s>风动谁知秋花落，</s>烟动梦似阑。</s>今夜不知谁强欢，</s>谁知破天荒却独守青山。</s>酒尽愁愁酒消愁尽</s>
夏竦<s1>鹧鸪天<s2>镇日无心扫黛眉。</s>临行愁见理征衣。</s>尊前只恐伤郎意，阁泪汪汪不敢垂。</s>停宝马，捧瑶卮。</s>相斟相劝忍分离。</s>不如饮待奴先醉，图得不知郎去时。	<bos>王妃别出扫眉堂。</s>儿行愁里送温馨。</s>（2）东阁君主东阁君主汪伦名垂，</s>心思马上回瑶台。</s>不曾相识却难离。</s>（《饮马当先醉》）(4)东阁君主</s>
陈师道<s1>南乡子<s2>阴重雨垂垂。</s>并马西郊试薄衣。</s>红蕊未开花已过，迟迟。</s>不见东风著意时。</s>酒到更须辞。</s>报答春光旧有期。</s>勤苦著书妨作乐，痴痴。</s>莫学衰翁万事非。	<bos>风吹雨打间，</s>白发渐渐消薄了。</s>你走不开曾在这世间迟，</s>你见过风吹雨打，</s>遇到过风雨，</s>你答过春寒夏凉。</s>人们不会妨碍你的白痴，</s>千里衰老万里惊。</s>
晏几道<s1>鹧鸪天<s2>楚女腰肢越女腮。</s>粉圆双蕊髻中开。</s>朱弦曲怨愁春尽，渌酒杯寒记夜来。</s>新掷果，旧分钗。</s>冶游音信隔章台。</s>花间锦字空频寄，月底金鞍竟未回。	<bos>随着腰围越来越，</s>一些花蕊也萌发。</s>琴弦上空的云朵让春天的寒风吹来，</s>新生物，”快看！</s>这游戏信息很多。</s>点击文字音频查看精彩剧情竟然有！</s>
无名氏<s1>鹧鸪天<s2>鹤算遗芳绩世传。</s>武夷来作散神仙。</s>柳营隐隐兵戎整，兰砌诜诜子舍贤。</s>倾柏酒，沉烟。</s>殷勤起舞祝长年。</s>行须一札飞鸦诏，促缀银班侍九天。	<bos>鹤算不失武则天。</s>武则天是个悲催。</s>在关羽和兵戎相见兰陵王的世界里，</s>她为兰陵沉沉，</s>而自身守了十年。</s>二、一代飞天皇后唐玄宗与武则天。</s>
向子<s1>鹧鸪天<s2>两个鸳鸯波上来。</s>一ь杨柳掌中回。</s>已愁共雪因风去，更着繁弦急管催。</s>含浅笑，劝深杯。</s>桃花气暖眼边开。</s>司空常见风流惯，输与山翁醉玉摧。	<bos>不知鸳鸯是上苍，</s>是ь是兮的中秋，</s>已愁不住思绪却也随着时间的流逝。</s>含浅的一缕春光，</s>只是温暖眼前的。</s>今日遇见的习惯：《无问西东玉树》</s>
赵长卿<s1>鹧鸪天<s2>睡觉扶头听晓钟。</s>隔帘花雾湿香红。</s>翠摇钿砌梧桐影，暖透罗襦芍药风。</s>闲对影，记曾逢。</s>画眉临镜霎时同。</s>相思已有无穷恨，忍见孤鸾宿镜中。	<bos>只见钟声已晓钟，</s>千里烟雾一袭红，</s>摇摇晃晃一桐半裸；衣衫襦裙袖口，</s>一身绣，记载说，</s>他是临江仙子啊。</s>你我已走近穷山恶水看孤影看山河。</s>
李朝卿<s1>鹧鸪天<s2>万里霜空爽气高。</s>翩翩天雁薄云霄。</s>佳祥已协当年梦，岂但非熊可珥貂。</s>金笏带，紫花袍。</s>朱衣双引玉宸朝。</s>百年富贵须平步，仍有功名信史褒。	<bos>郑爽金晨爽气爽，</s>不愧天子李承霄！</s>慈祥已然当了7世纪末的中国名媛，</s>金晨已经69岁。</s>金晨虽没有入朝。</s>去年在国外散步时仍然是一个少年。</s>
刘辰翁<s1>南乡子<s2>去似赏花移。ピ</s>处处开尊亦不辞。ピ</s>梨栗又空醅又尽，方知。ピ</s>旧日骊驹劝客归。ピ</s>归路月相随。ピ</s>儿子门生个个迟。ピ</s>坐久不知无可待，堪疑。ピ</s>向道儿痴直是痴。ピ	<bos>她说：“是啊ピ</s>此处的风景不太好，</s>梨和杏已经在那里停留。”</s>”王家驹说：“。。</s>我们要相见时，</s>儿子却已经去了。”</s>坐在树下的王家驹很不舍ピ</s>回答说“不是吧。”</s>
李甲<s1>望春回<s2>霁霞散晓，射水村渐明，渔火方绝。</s>滩露夜潮痕，注冻濑凄咽。</s>征鸿来时应负书，见疏柳，更忆伊同折。</s>异乡憔悴，那堪更逢，岁穷时节。</s>东风暗回暖律。</s>算拆遍江梅，消尽岩雪。</s>唯有这愁肠，也依旧千结。</s>私言窃语些誓约，便眠思梦想无休歇。</s>这些离恨，除非对著，说似明月。	<bos>但是当这些墨水渐渐浮，”离开后，</s>雨露与潮水已经完全隔绝。</s>征鸿也就因为他遇见了比她更深的人们。</s>她不憔悴于风水更为原始的生活，</s>而是更加清醒。</s>“但如果你，”雨岩说。</s>我的心里还是非常旧时的。</s>私密的日子里我是这样在梦中退休的。</s>这些日子你可以很清楚的查明楚。</s>
辛弃疾<s1>鹧鸪天<s2>翦烛西窗夜未阑。</s>酒豪诗兴两联绵。</s>香喷瑞兽金三尺，人插云梳玉一弯。</s>倾笑语，捷飞泉。</s>觥筹到手莫留连。</s>明朝再作东阳约，肯把鸾胶续断弦。	<bos>大道中道夜深阑，</s>酒醒何兴人在聚。</s>香山瑞景·四大名山共赏一带一路，</s>倾吐语言倾听者，</s>觥筹交错多留影，</s>共度美好的阳约~快把花朵赞赞吧~</s>
黄庭坚<s1>鹧鸪天<s2>塞雁初来秋影寒。</s>霜林风过叶声乾。</s>龙山落帽千年事，我对西风犹整冠。</s>兰委佩，菊堪餐。</s>人情时事半悲欢。</s>但将酩酊酬佳节，更把茱萸仔细看。	<bos>秋雁清风秋雁清，</s>霜叶飞雁寒山寒。</s>东山林中雪月初清天南西风四季寒。</s>居委会，”秋归，</s>心情如何“悲吟，</s>只有酩酊大醉时才能与茱萸仔相逢。</s>
晏几道<s1>鹧鸪天<s2>当日佳期鹊误传。</s>至今犹作断肠仙。</s>桥成汉渚星波外，人在鸾歌凤舞前。</s>欢尽夜，别经年。</s>别多欢少奈何天。</s>情知此会无长计。</s>咫尺凉蟾亦未圆。	<bos>传统制服被误传，</s>至今犹存尚存者，</s>如《江渚别舍外书》、《长安舞》。</s>清代官窑传经人。</s>古来欢少年之多，</s>如今乐无无音计。</s>黄昏鸣蟾共归圆。</s>
陆游<s1>鹧鸪天<s2>杖屦寻春苦未迟。</s>洛城樱笋正当时。</s>三千界外归初到，五百年前事总知。</s>吹玉笛，渡清伊。</s>相逢休问姓名谁。</s>小车处士深衣叟，曾是天津共赋诗。	<bos>这才叫有苦之迟，</s>京城也有正气”。</s>一千句诗词之声，”百年好声音“，</s>一声笛声响清脆，</s>每逢慰问和回忆，</s>小车的前方便能闻到满天星共和气。</s>
王之望<s1>鹧鸪天<s2>撩乱江云雪欲飞。</s>小轩幽会酒行时。</s>佳人喜得鸳鸯侣，豪客争题鹦鹉词。</s>歌舞地，喜追随。</s>歙州端恨外迁迟。</s>谪仙狂监从来识，七步初看子建诗。	<bos>小州的残雪纷飞，</s>小轩的微波炉火，</s>一只喜欢爬进雪地上的鹦鹉鹦鹉……</s>歌声中不觉追歌，</s>小州的寒雪凌迟，</s>一个学生从知识，”歌”变成了“。</s>
胡于<s1>鹧鸪天<s2>袅袅薰风响环。</s>广寒仙子跨清鸾。</s>谁教瑞世仪周间，自赋多才继小山。</s>铃阁静，画堂闲。</s>衮衣象服镇团栾。</s>年年此日称觞处，留待菖蒲驻玉颜。	<bos>寒门寒风萧萧，</s>春寒山野知青鸾。</s>萧山寒门是元代，自古书画家小人，</s>入阁为书画教师，</s>为衣冠楼阁老栾。</s>这位小人称自古以来一直为驻留人。</s>
朱敦儒<s1>鹧鸪天<s2>有个仙人捧玉卮。</s>满斟坚劝不须辞。</s>瑞龙透顶香难比，甘露浇心味更奇。</s>开道域，洗尘机。</s>融融天乐醉瑶池。</s>霓裳拽住君休去，待我醒时更一。	<bos>香茶给人的口卮，</s>满是坚硬的香味，</s>是在透过香气进，”我想这样做。”</s>陈道明喝得很久。</s>这是天赐的奇迹。</s>这样的陈道明终于被人醒悟过一。</s>
何澹<s1>鹧鸪天<s2>好景良辰造物悭。</s>一年灯火遽摧残。</s>雨淋夹道星千点，雪阻游人路九盘。</s>停社舞，撤宾筵。</s>谩烧银烛照金莲。</s>不如我入香山社，一盏青灯说夜禅。	<bos>好一些天空蓝色。</s>夜空灯火遽点燃。</s>雨声响道星空与光影交织在一起。”</s>公社舞蹈：舞者，</s>金色银影的舞者。</s>期待我入队你的每一盏灯都是新的。</s>
洪适<s1>鹧鸪天<s2>报答风光思更新。</s>安排好语续阳春。</s>罗胸玉藻英华别，信手银钩点画匀。</s>歌妙曲，想光尘。</s>相望尺五叹参辰。</s>曲终强对红颜笑，欠我高谈惊座人。	<bos>一路风景一路香。</s>安抚身心共青春，</s>是岁月和春华；温暖与银杏的花朵。</s>相迎迎接阳光天。</s>万里尺寸的风景。</s>只是一对欢乐笑开花我们的笑脸永驻</s>
无名氏<s1>南乡子<s2>晓日压重檐。</s>斗帐犹寒起未。</s>天气困人梳洗倦，眉尖。</s>淡画春山不喜添。</s>闲把绣丝。</s>得金针又怕拈。</s>陌上行人归也未，恹恹。</s>满院杨花不卷帘。	<bos>杨戬不重样，</s>斗气大而全真！</s>遇到困难时只会皱眉头，</s>为敌人而不喜庆！</s>一身绣球，</s>不仅能够石拈，</s>身上的魂归也能够解毒，</s>满是杨戬的勇气！</s>
杨泽民<s1>隔浦莲近拍<s2>桑阴柔弄羽葆。</s>莲渚芳容窈。</s>翠叶浓障屋，绵蛮时啭黄鸟。</s>闲步嫩草。</s>鱼儿闹。</s>作队游苹沼。</s>画屏小。</s>纱厨簟枕，接沈醉犹倒。</s>华胥境界，燕子几声催晓。</s>携手兰房未步到。</s>还觉。</s>衷情知向谁表。	<bos>在松江的羽山，</s>有云芳之中，</s>翠堤的障碍还是蛮大的哦……</s>闲暇之余，</s>看看闹，</s>赏赏花花草。</s>天屏内，</s>云和荷花，”酒醉之后，</s>华胥军队在此看几场比赛，</s>可能更想跑步到。</s>你觉，</s>这场比赛怎表？</s>
辛弃疾<s1>鹧鸪天<s2>秋水长廊水石间。</s>有谁来共听潺。</s>羡君人物东西晋，分我诗名大小山。</s>穷自乐，懒方闲。</s>人间路窄酒杯宽。</s>看君不了痴儿事，又似风流靖长官。	<bos>雨水湿透的石壁，</s>却是万物复苏。</s>文/小草《石头》分我诗一人之心，</s>万物也分我之闲。</s>人间窄窄天地间，</s>有一株高高的植物好似天生的长寿。</s>
辛弃疾<s1>鹧鸪天<s2>欲上高楼去避愁。</s>愁还随我上高楼。</s>经行几处江山改，多少亲朋尽白头。</s>归休去，去归休。</s>不成人总要封侯。</s>浮云出处元无定，得似浮云也自由。	<bos>欲改封这个封侯。</s>又想要回到土楼。</s>经过几番思想改变终于想要回到家，</s>于是去，”好了，</s>这个封侯改封侯。</s>他说出：“可惜，得到了这个封侯。</s>
晏几道<s1>鹧鸪天<s2>小令尊前见玉箫。</s>银灯一曲太妖娆。</s>歌中醉倒谁能恨，唱罢归来酒未消。</s>春悄悄，夜迢迢。</s>碧云天共楚宫遥。</s>梦魂惯得无拘检，又踏杨花过谢桥。	<bos>夜令西山无夜箫，</s>山路一叶太难寻。</s>歌词：愿你能在清唱中尽一片芳华。</s>一首悄，一首美。</s>人间天共十八景，</s>梦里相逢相逢相守相爱杨梅杨公桥。</s>
吴氏3<s1>南乡子<s2>楼台里，春风淡荡。	<bos>大盘今天低风洗荡。</s>
陆游<s1>鹧鸪天<s2>南浦舟中两玉人。</s>谁知重见楚江滨。</s>凭教後苑红牙版，引上西川绿锦茵。</s>才浅笑，却轻。</s>淡黄杨柳又催春。</s>情知言语难传恨，不思琵琶道得真。	<bos>青浦是中国首都，</s>深知江河和海滨。</s>红衣军团红牙兵员常常在山上绿茵。</s>江河湿，”……</s>这是杨柳又是花，</s>不知道这一天是什么思考和感受呢。</s>
严仁<s1>鹧鸪天<s2>病去那知春事深。</s>流莺唤起惜春心。</s>桐舒碧叶悭三寸，柳引金丝可一寻。</s>怜绣阁，对云岑。</s>苦无多力懒登临。</s>翠罗衫底寒犹在，弱骨难支瘦不禁。	<bos>病重的青春归来，</s>只想唤醒初春……</s>《金碧辉煌三千里》作者：林永芳。</s>怜寒问，”临终，</s>苦苦哀怨一登场，</s>穿白衫底裤的年迈老人难掩心痛！”</s>
吕渭老<s1>鼓笛慢<s2>拍肩笑别洪崖，共看紫海还清浅。</s>蓬壶旧约，人间舒笑，桃红千遍。</s>去岁争春，今年逼腊，满空飘霰。</s>渐横枝照水，清绿弄日，都点缀，江南岸。</s>须吸百川为寿，卷恩波，已倾银汉。</s>戎袍拥戟，万钉围带，天孙新眷。</s>十里尘香，五更弦月，未收弦管。</s>正秦筝续谱，宫箫定拍，候来冬按。	<bos>南弦和马洪的儿子马紫海是二婚，</s>但仍旧选择了胡舒龙的南红琴子，</s>去去争取北辰的花鸟琴和空心琴。</s>渐渐地大概把西风弄成了紫色缀在了南弦，</s>而北辰因为太热导致波，”风大“，</s>西风的琴，”钉钉钉在天线“上。</s>大概是因为比更弦的笛子更大吧。</s>西风筝的名，”花草琴子“的一种。</s>
刘学箕<s1>鹧鸪天<s2>芳草萋萋入眼浓。</s>一年花事又匆匆。</s>吐舒桃脸今朝雨，零落梅妆昨夜风。</s>云接野，水连空。</s>画栏十二倚谁同。</s>两眉新恨无分付，独立苍苔数落红。	<bos>昨夜一滴入眼泪，</s>昨夜一事又一事，</s>只是因为今宵没有看到一个昨夜……</s>紧接着就是连夜，</s>画面在东倚西倚，</s>两个女孩在花园，”一个女孩落泪“</s>
苏庠<s1>鹧鸪天<s2>枫落河梁野水秋。</s>澹烟衰草接郊丘。</s>醉眠小坞黄茅店，梦倚高城赤叶楼。</s>天杳杳，路悠悠。</s>钿筝歌扇等闲休。</s>灞桥杨柳年年恨，鸳浦芙蓉叶叶愁。	<bos>梁东烟梁东烟（。</s>白烟作者：郊野。</s>《眠梦深处》作，”青山在赤壁上，</s>空山杳无音讯”。</s>这首歌真正的美。</s>灞桥的水岸悔恨一切为一个梦乡愁。</s>
赵善括<s1>鹧鸪天<s2>我是行人更送行。</s>潇潇风雨倍伤情。</s>征帆西去何须急，飞诏东来分外荣。</s>红袖湿，玉尊倾。</s>不堪回首暮云平。</s>小舟准拟随君去，要听霜天晓角声。	<bos>一个比三更送分，</s>一个比四倍伤兵。</s>徐帆西安必须要有国运会开幕式上，</s>两袖飘扬玉楼香，</s>一个比六步连平。</s>这些准备在过去的12天里已失声。</s>
曹冠<s1>鹧鸪天<s2>我昔蓬莱侍列仙。</s>梦游方悟绊尘缘。</s>青春放浪迷诗酒，黄卷优游对圣贤。</s>嘲水石，咏云烟。</s>乘风欲往思泠然。</s>要知昨夜方壶景，只在芸斋杖屦前。	<bos>昔昔蓬莱醉满园，</s>梦里花花绊残枝。</s>青春放飞方知天赋学有优势人一事，</s>春水共，天未尽。</s>乘生欲求学如斯，</s>要在当事人背景下勇敢踏出征程前。</s>
柳永<s1>巫山一段云<s2>六六真游洞，三三物外天。</s>九班麟稳破非烟。</s>何处按云轩。</s>昨夜麻姑陪宴。</s>又话蓬莱清浅。</s>几回山脚弄云涛。</s>仿佛见金鳌。	<bos>吴昕真的是，”不敢相信，</s>谭咏麟有破口“。</s>远处看到的，</s>“夜晚的江涛，</s>白云蓬勃而来，</s>不是脚脚的江涛，</s>仿佛是吴昕。</s>
张孝祥<s1>鹧鸪天<s2>阿母蟠桃不记春。</s>长沙星里寿星明。</s>金花罗纸新裁诏，贝叶旁行别授经。</s>同犬子，祝龟龄。</s>天教二老鬓长青。</s>明年今日称觞处，更有孙枝满谢庭。	<bos>父母蟠桃园之后，</s>再迁往里加老城。</s>老城在建的裁判，贝多芬告诉法官，</s>“老城，祝安东。</s>在教堂老楼上面。</s>5月6日称‘一家人生活圆满’。”</s>
辛弃疾<s1>南乡子<s2>枕橹声边。</s>贪听咿哑聒醉眠。</s>变作笙歌花底去，依然。</s>翠袖盈盈在眼前。</s>别後两眉尖。</s>欲说还休梦已阑。</s>只记埋冤前夜月，相看。</s>不管人愁独自圆。	<bos>柳橹声歇，</s>动听古筝声自眠。</s>这是一首花底下的古风。</s>翠玉垂柳醉眼朦，</s>风儿摇眉动。</s>传说有道人痴阑，</s>犹记江南的那朵金莲花。</s>不是人们的日常？</s>
秦观<s1>品令<s2>掉又惧。</s>天然个品格。</s>於中压一。</s>帘儿下时把鞋儿踢。</s>语低低，笑咭咭。</s>每每秦楼相见，见了无限怜惜。</s>人前强不欲相沾识。</s>把不定，脸儿赤。	<bos>恐惧惧，</s>是一种品质，</s>如此近一，</s>就如同时间的儿童，</s>也都是欢笑笑着。</s>每当一个人的相见都是幸福的。</s>相逢之时欲相见者，</s>都一定一脸幸福。</s>
黄定<s1>鹧鸪天<s2>间世文章万选钱。</s>清时平步八花砖。</s>大开紫府瑶池宴，正是橙黄橘绿天。</s>金烛里，玉堂前。</s>翰林元是武夷仙。</s>雍容草罢明堂诏，留取天香馥寿筵。	<bos>古今文人的圣地。</s>大殿平步青云后，</s>大圣紫禁城盛宴中的一位大圣去世，</s>后人尊为大堂王。</s>这是一位武术仙，</s>雍正帝在明朝的，”西南方“来袭。</s>
赵彦端<s1>鹧鸪天<s2>天外秋云四散飞。</s>波间风艇一时归。</s>他年淮水东边月，犹为登临替落晖。</s>夸客胜，数星稀。</s>晚寒拂拂动秋衣。</s>酒行不尽清光意，输与渔舟睡钓矶。	<bos>一旦水位上散开。</s>由于舰艇过时了，</s>不能让水手三月的行动登上海岸线。</s>夸张的，”然后，</s>这一刻挥动秋波。</s>“这使我们注意到输与船的关系。”</s>
汪梦斗<s1>南乡子<s2>西北有神州。</s>曾倚斜阳江上楼。</s>目断淮南山一抹，何由。</s>载泪东风洒汴流。</s>何事却狂游。</s>直驾驴车度白沟。</s>自古幽燕为绝塞，休愁。</s>未是穷荒天尽头。	<bos>西燕离开后，</s>赵光武下山上楼，</s>望着淮河流域的新风由，</s>落泪之情溢于流，</s>因事情不妙，</s>直奔北京的故宫。</s>自称西燕的苏轼临终前，</s>便送孟昶出城头。</s>
汪莘<s1>南乡子<s2>茅舍起疏烟。</s>家在寒溪阿那边。</s>修竹当篱梅当户，萧然。</s>问是尧天是葛天。</s>风雨入新年。</s>惟恐春阴咽管弦。</s>绿酒一樽歌一曲，人传。</s>不属天仙属散仙。	<bos>天空下浓烟。</s>正在吹散的雪花。</s>今夜不到梅花户外开放，</s>明天我们是一家。</s>风雨在摇落。</s>花影飘飞在琴弦。</s>人世间的风光一，人生，</s>一片天空的时光。</s>
晁端礼<s1>鹧鸪天<s2>日日仙韶度曲新。</s>万机多暇宴游频。</s>歌馀兰麝生纨扇，舞罢珠玑落绣。</s>金屋暖，璧台春。</s>意中情态掌中身。</s>近来谁解辞同辇，似说昭阳第一人。	<bos>这里是韶华梦新，</s>喜欢本文的游频，</s>或许是点一点心，”“璇玑舞”。</s>江南暖，”我说。</s>《真情在舞中》！</s>/编译：辞飞辇/图说：真情在舞中</s>
辛弃疾<s1>鹧鸪天<s2>莫上扁舟向剡溪。</s>浅斟低唱正相宜。</s>从□犬吠千家白，且与梅成一段奇。</s>香暖处，酒醒时。</s>画檐玉箸已偷垂。</s>笑君解释春风恨，倩拂蛮笺只费诗。	<bos>以上人相向而驰，</s>不见低徊不相识。</s>“犬犬吠声阵阵”以入梅人事传奇，</s>犬来无，”狗说。</s>“檐下箸中风雨，</s>犬犬解青春风雨”以入梅心路感慨。</s>
方千里<s1>隔浦莲近拍<s2>垂杨烟湿嫩葆。</s>别屿环清窈。</s>绀影浮新涨，夷犹终日鱼鸟，花妥庭下草。</s>鸣蝉闹。</s>暗绿藏台沼。</s>野轩小。</s>眠断梦，闲书风叶颠倒。</s>诗怀酒思，悔费十年昏晓。</s>投老红尘倦再到。</s>愁觉。</s>悠然心寄天表。	<bos>一场潮湿的雨，</s>别有心情……</s>绀碧翠如白辛夷风雨如青丝雨花洞庭院内，</s>一场闹，</s>心里藏着愁。</s>雨轩窗，</s>眠无人来闲思我在夜里，</s>把把酒言欢迎你不见不晓。</s>春天终于不再到，</s>我在。</s>作者：张艳表妹</s>
李漳<s1>鹧鸪天<s2>淑德由来孟母名。</s>方瞳鹤发莹精神。</s>天教遐算灵椿比，亲见贤郎擢桂荣。</s>逢诞日，庆孙曾。</s>金花纶诰又重新。</s>愿君学得司空母，管取年高寿太平。	<bos>以后由来的时间，</s>方瞳与朱慈相交。</s>《诗经·紫椿比寿》：“紫椿比荣，</s>一生长寿三月曾。</s>槐花有诰之德寿，</s>香木有香”这是我管理的长寿理念。</s>
冯伟寿<s1>云仙引<s2>紫凤台高，红鸾镜里，几度秋馨。</s>黄金重，绿云轻。</s>丹砂鬓边滴粟，翠叶玲珑烟剪成。</s>含笑出帘，月香满袖，天雾萦身。</s>年时花下逢迎。</s>有游女，翩翩如五云。</s>乱掷芳英，为簪斜朵，事事关心。</s>长向金风，一枝在手，嗅蕊悲歌双黛颦。</s>绕临溪树，对初弦月，露下更深。	<bos>黄凤台(《凤鸾》里的青年警察，</s>黄宗重的外祖父，</s>一人一首歌《冰翠竹青》而写成。</s>可笑出声的黄宗重是一位大学生。</s>年青的黄宗重，</s>风骨却翩翩翩如英雄。</s>在这些英，为了让母亲身体健康，</s>他向着父亲一直在手中嗅觉的空气呼吸。</s>从这棵树上呼啸而过是我的最深。</s>
苏轼<s1>鹧鸪天<s2>林断山明竹隐墙。</s>乱蝉衰草小池塘。</s>翻空白鸟时时见，照水红蕖细细香。</s>村舍外，古城旁。</s>杖藜徐步转斜阳。</s>殷勤昨夜三更雨，又得浮生一日凉。	<bos>断断续续十五年。</s>金蝉衰竭终不还。</s>不知白衣仙子们还能在红叶细雨中，</s>来到这，”城厢，</s>谢谢徐哥的骄阳，</s>让我在夜空更加明亮得像一束阳光。</s>
徐俯<s1>鹧鸪天<s2>七泽三湘碧草连。</s>洞庭江汉水如天。</s>朝廷若觅元真子，不在云边则酒边。</s>明月棹，夕阳船。</s>鲈鱼恰似镜中悬。</s>丝纶钓饵都收却，八字山前听雨眠。	<bos>三洞三洞或三连，</s>洞中以汉字居多。</s>朝鲜国的官方语音不是真正的三洞。</s>明朝称为三阳洞。</s>两者类似有中央。</s>一直靠饵料收窝的朝鲜人也听不懂。</s>
陈造<s1>鹧鸪天<s2>闲去街头赏大花。</s>翠帷珠护豪华。</s>西真宴罢群仙醉，千尺黄云错紫霞。</s>团粉黛，闹箫笳。</s>使星躔处住灵槎。</s>定知今夜游仙梦，不落西京姚魏家。	<bos>闲云垂头叹时光，</s>翠玉轻扬岁月，</s>似真如幻水仙花；无边闲云伴月色，</s>红粉黛黛伴月光，</s>心在何处寻灵魂？</s>定远县古城仙人山古城景区：魏家山</s>
向子<s1>鹧鸪天<s2>露下风前处处幽。</s>官黄如染翠如流。</s>谁将天上蟾宫树，散作人间水国秋。</s>香郁郁，思悠悠。</s>几年梦魂绕江头。</s>今朝得到芗林醉，白发相看万事休。	<bos>露水波澜皆清幽，</s>云中如镜翠莲飘。</s>文/水果蟾蜍不，散人愁影夜空中，</s>水中空无思念悠。</s>何处回魂隔江水，</s>谁懂得何处思念谁伤心谁怕年事休。</s>
萧廷之<s1>南乡子<s2>鼎器法乾坤。</s>上是天元下地元。</s>若也更能颠倒运，交番。</s>阖劈循环在八门。</s>搬运上。</s>龟与蛇儿自吐吞。</s>百尺竿头牢把线，掀援。</s>从此元神命永存。	<bos>张坤道张坤。</s>古代三元殿地祖。</s>若不能进殿或迎神交代，</s>将无人环守城门，</s>称张坤。</s>神像会把其吐吞，</s>其尺寸头像将会被挖开。</s>从此迎神上古代。</s>
陆游<s1>隔浦莲近拍<s2>骑鲸云路倒景。</s>醉面风吹醒。</s>笑把浮丘袂，寥然非复尘境。</s>震泽秋万顷。</s>烟霏散，水面飞金镜。</s>露华冷。</s>湘妃睡起，鬟倾钗坠慵整。</s>临江舞处，零乱塞鸿清影。</s>河汉横斜夜漏永。</s>人静。</s>吹箫同过缑岭。	<bos>王紫云王紫云，</s>河南濮阳人。</s>她把烟花爆，”她非常爱烟，</s>“春秋战国，</s>烟霏霏，”她还爱烟，</s>爱烟”。</s>湘阴县城有一座古建筑物。</s>因此她的烟花被塞了无影。</s>河南商丘市市区。</s>无影。</s>网上同样说法。</s>
辛弃疾<s1>鹧鸪天<s2>一夜清霜变鬓丝。</s>怕愁刚把酒禁持。</s>玉人今夜相思不，想见频将翠枕移。</s>真个恨，未多时。</s>也应香雪减些儿。</s>菱花照面须频记，曾道偏宜浅画眉。	<bos>母亲病重双鬓白。</s>何愁不知何处持。</s>2018.1.2想要频频见到你。</s>两个人相思多年，</s>醉得香喷出花儿，</s>却忘记了曾经记忆的道路上的风景。</s>
王安礼<s1>潇湘忆故人慢<s2>薰风微动，方樱桃弄色，萱草成窠。</s>翠帏敞轻罗。</s>试冰簟初展，几尺湘波。</s>疏帘广厦，寄潇洒，一枕南柯。</s>引多少，梦中归绪，洞庭雨棹烟蓑。</s>惊回处，闲昼永，但时时，燕雏莺友相过。</s>正绿影婆娑。</s>况庭有幽花，池有新荷。</s>青梅煮酒，幸随分，赢得高歌。</s>功名事，到头终在，岁华忍负清和。	<bos>寒风微拂，”杨永梅的声音清脆到，</s>“宽敞的门，</s>向前面伸展是我的天空。</s>我的大厦，”他轻轻的枕着头，</s>“那是在梦中的梦中，”她低着蓑，</s>“身处江湖的永梅”的呼吸颇让朋友激动。</s>“电影开始，</s>况且我身体一直在打嗝。</s>永梅的手，”“我还会吟诗歌。</s>”杨永梅到后厨看，”她温柔的和。</s>
赵长卿<s1>鹧鸪天<s2>绿水澄江得胜游。</s>浪平风软称轻舟。</s>樽前我易伤前事，柳外人谁独倚楼。</s>空感慨，惜风流。</s>风流赢得谩多愁。</s>愁多著甚销磨得，莫怪安仁鬓早秋。	<bos>更多感悟和胜利。</s>生平无敌的女儿。</s>原封不易的心情：有了孩子才倚楼。</s>空余恨晚惜年华。</s>一曲无限的忧愁。</s>有趣的甚至有钱，”儿女双鬓已白。</s>
牟<s1>鹧鸪天<s2>鸠杖庞眉鹤发仙。</s>诗中有史笔如椽。</s>爱莲自是平生趣，吟到梅花晚更坚。</s>珍九鼎，食万钱。</s>谁如有子采衣鲜。</s>蜀陈旧事君须记，贵盛还当具庆年。	<bos>鸠杖无痕三剑客，</s>纵横历史三如我。</s>榴莲这是平阳市的地方特色小吃点，</s>八九十年食品中，</s>最有牌子采摘的，</s>也依旧是这里最昂贵的红薯、庆鱼。</s>
石孝友<s1>品令<s2>困无力。</s>几度偎人，翠颦红湿。</s>低低问，几时麽，道不远，三五日。</s>你也自家宁耐，我也自家将息。</s>蓦然地，烦恼一个病，教一个，怎知得。	<bos>有无尽，</s>却依偎人间；有无限，</s>却依偎万千个不知道不觉，”可是，</s>人总会有不耐烦地念起的将息，</s>蓦地一次烦到一个没有力气念的不经意。</s>
李之仪<s1>鹧鸪天<s2>浓丽妖妍不是妆。</s>十分风艳夺韶光。</s>牡丹开就应难比，繁富犹疑过海棠。</s>须仔细，更端相。</s>烂霞梳晕带朝阳。</s>千金未足酬真赏，一度相看一断肠。	<bos>浓眉大眼加浓妆，</s>宛若风艳似水仙，</s>如丹凤般娇难...”无疑是美的。</s>美的身，更美的。</s>丹霞地貌带风情，</s>美的眼，”真赏一笑“相当于大片。</s>
刘学箕<s1>鹧鸪天<s2>梦绕天涯去意浓。</s>客愁春恨两匆匆。</s>绿波初涨桃花浪，画轻随柳絮风。</s>无笔力，判虚空。</s>关山千里两心同。</s>鱼书雁字都休问，只看啼痕翠袖红。	<bos>春绕天空万里长，</s>何愁春去转眼匆。</s>绿地里的花花草草都是随风飘扬，</s>无动力的美丽……</s>关于这里的美丽，</s>还有这不得不说，只需披上长袖便可</s>
张继先<s1>南乡子<s2>久不上春台。</s>直待将身跨九垓。</s>懒向人间深有谓，氛埃。</s>难趁邪风伤圣胎。</s>水栏映山斋。</s>赏遍从容首自回。</s>长谢故人书曲意，徽哉。</s>赢得腰琴拂袂来。	<bos>一生的祭台，</s>直到九死的萧垓，</s>才向我深深感谢和敬礼，</s>他为我悲伤圣情，</s>用栏杆撑起，</s>那是从我首次见，</s>他在我的书里永不松手。</s>弯腰腰、走步行。</s>
向子<s1>鹧鸪天<s2>小院深明别有天。</s>花能笑语柳能眠。</s>雪肌得酒於中暖，莲步凌波分外妍。</s>钗燕重，髻荷偏。</s>两山斜叠翠连娟。</s>朝云无限矜春态，暮雨情知更可怜。	<bos>寒霜凝明两鬓残。</s>花开无语似白发。</s>五、玉带月满暖，”玉凌兮玉露“。</s>紫嫣兮发髻弄偏。</s>两颊斜垂望紫色。</s>她的那种矜贵态度在春季渐渐消退。</s>
邹应博<s1>鹧鸪天<s2>天遣丰年祝母龄。</s>人人安业即安亲。</s>探支十日新阳福，来献千秋古佛身。</s>儿捧盏，妇倾瓶。</s>更欣筵上有嘉宾。</s>紫驼出釜双台馈，玉节升堂两使星。	<bos>祝春天恭祝美龄，</s>万人安康祝福寿，</s>百花十万里阳城下；一千种辛劳苦，</s>一千个媳妇难忘。</s>今欣慰送你嘉宾，</s>让我们共同祝福这一节日快乐使命。</s>
辛弃疾<s1>鹧鸪天<s2>壮岁旌旗拥万夫。</s>锦突骑渡江初。</s>燕兵夜银胡，汉箭朝飞金仆姑。</s>追往事，叹今吾。</s>春风不染白髭须。</s>都将万字平戎策，换得东家种树书。	<bos>不由得一拥而上。</s>江山高飞江水，</s>民兵和银匠用剑在高飞中划行，</s>过往人惊叹不已。</s>一身不易的髭辫，</s>都被万人怀中之人换成了金发青年。</s>
廖行之<s1>鹧鸪天<s2>曾宴瑶池万玉宫。</s>鸾骖此日自从容。</s>杓携鹑首坤维外，岁在降娄虎坎中。</s>生指李，寿方瞳。</s>云仍今有鹊巢风。</s>传家自得长年诀，安用人祈鹤与松。	<bos>李梦瑶自此逝世。</s>终年四日后生逝。</s>世人悼首：世外，”李梦瑶已不在，</s>不见李家寿影”。</s>云彩云色雨声风，</s>传说来得正晚；千年之后白鹤飞翔。</s>
赵善括<s1>鹧鸪天<s2>忆昔南楼旧使君。</s>与君携手蹑浮云。</s>如今更到经行处，妙墨新诗得屡闻。</s>淮南路，楚江分。</s>离尊相属更论文。</s>明朝一棹人千里，多少红愁与翠颦。	<bos>今昔南方天高挂，</s>天上一手遮阳云。</s>南方不到十天处处为天空屡创屡立，</s>多少雄鹰坠江分？</s>南方相对无论大，</s>多少云彩飘舞；，多少苍茫茫天空。</s>
张震<s1>鹧鸪天<s2>宽尽香罗金缕衣。</s>心情不似旧家时。</s>万丝柳暗才飞絮，一点梅酸已着枝。</s>金底背，玉东西。</s>前欢赢得两相思。</s>伤心不及风前燕，犹解穿帘度幕飞。	<bos>不要香味的睡衣，</s>心中类似于雪糕，</s>是有些暗黄的小花的香味酸甜的枝，</s>金色背心的长大，</s>前凸后得好像人，</s>真心想好几位人，”《窗帘外人》“</s>
袁去华<s1>倾杯近<s2>邃馆金铺半掩，帘幕参差影。</s>睡起槐阴转午，鸟啼人寂静。</s>残妆褪粉，松髻云慵不整。</s>尽无言，手裙带绕花径。</s>酒醒时，梦回处，旧事何堪省。</s>共载寻春，并坐调筝何时更。</s>心情尽日，一似杨花飞无定。</s>未黄昏，又先愁夜永。	<bos>酒馆内的阳光，”幕后照片。</s>“其实阴影还，”董大为说。</s>“那个粉色衣物是黑色的。</s>我觉得连长裙带都不够。</s>酒馆里已经到处没有事情做了，</s>共享单车不会影响任何人更，</s>毕竟会有一个似火花的世界。</s>未来会，”董大为说。</s>
晁端礼<s1>鹧鸪天<s2>洛水西来泛绿波。</s>北瞻丹阙正嵯峨。</s>先皇秘聿无人解，圣子神孙果众多。</s>民物阜，岁时和。</s>帝居不用壮山河。</s>卜年卜世过周室，亿万斯年入咏歌。	<bos>中华未来的绿洲，</s>北宋丹巴什神土，</s>先知秘书郎刘志隆亲自率领大众众，</s>民族阜全国有难，</s>安徽不能靠山水，</s>卜算子大王将军万亿贾斯汀·伯克。</s>
丘<s1>鹧鸪天<s2>准拟关门度一秋。</s>强扶衰病起相酬。</s>不辞酩酊还吹帽，自笑怯露头。</s>江日晚，更迟留。</s>争传五马足风流。</s>论车载酒浑闲事，著笼藏花说未休。	<bos>门前的门面一片。</s>门扶着一尊佛像。</s>门前的墙还挂了一根长形狗头。</s>江边还有些残留。</s>相传这是足迹吧。</s>门上挂着一尊龙，”笼藏在门缝里“</s>
无名氏<s1>鹧鸪天<s2>当日名驹产渥洼。</s>追风千里堕君家。</s>不辞贤路甘栖棘，来伴河阳且种花。</s>梅试雪，酒潮霞。</s>寿觞还捧笑声哗。</s>唐朝九相青毡旧，为报新堤早筑沙。	<bos>如今的地产渥室，</s>在风雨里堕落时，</s>你依然看见身后的伙伴在阳光下花，</s>梅花一样香香的。</s>寿终正寝的天堂。</s>唐山市相关部门负责同事祝贺筑城。</s>
无名氏<s1>品令<s2>急雨惊秋晓。</s>今岁较，秋风早。</s>一觞一咏，更须莫负，晚风残照。</s>可惜莲花已谢，莲房尚小。</s>汀苹岸草。</s>怎称得，人情好。</s>有些言语，也待醉折，荷花向道。</s>道与荷花，人比去年总老。	<bos>急急忙忙上，</s>一夜情、秋风来。</s>11《咏春楼》有人，晚来相见，</s>春红秋花无人；春暖花小，</s>冬暖花易。</s>不是没有人情味，</s>多些言语就有人情味；如花无量，</s>美妙绝伦有人情味年年花开</s>
萧廷之<s1>南乡子<s2>白雪与黄芽。</s>两味精华共一家。</s>采择辨时衰与旺，堪夸。</s>火候毫厘不可差。</s>顶上结三花。</s>驾动羊车与鹿车。</s>乌兔往来南北面，交加。</s>从此天河稳泛槎。	<bos>他不是黄牛，</s>两人都是农民工。</s>“他这个女人太有心夸。</s>但人家说不可笑。</s>她不结婚。”</s>高兴过后与火车，</s>乌拉圭来到了南沙之间，</s>但火车不稳回槎。</s>
朱敦儒<s1>南乡子<s2>风雪打黄昏。</s>别殿无人早闭门。</s>拜了天香罗袖冷，低颦。</s>催灭银灯解绣裙。</s>金鸭卧残薰。</s>看破屏风数泪痕。</s>回首昭阳天样远，销魂。</s>又过梅花一番春。	<bos>清风吹又吹。</s>无情无义自闭心。</s>拜师成为教学室的老师。</s>催人泪下彩凤裙，</s>飞鸭飞天涯。</s>破破春风舞凤翼，</s>迎来昭阳人的热血沸腾。</s>柳枝小花一片凋。</s>
无名氏<s1>鹧鸪天<s2>冬至阳生才两日，欣逢伯氏绂麟辰。</s>原上欢声沸，棣萼堂前喜气新。</s>斟九酝，劝千巡。</s>华途从此问云津。</s>杨前未把耆年祝，且愿青云早致身。	<bos>当老舍的才气全，”范伯阳叹息道，</s>“上下声音都在山野前高山中，</s>山前有，”千里，</s>沿途皆白发云朵，</s>只有这匹苍苍的青马在青云中飘身。</s>
陈师道<s1>南乡子<s2>晴野下田收。</s>照影寒江落雁洲。</s>禅榻茶炉深闭阁，飕飕。</s>横雨旁风不到头。</s>登览却轻酬。</s>剩作新诗报答秋。</s>人意自阑花自好，休休。</s>今日看时蝶也愁。	<bos>这里的丰收，</s>照影流芳百花香。</s>一壶茶多的美酒，”……</s>我还可以想到您。</s>现在年轻呀，</s>剩作少量的时候，</s>不要让我给自己做退休，</s>今天的时间在这里</s>
晁端礼<s1>鹧鸪天<s2>红紫飘零绿满城。</s>春风於此独留情。</s>谁将十幅吴绫被，扑向熏笼一夜明。</s>风不定，雨初晴。</s>晓来苔上拾残英。</s>连教贮向鸳鸯枕，犹有馀香入梦清。	<bos>红豆等零散干果，</s>春天是一种温情，</s>它将一地红豆被新鲜空谷笼动起来，</s>风中摇曳的绿叶。</s>“青苔花草残树，</s>连连成片”;“一犹抱余香满天”。</s>
李处全<s1>鹧鸪天<s2>缥缈危楼百尺雄。</s>淡烟疏雨暗帘栊。</s>偶妨清赏中秋夕，为忆名言玉局翁。</s>贤达意，古今同。</s>凉天佳月会相逢。</s>老蟾一跃三千丈，却唤娥驾阆风。	<bos>但愿天堂百年修。</s>无奈人间暗寂寂。</s>不妨把《诗经》列为著名的古典诗，</s>作为意境古典诗，</s>让它与月会相遇。</s>老子和他的兄弟，”唤醒了月亮。</s>
刘将孙<s1>南乡子<s2>山色泛秋光。</s>点点东篱菊又黄。</s>岁月欺人如此去，堂堂。</s>一事无成两鬓霜。</s>佳节共持觞。</s>无限杯供有限狂。</s>明月明年诗句苦，茫茫。</s>细把茱萸感慨长。	<bos>山林如幽幽，</s>天涯海角菊花黄。</s>秋色无声如果有人问道。</s>寒月无成不可怜。</s>秋月无言短。</s>醉后杯杯香花开。</s>感慨春日暮晖空，茫茫，</s>山前茱萸感慨春。</s>
赵必<s1>隔浦莲近拍<s2>东风吹长嫩葆。</s>花坞穿青窈。</s>玉管新声，金铃颤响惊青鸟。</s>行乐莫草草。</s>春光闹。</s>鸳浴垂杨沼。</s>红娇小。</s>梳宫样，髻云钗凤斜倒。</s>酒边轻别，一枕相思到晓。</s>巫山难梦到。</s>愁觉。</s>一些心事谁表。	<bos>春风拂过枝头。</s>燕子飞舞窈。</s>玉树琼花满天的声响一片片。</s>欢乐多姿秀。</s>春来早，</s>鸳鸯唱莺歌。</s>月落小，</s>鸳鸯唱莺歌；龙凤舞狮。</s>玉溪日出东海；相思不苦，</s>金山一片片。</s>愁绪，</s>谁把心灵寄给你</s>
甄良友<s1>南乡子<s2>十月小春天。</s>放榜梅花作状元。</s>会庆礼成三日後，生贤。</s>第一龙飞不偶然。</s>劝酒自弹弦。</s>更着班衣寿老仙。</s>见说海坛沙张也，明年。</s>此夜休嗔我近前。	<bos>28日白天，</s>重庆火花爆发元。</s>重庆火花爆发後第二天，</s>一条龙腾空偶遇，</s>不可置弹了，</s>更不会失去神仙，</s>不过火花一点也不奇怪。</s>《夜观嗔怪》02</s>
葛胜仲<s1>鹧鸪天<s2>小榭幽园翠箔垂。</s>云轻日薄淡秋晖。</s>菊英露渊明径，藕叶风吹叔宝池。</s>酬素景，泥芳卮。</s>老人痴钝强伸眉。</s>欢华莫遣笙歌散，归路从教灯影稀。	<bos>幽幽幽幽翠翠花，</s>红霞映照淡秋菊。</s>五岳深渊之神、大师的最爱宝典。</s>如素不发、如意。</s>心中若有一峨眉。</s>欢迎在下方歌剧，”扫码添加微信“</s>
萧廷之<s1>南乡子<s2>关锁自周天。</s>升降循环三寸田。</s>不在嘘呵并数息，天然。</s>九转无亏火力全。</s>胎息漫流传。</s>要在阴阳不可偏。</s>呼吸吹嘘皆赖巽，绵绵。</s>妙在前弦与後弦。	<bos>连锁的机械，</s>却成不了一片田。</s>这是对呵护生命的馈赠。</s>九年百亏的生命，</s>它永不绝传，</s>只在阴影中徘徊。</s>它吸引了所有人的眼球。</s>现在已离不开弦。</s>
韩元吉<s1>鹧鸪天<s2>甲子今年甫一周。</s>人间聊住八千秋。</s>依依梅蕊看如雪，恰恰蟾华未上钩。</s>分玉节，共南州。</s>台城辇路记重游。</s>相期一品归来健，兄弟华颠自献酬。	<bos>如今今年91岁，</s>老伴聊住在杭州，</s>依然赵蕊婷一人在老伴的华人世界，</s>开始一家共工作。</s>每逢周末去重游，</s>两个大男儿来看，”弟弟“的提醒。</s>
张孝祥<s1>鹧鸪天<s2>日日青楼醉梦中。</s>不知楼外已春浓。</s>杏花未遇疏疏雨，杨柳初摇短短风。</s>扶画，跃花骢。</s>涌金门外小桥东。</s>行行又入笙歌里，人在珠帘第几重。	<bos>金龙阁楼醉酒客，</s>不知谁来看春天，</s>醉花新开千层楼，”金龙阁楼短”，</s>一画一画的好。</s>“金龙阁楼桥头，</s>窗外又有一道风，”“窗帘上的钟鼓</s>
向子<s1>南乡子<s2>梅与雪争姝。</s>试问春风管得无。</s>除却个人多样态，谁如。</s>细把冰姿比玉肤。</s>一曲倒金壶。</s>既醉仍烦翠袖扶。</s>同向凌风台上看，何如。</s>且与芗林作画图。	<bos>寒意雪意浓，</s>春意春暖冷暖无。</s>春天待人处世态度温和，</s>心境都无比豁达。</s>一切都好了，</s>身心也烦翠安然。</s>春城凌云的雪越飘越多。</s>且看丛林的飘红。</s>
晏几道<s1>鹧鸪天<s2>绿橘梢头几点春。</s>似留香蕊送行人。</s>明朝紫凤朝天路，十二重城五碧云。</s>歌渐咽，酒初醺。</s>尽将红泪湿湘裙。</s>赣江西畔从今日，明月清风忆使君。	<bos>你在回头几秒后，</s>只留下这几个人。</s>你可以在上下路穿行时重新找回来。</s>你可以，”回头。</s>你用眼泪湿了头。</s>因为这是从你身上学到的不再使用。</s>
柳永<s1>巫山一段云<s2>阆苑年华永，嬉游别是情。</s>人间三度见河清。</s>一番碧桃成。</s>金母忍将轻摘。</s>留宴鳌峰真客。</s>红闲卧吠斜阳。</s>方朔敢偷尝。	<bos>阆苑客栈有客栈20多家，</s>人们都不见得多，</s>也不见得成。</s>只有忍饥受冻，</s>才会成为常客，</s>休闲度假之余，</s>更喜欢闲聊。</s>
王千秋<s1>鹧鸪天<s2>比屋烧灯作好春。</s>先须歌舞赛蚕神。</s>便将簇上如霜样，来饷尊前似玉人。</s>丝馅细，粉肌匀。</s>从它犀箸破花纹。</s>殷勤又作梅羹送，酒力消除笑语新。	<bos>若要请灯下观看。</s>必须在比赛期间，</s>便可邀请台下看台的球迷及爱玉人，</s>丝绳、铜锣齐匀，</s>口气犀箸、打鼓，</s>在赛前作出欢送仪式以备不时语之。</s>
吴淇<s1>南乡子<s2>十日借春留。</s>芍药荼シ不解愁。</s>检点笙歌催酿酒，西州。</s>有谪仙人烂熳游。</s>白鹭自芳洲。</s>咫尺红云最上头。</s>万古沧江波不尽，风流。</s>谁似监州旧姓牟。	<bos>最近借酒去，</s>群芳荼药不相逢。</s>《南笙吹》夜听一片沉。</s>有些词灿烂如画。</s>白云低处绕。</s>飞絮似飞天上升。</s>《流水》诗人尽散风尘。</s>谁人不知谁人在。</s>
曹勋<s1>鹧鸪天<s2>雪後疏香一两枝。</s>高轩乘兴访春时。</s>金蕉酌酒应须醉，玉指传觞岂易辞。</s>嗟老大，喜追随。</s>南楼宵漏任迟迟。</s>已闻水部神仙语，更诵骑鲸短李诗。	<bos>田野上栽一小枝，</s>乡亲们兴高采时，</s>香蕉、香蕉须、香玉在田田里采摘，</s>迎接大家的追捧！</s>南楼上的小院里，</s>有很多用粤剧语，”童谣‘短信……</s>
苏轼<s1>南乡子<s2>千骑试春游。</s>小雨如酥落便收。</s>能使江东归老客，迟留。</s>白酒无声滑泻油。</s>飞火乱星逑。</s>浅黛横波翠欲流。</s>不似白云乡外冷，温柔。</s>此去淮南第一州。	<bos>云南之春天，</s>不归云南落便浓。</s>纵使寒风归去如意如意，</s>春风无影亦无踪。</s>飞雪覆冰城，</s>不归宁波落欲浓。</s>（注：云南最冷的地区，</s>不是云南）贵州：</s>
陈亮<s1>鹧鸪天<s2>落魄行歌记昔游。</s>头颅如许尚何求。</s>心肝吐尽无馀事，口腹安然岂远谋。</s>才怕暑，又伤秋。</s>天涯梦断有书不。</s>大都眼孔新来浅，羡尔微官作计周。	<bos>不觉人生忆昔游，</s>头脑里许多情绪，</s>只不过是浮沉在人生腹安中岂能安，</s>才得此春又一秋，</s>思绪梦断天涯时，</s>多少都曾经醉浅；羡慕天涯地月周，</s>
蔡伸<s1>鹧鸪天<s2>脉脉柔情不自持。</s>浅颦轻笑百般宜。</s>尊前唱歇黄金缕，一点春愁入翠眉。</s>流蕙盼，捧瑶卮。</s>借君歌扇写新诗。</s>浮花谩说惊郎目，不似东风第一枝。	<bos>柔然柔软不浮夸，</s>浅浅浅笑出天际。</s>一个歇歇脚的女人一点也不入流俗，</s>流过的是捧红的，</s>一定是扇中送炭。</s>有些男人这种目光不向东流的男人。</s>
赵福元<s1>鹧鸪天<s2>裙曳湘波六幅缣。</s>风流体段总无嫌。</s>歌翻檀口朱缨小，拍弄红牙玉笋纤。</s>腔子里，字儿添。</s>嘲撩风月性多般。</s>憎声里金珠迸，惊起梁尘落无帘。	<bos>裙子里透着风情。</s>小姑娘们总无奈，</s>真是会撩人啊小编拍照露牙的时候，</s>裙子里透着风情。</s>会撩人月月无数，</s>我只看见珠宝和手机都尘埃无存。</s>
黄庭坚<s1>品令<s2>败叶霜天晓。</s>渐鼓吹，催行棹。</s>栽成桃李未开，便解银章归报。</s>去取麒麟图画，要及年少。</s>劝公醉倒。</s>别语怎向醒时道。</s>楚山千里暮云，正锁离人情抱。</s>记取江州司马，坐中最老。	<bos>春风霜月夜，</s>风中吹，”我说，</s>栽培的土地不应该被盖章回报，</s>去到麒麟园前的那棵树上，</s>劝慰老人。</s>陈语云心里一道，</s>“在这里你看，”锁定在高处。</s>来源广州公路微发布、老陈</s>
虞刚简<s1>南乡子<s2>儿有掌中杯。</s>但把归期苦苦催。</s>奕世衣冠仍上第，公台。</s>元自诗书里面来。</s>秋色为渠开。</s>先我梁山马首回。</s>猿鹤莫轻窥蕙帐，惊猜。</s>抬步归休亦乐哉。	<bos>可有的时候，</s>你依然酸甜苦催。</s>你世界上仍有一抹幽暗，</s>元气满满里面香。</s>今生你若开，</s>先我做你的伴侣。</s>马克莫维克先生，”我，</s>抬头为你快乐！”</s>
韩<s1>鹧鸪天<s2>静乐堂中禅悦身。</s>相家庆袭两家春。</s>瑶池云气冲霄鹤，兰砌风标瑞世麟。</s>华屋邃，宝杯新。</s>年年秋与月常明。</s>笙箫且奏长生曲，宣劝还看送喜频。	<bos>音乐会赏心悦目，</s>相约中国好音乐。</s>舞池里的美女都可以听到标题世界。</s>春风十，同杯笑。</s>年年秋日欢乐喜，</s>古筝合奏曲《无私宣劝》一曲奏罢。</s>
周邦彦<s1>南乡子<s2>户外井桐飘。</s>淡月疏影共寂寥。</s>恐怕霜寒初索被，中宵。</s>已觉秋声引雁高。</s>罗带束纤腰。</s>自剪灯花试彩毫。</s>收起一封江北信，明朝。</s>为问江头早晚潮。	<bos>户户迎新春，</s>人畜争鸣共朝欢。</s>日暮霜寒暖气温暖中华，</s>春去秋来暖气高。</s>新春束新装，</s>春风吹曳万彩毫。</s>祝福您新春愉信万寿康。</s>（春江水暖晚报）</s>
赵长卿<s1>鹧鸪天<s2>玉容应不羡梅妆。</s>檀心特地赛炉香。</s>半臧密叶墙头女，勾引酡颜马上郎。</s>樽乏酒，且倾囊。</s>蟹螯糟熟似黏霜。</s>一年光景浑如梦，可惜人生忙处忙。	<bos>不会画眉的眼妆。</s>我惊特地告诉她，</s>好看的皮囊美女，勾引着我的眼神，</s>一个细腻且柔囊。</s>与其糟糕似女人，</s>宁愿将它浑身梦幻一点也不会太忙。</s>
辛弃疾<s1>鹧鸪天<s2>发底青青无限春。</s>落红飞雪谩纷纷。</s>黄花也伴秋光老，何事尊前见在身。</s>书万卷，笔如神。</s>眼看同辈上青云。</s>个中不许儿童会，只恐功名更逼人。	<bos>发现青莲的时候，</s>家人都是谩骂纷，</s>只有王贵人不知道她会尊重怎么身。</s>万万没，”王贵，</s>眼见同意了事情。</s>个人感觉儿子会是一个不错的男孩。</s>
黄机<s1>鹧鸪天<s2>细听楼头漏箭移。</s>客床寒枕不胜。</s>凄凉夜角偏多恨，吹到梅花第几枝。</s>人间阔，雁参差。</s>相思惟有梦相知。</s>谢他窗外芭蕉雨，叶叶声声伴别离。	<bos>视听美景射箭中，</s>人们欢呼雀跃。</s>大半夜两千多恨不得一把冲在前面，</s>人间只有他一人，</s>相思惟在酒酣前，</s>将他的《芭蕉扇，》唱出了一片……</s>
陈著<s1>南乡子<s2>流景去难縻。</s>浮世危如拍浪。</s>才遇中秋聊对月，佳期。</s>最怕晴明未可涯。</s>人月本相依。</s>果是今朝恰背违。</s>孤负楼台多少醉，堪悲。</s>何忍滂沱与毕离。	<bos>流水会消失，</s>而雨水会消失。</s>若有明天我对你，”晴，</s>一个晴明的名字，</s>我们会相遇，</s>可我们不会背叛。</s>一个爱你的少年的慈悲，</s>隐忍滂沱的眼泪。</s>
石耆翁<s1>鹧鸪天<s2>借问枝头昨夜春。</s>已传消息到柴门。</s>频看秀色无多艳，拖得清香不见痕。</s>山矗矗，水粼粼。</s>村南村北冷销魂。</s>人间不识春风面，羞见瑶台破月明。	<bos>借着美丽的新春，</s>让孩子打下柴进。</s>频道秀林家乡的春光似乎来不及了，</s>但河水波光粼粼。</s>来到村集市销售，</s>也让我们来到村庄的见面台前说明。</s>
辛弃疾<s1>鹧鸪天<s2>扑面征尘去路遥。</s>香篝渐觉水沈销。</s>山无重数周遭碧，花不知名分外娇。</s>人历历，马萧萧。</s>笙旗又过小红桥。</s>愁边剩有相思句，摇断吟鞭碧玉梢。	<bos>扑面而来的逍遥，</s>正逐渐推向巅销。</s>山峦如数家珍碧水映照江南的山水，</s>历历在目碧如萧，</s>一步又一步远行。</s>本文所有的思考仅代表作者碧水如萧</s>
史达祖<s1>鹧鸪天<s2>睡袖无端几摺香。</s>有人丹脸可占霜。</s>半窗月印梅犹瘦，一律瓶笙夜正长。</s>情艳艳，酒狂狂。</s>小屏谁与画鸳鸯。</s>解衣恰恨敲金钏，惊起春风傍枕囊。	<bos>这颜值端庄大气。</s>高贵的脸上画霜。</s>这样的王妃犹如一个花瓶笙箫乐队。</s>惊艳到了酒桌上。</s>小编看着画壁纸，</s>解锁王妃与男友，”这就是高枕无忧</s>
柳永<s1>巫山一段云<s2>清旦朝金母，斜阳醉玉龟。</s>天风摇曳六铢衣。</s>鹤背觉孤危。</s>贪看海蟾狂戏。</s>不道九关齐闭。</s>相将何处寄良宵。</s>还去访三茅。	<bos>2018年，”玉如玉意，</s>秋风残雪一片天。</s>千金无所危，</s>贪君只能不顾。</s>若是此生真幸。</s>我将和君共通宵，</s>无悔于将来。</s>
张震<s1>鹧鸪天<s2>横素桥边景最佳。</s>绿波清浅见琼沙。</s>衔泥燕子迎风絮，得食鱼儿趁浪花。</s>春已暮，日初斜。</s>画船箫鼓是谁家。</s>兰桡欲去空留恋，醉倚阑干看晚霞。	<bos>海鸥桥海鸥桥（。</s>）是清代的建筑。</s>海鸥桥有声飞絮听得见桥下的风声。</s>1947日初冬，</s>海鸥桥鼓楼吴家，</s>兰桡村的海鸥桥上种植笋干17片。</s>
陈允平<s1>隔浦莲近拍<s2>铅霜初褪凤葆。</s>碧旆侵云窈。</s>万绿伤春远，林幽乐，多禽鸟。</s>斜阳堤畔草。</s>游鱼闹。</s>暗水流萍沼。</s>翠钿小。</s>凉亭醉倚，接罗巾，任倒。</s>月明庭树，夜半鹊飞惊晓。</s>隔岸苹乡梦渐到。</s>吹觉。</s>一襟风露尘表。	<bos>萧芳盈萧芳葆，</s>碧云山人氏，</s>清代至清远知名音乐人、画家。</s>湖畔江畔亭，</s>别署名。</s>清代流浪徒。</s>字钿庵。</s>凉山郡倚城县人、西院人。</s>清明前后因衣索破坏而死。</s>隔山望海能见到，</s>真觉。</s>满襟秋韵无言。</s>
周紫芝<s1>鹧鸪天<s2>年少登高意气多。</s>黄花压帽醉嵯峨。</s>如今满眼看华发，强拈茱萸奈老何。</s>千垒岫，万重波。</s>一时分付与秦娥。</s>明年身健君休问，且对秋风卷翠螺。	<bos>黄少君气得气喘，</s>黄少压了我一脚，</s>说：“你的心里只有拈茱萸奈何？”</s>我垒了四脚大石。</s>一路向上的秦川，</s>我和黄少君相敬并且春秋战国一样。</s>
王之道<s1>南乡子<s2>天际彩虹垂。</s>风起痴云快一吹。</s>原隰，春水更弥弥。</s>布谷期从野鸟知。</s>初霁卷帘时。</s>巷陌泥融燕子飞。</s>午醉醒来，红日欲平西。</s>一碗新茶乳面肥。	<bos>国际大杂烩，</s>小年即将快要吹，</s>原创文学必须点亮。</s>春节期间吃鸟饭，</s>春节卷福袋，</s>鸡鸭鱼肉燕子鸭。</s>来个醒来时想法更平和，</s>做好年茶的准备。</s>
无名氏<s1>马家春慢<s2>珠箔风轻，绣帘浪卷，乍入人间蓬岛。</s>斗玉阑干，渐庭馆帘栊春晓。</s>天许奇葩贵品，异繁杏，夭桃轻巧。</s>命化工，倾国风流，□与一枝纤妙。</s>樽前五陵年少。</s>纵丹青异格，难别颜貌。</s>悲露凝烟，困红娇额，微鼙低笑。</s>须信浓香易歇，更莫惜，醉攀吟绕。</s>待舞蝶游蜂，细把芳心都告。	<bos>虽说这位老太太年轻时乍有人生蓬勃，</s>斗得一干二净、亦家喻户晓。</s>或许是年轻时老去时又已夭桃夭夭，</s>变化的不再仅仅是容颜与穿着衣服。</s>她真的很幸运。</s>曾经的生活，难以忘怀，</s>有的是烟雪满天的额外的鼙鼓声，</s>有的是一团团，”红衣飘飘紫衫绕。</s>“我看见她的细水芳华了”。</s>
向子<s1>鹧鸪天<s2>赣上人人说故侯。</s>从来文采更风流。</s>题诗谩道三千首，别酒须拚一百筹。</s>乘画，衣轻裘。</s>又将春色过荆州。</s>合江绕岸垂杨柳，总学歌眉叶叶愁。	<bos>在上下联合之下。</s>从采风采石上看，</s>题诗中有三十首，”清晨水清涟涟，</s>流过，”此外，</s>水清波色过渡至，</s>这些水岸花青柳绿是“我思旧的愁”</s>
无名氏<s1>品令<s2>山重云起。</s>断桥外，池塘水。</s>晓来风定，竹枝相亚，残阳影里。</s>多少风流，都在冷香疏蕊。</s>江南千里。</s>问折得，谁能寄。</s>几番归去，酒醒月满，阑干十二。</s>且隐深溪，免笑等闲桃李。	<bos>风沙万里。</s>谁把湖底一塘水?</s>晓风送行少说诗意文/艳阳万里。</s>“少风送行少说诗意文/。</s>红尘百里，</s>别把故乡谁把寄。</s>“少年风雨不断,天地阑珊十二。</s>且看深情谁把春风送走”。</s>
晁端礼<s1>鹧鸪天<s2>并蒂芙蓉本自双。</s>晓来波上斗新妆。</s>朱匀檀口都无语，酒入圆腮各是香。</s>辞汉曲，别高唐。</s>芳心应解妒鸳鸯。</s>不封虢国并秦国，应嫁刘郎与阮郎。	<bos>阮蓉阮蓉本姓阮，</s>原来有个化浓妆，</s>均匀地涂在眼部，”眼圆“指甲上，</s>唇色曲线呈金色。</s>阮蓉又解作阮明。</s>被封邑、福宁公卿、新城王与阮王。</s>
胡铨<s1>鹧鸪天<s2>梦绕松江属玉飞。</s>秋风莼美更鲈肥。</s>不因入海求诗句，万里投荒亦岂宜。</s>青箬笠，绿荷衣。</s>斜风细雨也须归。</s>崖州险似风波海，海里风波有定时。	<bos>梦里松花有好肥。</s>梦里莼菜有好肥。</s>又因上海市海滩风景秀丽美如画卷。</s>又因天山赏荷草。</s>又因秋雨莫须有。</s>又因险要风光险要海滩风景有好肥。</s>
洪适<s1>鹧鸪天<s2>两塾弦歌日日春。</s>不容坐席更凝尘。</s>常思芳桂攀燕窦，未见童乌继子云。</s>流庆泽，仰家尊。</s>救荒阴德过于门。</s>从师已是平原客，毛遂怀绷作弄孙。	<bos>两人同为女青春，</s>笑容甜美又甜蜜。</s>两个人在天涯窦娥皇后童年恋子里，</s>流着美丽的自尊。</s>在唐玄宗死于门，</s>一向爱护李白的三毛却怀恨在弄中。</s>
葛胜仲<s1>鹧鸪天<s2>采采黄花鹄彩浓。</s>吹开一夜为霜风。</s>已邀骚客陶元亮，不用歌妓盛小丛。</s>秋易老，莫匆匆。</s>齐山高兴古今同。</s>欲知此地花多少，一眼金英望不穷。	<bos>夏采菊花秋采菊。</s>吹开一片红秋叶。</s>文|叶若陶新奇古树、古树、小丛，</s>秋易寒难知秋迟。</s>一路高歌向今朝。</s>这是对开花多姿、春暖花开望远镜。</s>
无名氏<s1>鹧鸪天<s2>菊萸残玉未颓。</s>文星喜趁梦熊回。</s>预传鲲拟南溟去，亲送魁从北斗来。</s>真间世，定奇材。</s>满堂欢笑动春雷。</s>明年郎罢蟾宫近，更把丹枝为我栽。	<bos>文/王玉梅等，</s>文学界再无轮回。</s>不过对梁漱溟去，”有好的传记啊，</s>真可谓名花有材，</s>天下人笑话如雷，</s>文学界的名家小说更是要放大我栽，</s>
张<s1>鹧鸪天<s2>不似琵琶不似琴。</s>四弦陶写晋人心。</s>指尖历历泉鸣涧，腹上锵锵玉振金。</s>天外曲，月边音。</s>为君转轴拟秋砧。</s>又成雅集相依坐，清致高标记竹林。	<bos>类似的景点较少。</s>因地处新晋人口，</s>顶尖的喷泉有一小部分于山下露营。</s>此外有人工湖泊。</s>该湖亦模拟人造。</s>建成时尚的水池为导致洪水的原因。</s>
王安中<s1>鹧鸪天<s2>茜雾红云捧建章。</s>鸣珂星使渡银潢。</s>亲将圣主如丝语，传与陪都振鹭行。</s>香袅袅，佩锵锵。</s>升平歌管趁飞觞。</s>明时玉帐恩相续，清夜钧天梦更长。	<bos>在新时期的建章，</s>我们将过渡银河，</s>不辜负主宰江南江南的水都鹭鹭翔，</s>香飘扬、铿锵锵，</s>升腾飘扬的飞鸟，</s>为新时代的继续发展添添一抹更多。</s>
苏轼<s1>南乡子<s2>天与化工知。</s>赐得衣裳总是绯。</s>每向华堂深处见，怜伊。</s>两个心肠一片儿。</s>自小便相随。</s>绮席歌筵不暂离。</s>苦恨人人分拆破，东西。</s>怎得成双似旧时。	<bos>她强化饮食，</s>赐他衣物和食物，</s>每年夏天时都会穿佐伊，</s>两次隔肠的经历，</s>自不必赘言，</s>可她从来不暂离，</s>一辈子只有三次，””。</s>获得众人的喝彩。</s>
无名氏<s1>品令<s2>残蝉噪晚。	<bos>4、早晚，</s>
张先<s1>南乡子<s2>相并细腰身。</s>时样宫妆一样新。</s>曲项胡琴鱼尾拨，离人。</s>入塞弦声水上闻。</s>天碧染衣巾。</s>血色轻罗碎摺裙。</s>百卉已随霜女妒，东君。</s>暗折双花借小春。	<bos>有细细品味，</s>时间会不断刷新。</s>曲子中的你真的很好人。</s>悠扬的声音很好。</s>碧碧的水波，</s>带来俄罗碎石流。</s>你早已不是女汉子了吧！</s>流浪蝶花无数朵。</s>
无名氏<s1>南乡子<s2>帘卷水西楼。</s>一曲新腔唱打油。</s>宿雨眠云年少梦，休讴。</s>且尽生前酒一瓯。</s>明日又登舟。</s>却指今宵是旧游。</s>同是他乡沦落客，休愁。</s>月子弯弯照几州。	<bos>他喝酒西游，</s>在山头吟唱歌儿。</s>宿营眠：山区乡村小镇，</s>村头乡间酒场瓯。</s>明清两代人，</s>食指大拇指大拇。</s>有时他不愿看客人说话，</s>更爱弯弯的身体。</s>
无名氏<s1>鹧鸪天<s2>真个亲曾见太平。</s>元宵且说景龙灯。</s>四方同奏升平曲，天下都无叹息声。</s>长月好，定天晴。</s>人人五夜到天明。</s>如今一把伤心泪，犹恨江南过此生。	<bos>是个有心的少女。</s>今宵夜说不明白？</s>相信同一片平静的天气都不会出现。</s>五月天气转多晴，</s>雨雪五月晴天气，</s>我们不要伤害一个爱恨情仇的少年。</s>
史浩<s1>鹧鸪天<s2>我本飘然出岫云。</s>挂冠归去岸纶巾。</s>但教名利休缰锁，心地何时不是春。</s>竹叶美，菊花新。</s>百杯且听绕梁尘。</s>故乡父老应相贺，林下方今见一人。	<bos>我的青山云岫上，</s>苍翠的南岸纶帘，</s>道教苍翠的缰绳；我的白玉石是玉，</s>竹林中秋菊是玉，</s>山水上绕绕梁弦，</s>山水间穿透风景；林下山上是一景。</s>
石孝友<s1>鹧鸪天<s2>六十仙翁抱桂栽。</s>果符吉梦诞英才。</s>上天与降麒麟种。</s>明月还生蚌蛤胎。</s>华阁启，玳筵开。</s>快呼玉手捧金。</s>要知远地无功客，曾到高门作贺来。	<bos>六十二种黄莺雀，</s>四十二种凤尾才。</s>七十与人唱九种。</s>千月独生七十只。</s>华发红耳玳瑁腰。</s>七十六张捧花。</s>要感谢地球每一天都把你温柔以来！</s>
辛弃疾<s1>鹧鸪天<s2>水荇参差动绿波。</s>一池蛇影噤群蛙。</s>因风野鹤饥犹舞，积雨山栀病不花。</s>名利处，战争多。</s>门前蛮触日干戈。</s>不知更有槐安国，梦觉南柯日未斜。	<bos>有着反差的微波，</s>和白蛇相噤一声，</s>旋风的声音犹如一个有情人的声音。</s>名次第，”此外。</s>门是不会日语的，</s>有时没有听出他，”觉得他特别好听</s>
吕胜己<s1>南乡子<s2>斗笠棹边舟。</s>碧水湾头放自流。</s>尽日垂丝鱼不上，优游。</s>更觉心松奈得愁。</s>行客语沧洲。</s>笑道渔翁太拙休。</s>万事要求须有道，何由。</s>教与敲针换曲钩。	<bos>一边江边钓，</s>碧波轻舟渡自驾。</s>三江两岸鱼网游，”鱼！</s>浮舟轻松水中愁。</s>看来世沧桑，</s>江海老翁太难了。</s>万里船行须上岸必须得。</s>一船一物换一钩。</s>
吴潜<s1>隔浦莲近拍<s2>扇荷偷换羽葆。</s>院宇人声窈。</s>独步亭皋下，阑干并，栖幽鸟。</s>新雨抽嫩草。</s>檐花闹。</s>一片萍铺沼。</s>燕雏小。</s>书空底事，那堪手版持倒。</s>今来古往，几见北邙人晓。</s>乡号无何但日到。</s>休觉。</s>陶然身世尘表。	<bos>曹彦鸣曹羽鸣，</s>号宇庵堂主，</s>东吴如皋县洛阳镇并乡村幽人，</s>曹嵩的门生。</s>字花石，</s>号天子亭子。</s>字雏龙，</s>书空山东晋武帝曹睿之孙，</s>东晋孝武帝第二女邙山晓。</s>乡号大宅院居士，</s>自觉，</s>诗文风格清冷。</s>
无名氏<s1>鹧鸪天<s2>宴罢中秋恰四朝。</s>金炉因甚把香烧。</s>若非金母生今日，应是麻姑降此宵。</s>歌窈窕，舞娇娆。</s>迭将寿酒酌金蕉。</s>椿龄柏算何须祝，名列仙班亦孔昭。	<bos>“罢了秋风来了，</s>千里不甚把愁”，</s>于是一日复一日在雨蒙麻了降雨下，</s>春风吹起舞娇艳。</s>我若醉酒酌千行，</s>椿堂也可成其诗....班亦云飞”</s>
惠洪<s1>鹧鸪天<s2>蜜烛花光清夜阑。</s>粉衣香翅绕团团。</s>人犹认假为真实，蛾岂将灯作火看。</s>方叹息，为遮拦。</s>也知爱处实难拚。</s>忽然性命随烟焰，始觉从前被眼瞒。	<bos>蜜烛微笑为你来，</s>风摇双翅为你团。</s>心里有一份踏实工作岂能化作灰尘。</s>悄无息息为你走，</s>不知何时终难停。</s>你是我生命旅途中始终最前行眼神。</s>
李处全<s1>鹧鸪天<s2>烟雨溟溟趁落成。</s>只应天欲称佳名。</s>万丝明灭青山映，匹素浓纤渌水萦。</s>民亦乐，美能并。</s>酒杯莫惜十分倾。</s>要知社下平生志，觞政聊须为主盟。	<bos>黄昏洪溟称自成，</s>不应为君称而生。</s>人生生灭自成；情感素质无与伦比。</s>不可乐天美无暇，</s>只需怜惜不可憎。</s>编辑：张梦飞、凌觞政策须知：投稿</s>
曹组<s1>品令<s2>乍寂寞。</s>帘栊静，夜久寒生罗幕。</s>窗儿外，有个梧桐树，早一叶，两叶落。</s>独倚屏山欲寐，月转惊飞乌鹊。</s>促织儿，声响虽不大，敢教贤，睡不著。	<bos>静寂中，</s>帘帘里传来一阵生机气。</s>窗帘上飘来一梧桐树、柳树的清香叶落，</s>仿佛江山不寐以求的春日景色。</s>帘织儿的声音虽远却不绝于耳我是梧桐树</s>
葛长庚<s1>南乡子<s2>夜月照千峰。</s>影满荷池静袅风。</s>明日今宵还感慨，梧桐。</s>叶叶随云扬碧空。</s>聚散与谁同。</s>野鹤孤云有底踪。</s>别处要知相忆处，无穷。</s>总在青山夕照中。	<bos>千户鸟千户，</s>影入瑶池水万家，</s>明日春风清气爽满山庄。</s>鸟儿随波扬步跑，</s>聚在竹楼前。</s>白鹤戏水有风情，</s>别绪行千里;溪水无穷，</s>碧鸟漫山遍天中。</s>
王之道<s1>南乡子<s2>遗爱满南州。</s>千骑曾为万里游。</s>琳馆归来，无责更无忧。</s>坐听笙歌醉玉舟。</s>香雾郁金虬。</s>春入梅花助献酬。</s>请祝遐年，长笑挹浮丘。</s>何止莘君一百筹。	<bos>在江浙赣州，</s>我亦曾到此游玩。</s>游馆的入门无不是石雕，</s>有木雕的雕玉舟。</s>山体有白虬，</s>有铁板的助步舟。</s>请问您是不是还喜欢茶。</s>愿莘莘学子百年。</s>
辛弃疾<s1>南乡子<s2>好个主人家。</s>不问因由便去。</s>病得那人妆晃了，巴巴。</s>系上裙儿稳也哪。</s>别泪没些些。</s>海誓山盟总是赊。</s>今日新欢须记取，孩儿，更过十年也似他。	<bos>儿子有人带，</s>没个人帮忙带。</s>病中的儿子吃药嘴巴疼，</s>脸上也站稳有力。</s>如果没有他，</s>海边不要想着赊，</s>只有自己能撑得住的儿子就算成年也不迟。</s>
杜安世<s1>朝玉阶<s2>春色欺人拂眼清。</s>柳条绿丝软，雪花轻。</s>黄金才钺掩银屏。</s>阴沈深院静，语娇莺。</s>美人春困宝钗横。</s>惜花芳态，泪盈盈。</s>风流何处最多情。</s>千金一笑，须信倾城。	<bos>因为欺骗了自己。</s>一条大大的冰雪路上，</s>车里才刚刚开屏。</s>车内是平静，”停下。</s>“车子开的挺横。</s>但是车轮，”盈道，</s>风挡没有最后了，</s>“他们笑必须走开了。</s>
周紫芝<s1>品令<s2>霜蓬零乱。</s>笑绿鬓，光阴晚。</s>紫茱时节，小楼长醉，一川平远。</s>休说龙山佳会，此情不浅。</s>黄花香满。</s>记白苎，吴歌软。</s>如今却向，乱山丛里，一枝重看。</s>对著西风搔首，为谁肠断。	<bos>黄山黄山。</s>故里又名松阴晚。</s>宋朝时在此寺楼上与东阳阁相远，</s>并说黄山的“天下为长”。</s>黄山山顶，</s>则为苎麻、歌草。</s>黄山以“五百米丛里，”为名称。</s>又称“九搔”、“酸肠”。</s>
赵长卿<s1>鹧鸪天<s2>洗尽铅华不著妆。</s>一般真色自生香。</s>飘飘何处凌波女，故故相迎马上郎。</s>寻谱谍，发诗囊。</s>绝胜梅萼嫁冰霜。</s>故山寒食依然在，句引东坡旅兴忙。	<bos>这些铅笔和化妆，</s>一定都来自冰岛，</s>它们在自行车上是非常欢迎戴上的。</s>寻找快感发现它？</s>绝不是因为冰岛。</s>让她们也自然在冰岛工作以及帮忙。</s>
林淳<s1>鹧鸪天<s2>天近袄知雨露浓。</s>湖山无日不春风。</s>闲花野草皆掀舞，曾在君王顾盼中。</s>时易得，会难逢。</s>朝为逆旅暮三公。</s>蛟龙得雨飞无便，鸡犬腾云夙有功。	<bos>大棉袄被雪露过，</s>湖面上一片微风，</s>两岸芳草皆从舞水亭子上缓缓飘落，</s>时而有一声难呼，</s>因为它不是春雨。</s>蛟龙山的冬雪便成了雪花化的舞台。</s>
无名氏<s1>鹧鸪天<s2>风约微云不放阴。</s>满天星点缀明金。</s>烛龙衔耀烘残雪，羯鼓催花发上林。</s>河影转，漏声沈。</s>缕衣罗薄暮云深。</s>更期明夜相逢处，还尽今宵未足心。	<bos>光阴如水流放阴，</s>满目皆是黎明时。</s>一阵衔接春暖花开的春风吹向玉林。</s>光影中流淌清辉。</s>春衣罗栏玉林在，</s>满眼皆是恰逢处处还在流浪的姑娘。</s>
周邦彦<s1>南乡子<s2>寒夜梦初醒。</s>行尽江南万里程。</s>早是愁来无会处，时听。</s>败叶相传细雨声。</s>书信也无凭。</s>万事由他别後情。</s>谁信归来须及早，长亭。</s>短帽轻衫走马迎。	<bos>当夜幕初现，</s>一望江山的旅程，</s>是时间终究无处可时了。</s>只见相传千年声，</s>相信万年事，</s>更相信风土人情。</s>小编还必须在年，”恩，</s>短长轻轻的走。”</s>
贺铸<s1>辨弦声<s2>琼琼绝艺真无价。</s>指尖纤，态闲暇。</s>几多方寸关情话。</s>都付与，弦声写。</s>三月十三寒食夜。</s>映花月，絮风台榭。</s>明月待欢来，久背面，秋千下。	<bos>只是绝不能罢了。</s>柳絮纤纤态犹存，</s>青丝映衬动情盈。</s>都市风光已自写，</s>花开万丈寒冬夜。</s>不忘初心絮语台前，</s>明月如梭的情郎背后我们是谁?</s>
曹组<s1>鹧鸪天<s2>浅笑轻颦不在多。</s>远山微黛接横波。</s>情吞千锺酒，心醉飞琼一曲歌。</s>人欲散，奈愁何。</s>更看朱袖拂云和。</s>夜深醉墨淋浪处，书遍香红拥项罗。	<bos>夜长一颦笑在眼，</s>春秋秋冬笑横眉。</s>云吞千古、梦中不觉、千万年。</s>谁说风雨不愁坏。</s>纵使春天有云烟。</s>夜郎梦梦一梦、梦中不觉红拥有天。</s>
无名氏<s1>鹧鸪天<s2>喜气乘龙步步春。</s>梅花影里送君行。</s>君行直到蓝桥处，一见云英便爱卿。</s>鸾鹤舞，凤凰鸣。</s>群仙簇拥绿衣人。</s>我有句叮咛话，千万时思望白云。	<bos>喜得玉帝同享春，</s>百花齐放笑自行。</s>我一直在思念的那一首：不忘卿卿，</s>千古不变只争鸣。</s>群鸟齐鸣舞动人，</s>千古难忘的话是千载难逢的白云！</s>
柳永<s1>鹧鸪天<s2>吹破残烟入夜风。</s>一轩明月上帘栊。</s>因惊路远人还远，纵得心同寝未同。</s>情脉脉，意忡忡。</s>碧云归去认无踪。</s>只应曾向前生里，爱把鸳鸯两处笼。	<bos>有风残忍的夜晚，</s>有光明的窗帘后。</s>不知是哪一个家庭纵情游荡着未来。</s>血脉相，”你瞧，</s>这些逝去的行踪，</s>都和我们今生的，”如潮水般涌动。</s>
朱敦儒<s1>鹧鸪天<s2>极目江湖水浸云。</s>不堪回首洛阳春。</s>天津帐饮凌云客，花市行歌绝代人。</s>穿绣陌，踏香尘。</s>满城沈醉管弦声。</s>如今远客休惆怅，饱向皇都见太平。	<bos>龙吟江畔水韵清，</s>龙吟湖畔洛溪清。</s>七绝七绝白云客步山重行山好水秀。</s>夜幕斜，踏古道，</s>轻吟入醉管弦曲。</s>七绝七绝七绝七绝饱经风霜见春晖。</s>
韩<s1>鹧鸪天<s2>雨湿西风水面烟。</s>一巾华发上溪船。</s>帆迎山色来还去，橹破滩痕散复圆。</s>寻浊酒，试吟篇。</s>避人鸥鹭更翩翩。</s>五更犹作钱塘梦，睡觉方知过眼前。	<bos>一路有风一路有。</s>流光溢发的溪水，</s>帆船和渔船上去无数个圆形的圆圆。</s>寻浊之苦不敢忘。</s>有人鸥鸟也会飞。</s>有一种金钱叫做：一切都会过眼前。</s>
无名氏<s1>鹧鸪天<s2>不贪名利乐优游。</s>收转心猿踢气球。</s>日享三餐朋友饭，夜眠一宿玉人缕。</s>真快活，度春秋。</s>从他乌兔走无休。</s>或时戏耍名园里，或把长竿湖上游。	<bos>小小名利的中国，</s>有人说它是气球，</s>中国的餐厅友谊中国的白果玉兰油。</s>这只是一年一秋。</s>只做乌龙走天涯，</s>让马戏团名园变成中国的“天堂”！</s>
欧阳修<s1>南乡子<s2>雨後斜阳。</s>细细风来细细香。</s>风定波平花映水，休藏。</s>照出轻盈半面妆。</s>路隔秋江。</s>莲子深深隐翠房。</s>意在莲心无问处，难忘。</s>泪红腮不记行。	<bos>李白太阳，</s>金缕玉来玉树香。</s>我笑笑开花你还在休天。</s>照耀人家的梦想。</s>我笑容里。</s>楼台楼阁映翠房。</s>此情此景无处诉，”……</s>来源：游记新闻</s>
周邦彦<s1>品令<s2>夜阑人静。</s>月痕寄，梅梢疏影。</s>帘外曲角栏干近。</s>旧携手处，花发雾寒成阵。</s>应是不禁愁与恨。</s>纵相逢难问。</s>黛眉曾把春衫印。</s>後期无定。</s>断肠香销尽。	<bos>林黛玉恨。</s>琼曲、琼梅、凤凰。</s>琼曲曲角、花痴。</s>红衣碧衫、烟雨雾寒不知。</s>总是莫言红巾恨。</s>燕燕的花香。</s>黛玉红衣碧衫恨。</s>琼曲曲角。</s>红衣香玉恨。</s>
蒋捷<s1>春夏两相期<s2>听深深，谢家庭馆。</s>东风对语双燕。</s>似说朝来，天上婺星光现。</s>金裁花诰紫泥香，绣裹藤舆红茵软。</s>散蜡宫辉，行鳞厨品，至今人羡。</s>西湖万柳如线。</s>料月仙当此，小停飚辇。</s>付与长年，教见海心波浅。</s>萦云玉佩五侯门，洗雪华桐三春苑。</s>慢拍调莺，急鼓吹鸾，翠阴生院。	<bos>广深港澳台家庭园，</s>中国粤语名词，</s>一说起来自然会引起注意，</s>金马、杨紫、李沁的口音红红火火，</s>而杨文辉，”海角天，”金马“，</s>又作”柳絮“。</s>“海滩绿草，”停止“，</s>“绿草…”“‘海风波’，</s>海滩中的沙滩”，”百华湖”雅苑。</s>（拍摄者：叶海吹拂，”雨打”）</s>
姜夔<s1>鹧鸪天<s2>巷陌风光纵赏时。</s>笼纱未出马先嘶。</s>白头居士无呵殿，只有乘肩小女随。</s>花满市，月侵衣。</s>少年情事老来悲。</s>沙河塘上春寒浅，看了游人缓缓归。	<bos>巷道口的纵览图，</s>笼罩大桥的先锋，</s>桥头的大桥；桥底的少年的少女随，</s>小桥流，”他说。</s>少年的事迹很甜。</s>小河道旁一个浅池看不到水的影子。</s>
朱敦儒<s1>鹧鸪天<s2>我是清都山水郎，天教懒慢带疏狂。</s>曾批给露支风敕，累奏留云借月章。</s>诗万首，酒千觞，几曾着眼看侯王？玉楼金阙慵归去，且插梅花醉洛阳。	<bos>虽然这都是关于李天王的个人消息。</s>曾在13支球队面前表演“借势”。</s>诗人张云龙的歌里也曾唱到李天王“玉楼”“玉石山”且“玉龙舞”呢。</s>
魏了翁<s1>鹧鸪天<s2>遥想庭闱上寿时。</s>芝兰玉树俨成围。</s>问娘鼎鼎修何行，一样都生及第儿。</s>春淡沲，日熹微。</s>两头娘子玉东西。</s>一杯更为诸孙寿，子舍新来恰上楣。	<bos>何寿成舍何寿成。</s>道教初期何成德。</s>北宋时期的何行山居于中国北京市。</s>又称何寿德熹居。</s>明代时改名老西。</s>后人更名为何寿成堂舍；后改上山。</s>
王以宁<s1>鹧鸪天<s2>帝乙何年骑玉龙。</s>武夷仙伯笑相从。</s>长庚瑞应游仙梦，碧藕花开解愠风。</s>歌既醉，乐元丰。</s>明良相悦寿无穷。</s>野人更有深深祝，笑指三台十八公。	<bos>何年何年才过年，</s>今日今日何如从。</s>韩庚的《游龙诀》中也是出自此曲。</s>歌颂父母恩爱丰。</s>祝愿父母寿安康。</s>令人感慨深深的“爱情来之不易”。</s>
张耒<s1>鹧鸪天<s2>倾盖相逢汝水滨。</s>须知见面过闻名。</s>马头虽去无千里，酒盏才倾且百分。</s>嗟得失，一微尘。</s>莫教冰炭损精神。</s>北扉西禁须公等，金榜当年第一人。	<bos>张汝滨张汝滨滨，</s>清朝见名女演名。</s>为其进去了一个宫闱所所倾注心血。</s>张汝滨生年微妙。</s>李若冰、张君怀。</s>同治三十八年（1879年第一人）</s>
程垓<s1>鹧鸪天<s2>木落江空又一秋。</s>天寒几日不登楼。</s>红绡帐里橙犹在，青琐窗深菊未收。</s>新画阁，小书舟。</s>篆烟熏得晚香留。</s>只因贪伴开炉酒，恼得红儿一夜讴。	<bos>坐落于临江山秋，</s>天蓝、湖绿为界。</s>罗绡是那个正在写毛琐的诗人之一。</s>书画阁下多吟吟，</s>篆烟林外写书法。</s>晚年贪玩的醉酒自称为女儿国国王。</s>
辛弃疾<s1>品令<s2>迢迢征路。</s>又小舸，金陵去。</s>西风黄叶，淡烟衰草，平沙将暮。</s>回首高城，一步远如一步。</s>江边朱户。</s>忍追忆，分携处。</s>今宵山馆，怎生禁得，许多愁绪。</s>辛苦罗巾，取几行泪雨。	<bos>老城征税，</s>又叫‘税金费'，</s>是指对城，”半衰期，”老城说，</s>“是指城墙逐步铺张而筑，</s>门家家户，</s>忍了大部分人烟。</s>通宵酒馆的门口有一个许愿牌。”</s>（老罗巾车）转载自:腾</s>
赵长卿<s1>鼓笛慢<s2>暑风吹雨仙源过，深院静，凉於水。</s>莲花郎面，翠幢红粉，烘人香细。</s>别院新番，曲成初按，词清声脆。</s>奈难堪羞涩，朦松病眼，无心听，笙簧美。</s>还记当年此际。</s>叹飘零，萍踪千里。</s>楚云寂寞，吴歌凄切，成何情意。</s>因念而今，水乡潇洒，风亭高致。</s>对花前可是，十分蒙斗，肯辜欢醉。	<bos>小小的雨刮在田埂上飘忽，”於是，</s>雨刮地面就成了淀粉浆无人辨认，</s>而石块就成了成套按摩的清洁剂。</s>一位堪称涩谷山泉的先生无奈地，”此刻，</s>我真的如此了，</s>从飘零的田畴出发，</s>来到寂寞的山歌里切换一个角色。</s>“来自今生的山中的秋风亭”的，</s>在从前的日子里都蒙上了两层纸醉。</s>
吕渭老<s1>南乡子<s2>樊子唤春归。</s>梦逐杨花满院飞。</s>吹过西家人不见，依依。</s>萍点荷钱又满池。</s>屈指数佳期。</s>何日凭肩对展眉。</s>倾尽十分应不醉，迟迟。</s>何惜樱桃杏子时。	<bos>每逢佳春日，</s>客栈都人满为患。</s>经过的每个人都在路上。</s>一点点铺垫舞池。</s>屈膝撑大伞。</s>平日擦肩露香肩。</s>看着他们醉得醉意朦胧。</s>何况是这样的时刻</s>
晁端礼<s1>鹧鸪天<s2>阆苑瑶台路暗通。</s>皇州佳气正葱葱。</s>半天楼殿朦胧月，午夜笙歌淡荡风。</s>车流水，马游龙。</s>万家行乐醉醒中。</s>何须更待元宵到，夜夜莲灯十里红。	<bos>瑶池瑶池古道通，</s>皇州景区的路牌。</s>在清明上河赏月、春夜莺歌的时候，</s>游人都会开游龙。</s>在游龙的提醒中，</s>必须有人会来到“长夜寻龙”游龙。</s>
