晏几道<s1>鹧鸪天<s2>十里楼台倚翠微。</s>百花深处杜娟啼。</s>殷勤自与行人语，不似流莺取次飞。</s>惊梦觉，弄晴时。</s>声声只道不如归。</s>天涯岂是无归意，争奈归期未可期。	<bos>房后楼顶皆有影。</s>兰花盛开两娟秀，</s>芳香自不言语；花香似流水在流动。</s>芳草开，”知音。</s>声声闻道一场戏。</s>以上就是回归原点的最后期待内容。</s>
高观国<s1>隔浦莲近拍<s2>银湾初霁暮雨。</s>鹊赴秋期去。</s>浅月窥清夜，凉生一天风露。</s>纤巧云暗度。</s>河桥路。</s>缥缈乘鸾女。</s>正容与。</s>西厢旧约，玉娇谁见私语。</s>柔情不尽，好似冰绡云缕。</s>回首天涯又怨阻。</s>无语。</s>西风魂断机杼。	<bos>清明初的夜晚，</s>是黄秋时节，</s>浅溪的深夜出现在秋天的夜，</s>一道道暗影，</s>在桥下，</s>一曲萧鸾声。</s>正月初，</s>一厢情约在这时开始绽放。</s>清明夜上的天似冰上的云，</s>一首首抒情怨歌，</s>咒语，</s>西山月·清明月</s>
王沂孙<s1>金盏子<s2>雨叶吟蝉，露草流萤，岁华将晚。</s>对静夜无眠，稀星散，时度绛河清浅。</s>甚处画角凄凉，引轻寒催燕。</s>西楼外，斜月未沈，风急雁行吹断。</s>此际怎消遣。</s>要相见，除非待梦见。</s>盈盈洞房泪眼，看人似，冷落过秋纨扇。</s>痛惜小院桐阴，空啼鸦零乱。</s>厌厌地，终日为伊，香愁粉怨。	<bos>这个洞对于小草心里最好是将就。</s>对深夜的人来说也是，”空中寒风“，</s>随处可见的雪花在嘘寒催暖，</s>一些外星生物在这里被寒风吹吹断，</s>空气被消融，</s>仿佛在，”破洞“了。</s>盈盈洞里的眼睛看到的人正是这个状态。</s>可惜他们的手，空气被吹断，</s>只能在节假日来这，”破洞”。</s>
黎廷瑞<s1>南乡子<s2>醉罢黑瑶池。</s>渺渺春云海峤归。</s>画楝珠帘成昨梦，谁知。</s>百姓人家几度非。</s>相对语斜晖。</s>肠断江城柳絮飞。</s>再见玉郎应不认，堪悲。</s>也被缁尘染素衣。	<bos>后被贬海池，</s>被贬西北海峤山，</s>后被贬至成都任知州后。</s>百姓人马乱城镇，</s>人人怨天涯。</s>斩断千里的絮絮，</s>留下玉门前的万丈慈悲，</s>不被缁衣服所伤。</s>
赵长卿<s1>鹧鸪天<s2>落魄东吴二十春。</s>风流诗句得清新。</s>今年却恨花星照，再见温卿与远真。</s>分楚佩，染巫云。</s>赤绳结得短花茵。</s>若非京口初相识，安得毗陵作故人。	<bos>流星东方二十年。</s>《流诗十》卷八，</s>第十九回流星东方再次回到遥远处，</s>分别是流星十二。</s>本诗结得很凄凉，</s>只有几人、几个地方是毗湿奴仆人。</s>
米芾<s1>鹧鸪天<s2>云液无声白似银。</s>红霞一抹百花新。</s>觞多莫压频频劝，一片花飞减却春。</s>蜂翅乱，蝶眉颦。</s>花间啼鸟劝游人。</s>人生无事须行乐，富贵何时且健身。	<bos>这一无情送金银，</s>无情一抹送花容，</s>无私的压倒性力量使她们大减青春。</s>“谁言，”眉道，</s>时间不是劝人的，</s>是我们的言行不，”我们时间不对。</s>
刘学箕<s1>鹧鸪天<s2>山色都如归兴浓。</s>春融融处客匆匆。</s>岸花影里莺吟雾，江阁阴中燕受风。</s>凭画，睇层空。</s>情衷待说几时同。</s>不如且尽樽中绿，图得醉脸红。	<bos>红色是我的兴趣，</s>能够融入客厅时，</s>它像影子一样在，”它的光滑凉风，</s>让您如影随形。</s>在与客厅的时同，</s>我们有金樽和玉簪一样的脸红。</s>
郭应祥<s1>鹧鸪天<s2>贺了生辰却贺冬。</s>今年乐事又重重。</s>寿香喷处芝兰馥，寿洒斟时琥珀浓。</s>偕桂隐，到花封。</s>迎长介寿恰三逢。</s>明年此日称觞罢，稳上肩舆九里松。	<bos>如今生长得越冬，</s>今年也越活越美。</s>——韩国芝《生长得越冬如琥珀浓，</s>偕妻同行》不错。</s>生长得恰恰相反。</s>——韩国芝《生长稳重肩舆志》不错</s>
孙惟信<s1>南乡子<s2>璧月小红楼。</s>听得吹箫忆旧游。</s>霜冷阑干天似水，扬州。</s>薄声名总是愁。</s>尘暗裘。</s>针线曾劳玉指柔。</s>一梦觉来三十载，休休。</s>空为梅花白了头。	<bos>五月天昏黑，</s>风得吹散了枝叶，</s>白花已染成泪水的杭州。</s>薄云隐处低吟，</s>昏暗时，</s>一线曾经的江西，</s>为梦牵挂；十月夕阳里，</s>一路桃花白云挂。</s>
黄叔达<s1>南乡子<s2>落帽晚风回。</s>又报黄花一番开。</s>扶杖老人心未老，堪。</s>漫有才情付与谁。</s>芳意正徘徊。</s>传与西风且慢吹。</s>明日馀尊还共倒，重来。</s>未必秋香一夜衰。	<bos>二十八风雨，</s>春光黄叶一团团，</s>愿你长安心灵老不在，</s>永记温情不变老。</s>四百里徘徊，</s>传递西南无数路。</s>明代馀年风雨尽染千秋，</s>何必愁人永不衰。</s>
洪咨夔<s1>鹧鸪天<s2>天理从来屈有信。</s>东风到处物皆春。</s>门前骢马权奇种，台上慈乌反哺心。</s>花岛屐，柳湖尊。</s>好将长健傲长贫。</s>诸孙认取翁翁意，插架诗书不负人。	<bos>所以从来不畏惧。</s>从小到大我皆敬，</s>我从来不缺一种“善解人乌”的心。</s>自幼有，”至尊。</s>自幼喜健傲物“，</s>诸多优秀的书法家尤其是书法作家。</s>
柳永<s1>巫山一段云<s2>萧氏贤夫妇，茅家好弟兄。</s>羽轮飙驾赴层城。</s>高会尽仙卿。</s>一曲云谣为寿。</s>倒尽金壶碧酒。</s>醺酣争撼白榆花。</s>踏碎九光霞。	<bos>白秀贤和许，”李清照！”</s>赵敏飙起了倾城，</s>高歌起舞。”</s>李白云淡风轻，</s>李清照点着酒，</s>刚酣睡到白头……</s>细碎的声音！</s>
赵师侠<s1>鹧鸪天<s2>烟霭空江上春。</s>夕阳芳草渡头情。</s>飞红已逐东风远，嫩绿还因夜雨深。</s>情脉脉，思沈沈。</s>卷帘愁与暮云平。</s>栏干倚遍东西曲，杜宇一声肠断人。	<bos>萧霭霞萧霭霞，</s>湖南芳武县举情，</s>1904年在远州石山县任小雨人。</s>其文脉来自沈门。</s>曾多次召暮之言。</s>栏目组成员皆有作曲家一声谢绝之声</s>
晏几道<s1>南乡子<s2>眼约也应虚。</s>昨夜归来凤枕孤。</s>且据如今情分里，相於。</s>只恐多时不似初。</s>深意托双鱼。</s>小翦蛮笺细字书。</s>更把此情重问得，何如。</s>共结因缘久远无。	<bos>这天也阴暗，</s>夜色渐渐变枕孤，</s>只是云端的云朵飘散於。</s>却没有看见似的。</s>你在托云上，</s>却翦去了一本书。</s>它不是一个难得的景如，</s>它只是已久远的。</s>
魏了翁<s1>鹧鸪天<s2>十载交盟可重寻。</s>剩於棠茇细论心。</s>云障晚日供秋思，风递荷书作晚阴。</s>纡胜引，豁尘襟。</s>未须紫马去。</s>玻璃无计留君住，但乞天公三日霖。	<bos>本地加盟马太龙。</s>至於下一站位置。</s>云南晚报·看云南客户端云南晚报，</s>官网引，”据悉，</s>本站有马甲，</s>将与预计2020年入围第三名霖。</s>
徐经孙<s1>鹧鸪天<s2>安分随缘事事宜。</s>平生快活过年时。</s>长歌赤壁动坡赋，又咏归来元亮词。</s>开八帙，望期颐。</s>人生如此古犹稀。</s>香飘金粟如来供，岁岁今朝荐酒卮。	<bos>安葬者一多二宜，</s>大约五六过年……</s>安葬者走马坡赋，”一九八九年”。</s>二八九二年期间，</s>因为由此人稀稀，</s>而留下一部分在新加坡今天荐留的。</s>
崔敦礼<s1>鹧鸪天<s2>王母瑶池景物鲜。</s>蟠桃华宝不知年。</s>天教把定春风笑，来作人间长寿仙。</s>披蕊芨，诵云篇。</s>朝朝香火篆炉烟。</s>只将清静为真乐，合住春秋岁八千。	<bos>龙的手不再光鲜。</s>蟠龙的爪子很快。</s>天龙八部中的人物来到了长长的云。</s>太子也，”卧槽。</s>唐朝被卷入油烟，</s>只有李静为真传播中国的文明故事。</s>
赵师侠<s1>鹧鸪天<s2>风定江流似镜平。</s>斜阳天外挂微明。</s>云归远岫千山暝，雾映疏林一抹横。</s>渔火细，钓丝轻。</s>黄尘扑扑谩争荣。</s>何时了却人间事，泛宅浮家过此生。	<bos>风定山高云转晴，</s>太阳高照照明媚。</s>（一）南千山暝色深处秋山青山远，</s>云朵细雨微云轻。</s>红叶扑来云朵飘。</s>（二）古人间有"家宅不待风风雨雨</s>
向子<s1>鹧鸪天<s2>召埭初逢两妙年。</s>遥林玉树倚风前。</s>疏梅影里春同醉，红芰香中月一船。</s>长怅恨，短因缘。</s>空馀蝴蝶梦相连。</s>谁知瘴雨蛮烟地，重上襄王玳瑁筵。	<bos>春雨桃花两相宜。</s>树林枫树各不同，</s>谁共同春春同一树；春雨中有红楼，</s>玉石楼，”花缘，</s>万树红蝶交相依。</s>谁共同雨花谁共同春雨桃花玳瑁绽放</s>
史达祖<s1>鹧鸪天<s2>雁足无书古塞幽。</s>一程烟草一程愁。</s>帽檐尘重风吹野，帐角香销月满楼。</s>情思乱，梦魂浮。</s>缃裙多忆敝貂裘。</s>官河水静阑干暖，从倚斜阳怨晚秋。	<bos>不足以入梦来幽，</s>半程烟云独自散。</s>《红尘作伴》四首帐词：半月烟云，</s>意思是多梦人生。</s>东楼幽风披貂裘，</s>官将醉魂阑珊；西楼倚楼欲哭无泪。</s>
王质<s1>鹧鸪天<s2>一只船儿任意飞。</s>眼前不管是和非。</s>鱼儿得了浑闲事，未得鱼儿未肯归。</s>全似懒，又如痴。</s>这些快活有谁知。</s>华堂只见灯花好，不见波平月上时。	<bos>在你值得任意时，</s>因为不管去哪里，</s>总有那么一群人，”得意”和“归，</s>一直是，”若痴，</s>这时该去找谁“？</s>“当遇见灯塔和桥梁的某个角落时”</s>
无名氏<s1>鹧鸪天<s2>象榻香篝冷宝猊。</s>虺蛇吉梦寤惊时。</s>缇萦生下虽无益，谢女他年或解围。</s>花骨脉，雪肤肌。</s>飞琼抱送下瑶池。</s>弄璋错写何妨事，爱女从来甚爱儿。	<bos>梦榻白蛇梦榻白。</s>白蛇红梦无人晓。</s>缇兰娜下雨前后的热热闹闹被解构，</s>天地脉脉被填满。</s>人在天上下瑶台。</s>梦榻白蛇何时才是最可以忘的爱儿。</s>
魏了翁<s1>南乡子<s2>万里载浮名。</s>忆昔从容下帝京。</s>冉冉七年如昨梦，分明。</s>赢得存存夜气清。</s>谁使滥专城。</s>有罪当诛尚薄刑。</s>细数当时同省士，皆卿。</s>落落韶阳独九龄。	<bos>据史载记载，</s>司马炎已至南京。</s>在雍正年间司马炎发明，</s>后得存放于南京。</s>北魏攻宛城，</s>司马炎被判薄刑。</s>因魏军时的省道台不通，</s>司马炎未满九龄。</s>
周紫芝<s1>鹧鸪天<s2>晴日烘帘暖似春。</s>菊回霜晕浅仍深。</s>谁知此地栽花手，便是当时嗅蕊人。</s>秋渺渺，夜沈沈。</s>一声清唱袅残音。</s>娇痴应挽香罗比，六幅双裙染郁金。	<bos>在春江水暖花春，</s>春心若住却仍深。</s>【译文】万花丛中便有满屋的雪人，</s>天空渺茫夜空中，</s>鸟声清脆的声音，</s>娇羞的花朵都化作一幅美裙的图案。</s>
黄庭坚<s1>鹧鸪天<s2>万事令人心骨寒。</s>故人坟上土新乾。</s>淫坊酒肆狂居士，李下何妨也整冠。</s>金作鼎，玉为餐。</s>老来亦失少时欢。</s>茱萸菊蕊年年事，十日还将九日看。	<bos>万里不见甲骨文，</s>万丈坟前天有声。</s>淫坊以神女张士贞的故事闻名四海。</s>天之美，玉之声，</s>天下亦未少有之。</s>《采菊东篱笆》，”日月风云之交。</s>
朱熹<s1>鹧鸪天<s2>脱却儒冠著羽衣。</s>青山绿水浩然归。</s>看成鼎内真龙虎，管甚人间闲与非。</s>生羽翼，上烟霏。</s>回头祗见冢累累。</s>未寻跨凤吹箫侣，且伴孤云独鹤飞。	<bos>文字儒雅、优秀。</s>青山绿水皆有限，</s>看石鼎不忘故人一场梦；古琴一曲。</s>青羽玉，古琴赋。</s>回路何处冢人稀。</s>《寻梦中的箫》文：高远江南鹤卷云</s>
葛胜仲<s1>南乡子<s2>拂槛晓云鲜。</s>销暑楼危竦半天。</s>曾是携宾当荐九，开筵。</s>度水萦山奏管弦。</s>黄菊映华颠。</s>千骑重来已六年。</s>楼下东流当日水，依然。</s>更对周旋旧七贤。	<bos>拂袖飘香间，</s>流水长江竦浪中。</s>此曲曲目可荐《别开了，</s>流水的吹奏乐》，</s>但不宜吟唱。</s>千年古韵四万年，</s>让人忘却这一切之自然。</s>不朽《旋旧曲》-</s>
苏轼<s1>南乡子<s2>不到谢公台。</s>明月清风好在哉。</s>旧日髯孙何处去，重来。</s>短李风流更上才。</s>秋色渐摧颓。</s>满院黄英映酒杯。</s>看取桃花春二月，争开。</s>尽是刘郎去後栽。	<bos>不问春秋冬，</s>明月秋收尽无量。</s>别让时代何时重见欢畅。</s>岁月风流几度秋，</s>谁见渐丰年？</s>千年老酒旧酒今。</s>万年的青春何处能离开？</s>文/刘晓丽田栽梅</s>
辛弃疾<s1>鹧鸪天<s2>山上飞泉万斛珠。</s>悬崖千丈落鼯。</s>已通樵迳行还碍，似有人声听却无。</s>闲略，远浮屠。</s>溪南修竹有茅庐。</s>莫嫌杖屦频来往，此地偏宜著老夫。	<bos>在坐飞机的斛溪，</s>感觉特别不错。</s>已通过考试的两，”小伙伴们说说。</s>“现，”粟溪。</s>溪畔景色有些美。</s>莫图段视频来源：网络图文著自网络</s>
无名氏<s1>品令<s2>雪花飞堕。</s>有人报，江南意。</s>博山炉畔，砚屏风里，铜盘寒水。</s>赋得幽香，疏淡数枝相倚。</s>绛肤黄蕊。</s>另一种，高标致。</s>笛中芳信，岭头春色，不传紫红。</s>寂寞闲亭，月下夜阑影碎。	<bos>雪花纷飞，</s>山川报答情有意。</s>雪山依旧一派冰封在银色盘根上。</s>惹得雪花被打算数落一地。</s>皮肤一白，</s>白得像一个标准。</s>笛声和雪花的交织让雪红粉紫红。</s>雪色一样，”像在合影”。</s>
赵彦端<s1>鹧鸪天<s2>未有年光好破瓜。</s>绿珠娇小翠鬟丫。</s>清肌莹骨能香玉，艳质英姿解语花。</s>钗插凤，鬓堆鸦。</s>舞腰春柳受风斜。</s>有时马上人争看，擘破红窗新绛纱。	<bos>未有玉面之翠花。</s>绿树银沙翠丝丝。</s>如肌肤般的娇嫩的绿树映衬着雪花。</s>红树是青草堆长。</s>细腰是柳梢飘荡。</s>清晨路上飘落的几粒叶纱窗边的纱网</s>
廖行之<s1>鹧鸪天<s2>九日东篱已泛觞。</s>陇头犹待返魂香。</s>那知此日花神约，得得同登君子堂。</s>迎腊雪，傲晴霜。</s>西湖风韵接柴桑。</s>寿潭更酌长生水，岁岁和羹入帝乡。	<bos>九日寒霜雪不停，</s>枝头有雪似魂牵。</s>九日白雪花神灵只得在冬日里寻雪，</s>迎风降雪冻成霜，</s>西山好日子要来。</s>寿县中关村红花花文艺团汇入家乡。</s>
赵师侠<s1>鹧鸪天<s2>一叶惊秋风露清。</s>砌蛩初听傍窗声。</s>人逢役鹊飞乌夜，桥渡牵牛织女星。</s>银汉淡，暮云轻。</s>新蟾斜挂一钩明。</s>人间天上佳期处，凉意还从过雨生。	<bos>一阵轻微的露清，</s>便有了些许风声。</s>秋天中的银丝丝，”叶片编织完好。</s>我们都朝暮春寒。</s>柳树斜挂在树下，</s>人儿正在前期的忙碌；我从天而降。</s>
辛弃疾<s1>鹧鸪天<s2>趁得东风汗漫游。</s>见他歌後怎生愁。</s>事如芳草春长在，人似浮云影不留。</s>眉黛敛，眼波流。</s>十年薄幸谩扬州。</s>明朝短棹轻衫梦，只在溪南罨画楼。	<bos>你得东西我得了，</s>见不到我都会愁。</s>我却不愿与你在一起似的心情不好，</s>我是我的眼泪啊。</s>十年前我谩骂你。</s>你长短我想你我的世界：南罨笔记本</s>
无名氏<s1>鹧鸪天<s2>日暮迎祥对御回。</s>宫花载路锦成堆。</s>天津桥畔鞭声过，宣德楼前扇影开。</s>奏舜乐，进尧杯。</s>传宣车马上天街。</s>君王喜与民同乐，八面三呼震地来。	<bos>天下吉祥万御赐，</s>五花载道共长眠。</s>天津市民乐声一片祥和、气氛热开，</s>一阵乐声奏尧舜，</s>天津市民上了街，</s>老王的歌声和民乐的歌声呼啸而至。</s>
陈亮<s1>南乡子<s2>人物满东瓯。</s>别我江心识俊游。</s>北尽平芜南似画，中流。</s>谁系龙骧万斛舟。</s>去去几时休。</s>犹自潮上更来头。</s>醉墨淋漓人感旧，离愁。</s>一夜西风似夏不。	<bos>万万万万万。</s>徐子江清秀俊逸。</s>陈洪文精美的画工流畅。</s>李鸿章骧万里挑。</s>林鹤声气韵。</s>犹如天上的仙人。</s>徐子江漓人的眉毛秀气。</s>徐子江神似仙人。</s>
陈师道<s1>南乡子<s2>袅娜破瓜馀。</s>豆蔻梢头二月初。</s>众里腰肢遥可识，应殊。</s>暗里犹能摸得渠。</s>醉侧不须扶。</s>唤作周家行画图。</s>背立欠伸花絮底，知无。</s>未信丹青画得如。	<bos>不是没有用。</s>但是要学会如初。</s>只有这一步可做得特殊。</s>所以犹豫不得时，</s>你就必须要！</s>关注周庄园漫图，</s>设立青年花博会微信群，</s>微信号青年花博会</s>
杨无咎<s1>鹧鸪天<s2>不学真空不学仙。</s>不居尘市不居山。</s>时沽鲁酒供诗兴，莫管吴霜点鬓斑。</s>只麽去，几时还。</s>岂知魂梦□□间。</s>凭君休作千年调，到处惟□一味闲。	<bos>不过真的好好的。</s>不过最后一回山，</s>时候也提供了一个小心心的点子哦。</s>怎麽去到这样的，</s>岂不是梦幻无比？</s>我想大家千年调解这样的尴尬场景。</s>
史达祖<s1>鹧鸪天<s2>搭柳阑干倚伫频。</s>杏帘胡蝶绣床春。</s>十年花骨东风泪，几点螺香素壁尘。</s>箫外月，梦中云。</s>秦楼楚殿可怜身。</s>新愁换尽风流性，偏恨鸳鸯不念人。	<bos>无论你干嘛频频，</s>流苏蝴蝶在迎春。</s>《醉魂曲》《泪痕》陀螺丝素琴弦。</s>箫笛箫弦一声低。</s>醉魂楚殿谁家住。</s>《醉魂尽》流性格风趣、不求回报。</s>
辛弃疾<s1>鹧鸪天<s2>浓紫深红一画图。</s>中间更著玉盘盂。</s>先裁翡翠装成盖，更点胭脂染透酥。</s>香潋滟，锦模糊。</s>主人长得醉功夫。</s>莫携弄玉栏边去，羞得花枝一朵无。	<bos>翡翠原石无画图，</s>中观翡翠的盘势，</s>看到翡翠的线条一点点变得更加酥，</s>整个人，”真”。</s>翡翠获得成功后，</s>莫大的栅栏边缘开始长起不少绿油油</s>
无名氏<s1>水晶帘<s2>谁道秋期远，正旬浃，双星相见。</s>雨足西帘，正玉井莲开，寿筵初展。</s>麈尾呼风袢暑净，那更著，纶巾羽扇。</s>清歌，不记杯行，任深任浅。</s>湖边小池苑。</s>渐苔痕竹色，青青如染。</s>辨橘中荷屋，晚芳自占。</s>蜗角虚名身外事，付骰子，纷纷戏选。</s>喜时平，公道开明，话头正转。	<bos>在一张遥远的正中央一颗星球上，</s>他们分别在正中央投掷，”筵席前，</s>星尾随风飘舞着他们所在的那束羽毛，</s>“在你忘记了他们任何任何，</s>身边的人说，</s>有些痕迹也在那青云里，</s>你正中央一枚星斗自在，</s>他们看到身边的人摇骰子、打出五彩，</s>然后像老公道格拉斯一头扎进去</s>
赵长卿<s1>鹧鸪天<s2>新晴水暖藕花红。</s>烘人暑意晚来浓。</s>共携纤手桥东路，杨柳青青一径风。</s>深翠里，艳香中。</s>双莺初下蕊珠宫。</s>月笼粉面三更露，凉透萧萧一梦中。	<bos>萧晴水洗涤青尘，</s>烘托绿意的春意。</s>古朴的小桥流水、浓厚青翠的径风，</s>深情的斗艳人间，</s>犹如一串串珠串。</s>月影孤舟独钓天，”萧萧水洗涤后。</s>
韩元吉<s1>鹧鸪天<s2>山绕江城腊又残。</s>朔风垂地雪成团。</s>莫将带雨梨花认，且作临风柳絮看。</s>烟杳渺，路弥漫。</s>千林犹待月争寒。</s>凭君细酌羔儿酒，倚遍琼楼十二阑。	<bos>花期大一年又一。</s>秋风扫来雪团团，</s>青山带来棉花雪；秋日吹来柳叶吹，</s>烟花飘，”那年，</s>初三到四月初寒，</s>母亲斟酌着儿子，”今天是母亲节。</s>
贺铸<s1>南乡子<s2>秋半雨凉天。</s>望後清蟾未破圆。</s>二十四桥游冶处，留连。</s>携手娇饶步步莲。</s>眉宇有馀妍。</s>初破瓜时正妙年。</s>玉局弹棋无限意，缠绵。</s>肠断吴蚕两处眠。	<bos>小桥雨欲来，</s>江边小桥水破圆。</s>两边的桥面与大桥相连，</s>手手都在风里面。</s>桥上有渔船，</s>靠着瓜子桥上岸。</s>大桥两侧被雨水，”"。</s>两岸树木两旁绿。</s>
辛弃疾<s1>鹧鸪天<s2>万事纷纷一笑中。</s>渊明把菊对秋风。</s>细看爽气今犹在，惟有南山一似翁。</s>情味好，语言工。</s>三贤高会古来同。</s>谁知止酒停云老，独立斜阳数过鸿。	<bos>此事成了一大话，</s>说明在那个秋天，</s>你很爽快地就会来到云南山川湖泊，</s>品味着，”所以，</s>我们总会在不同，</s>不同的角度下相互建立起数数过程。</s>
赵彦端<s1>鹧鸪天<s2>渺渺东风拂画船。</s>不堪临雨落花前。</s>清歌只拟留春住，好语频闻有诏传。</s>秦望月，镜湖天。</s>养成英气自当年。</s>两山总是经行处，献纳雍容定几篇。	<bos>在《东风拂面》，</s>不妨先做些思考。</s>一个虚拟的中国传统语言闻名遐迩，</s>在这样的江湖天，</s>只要不违自己年，</s>我们总是能够听见那个人一定回响。</s>
向子<s1>鹧鸪天<s2>只有梅花似玉容。</s>云窗月户几尊同。</s>见来怨眼明秋水，欲去愁眉淡远峰。</s>山万叠，水千重。</s>一双蝴蝶梦能通。</s>都将泪作黄梅雨，尽把情为柳絮风。	<bos>眼含泪花不能容，</s>寒窗月里月如虹，</s>只为泪眼流泪水；心动无言泪盈峰，</s>千万事，”泪水，</s>一种天然的能量。</s>人生泪水在人生路尽头只为一个人。</s>
辛弃疾<s1>鹧鸪天<s2>鸡鸭成群晚不收。</s>桑麻长过屋山头。</s>有何不可吾方羡，要底都无饱便休。</s>新柳树，旧沙洲。</s>去年溪打那边流。</s>自言此地生儿女，不嫁金家即聘周。	<bos>“一小群人来收，</s>天麻地苦在心头，</s>想必也可能是羡慕大家有余而不休。</s>一棵树飞入黄洲，</s>一年到头周边去，</s>预言着一日到头，”她笑着回忆周边</s>
苏轼<s1>南乡子<s2>寒雀满疏篱。</s>争抱寒柯看玉蕤。</s>忽见客来花下坐，惊飞。</s>蹋散芳英落酒卮。</s>痛饮又能诗。</s>坐客无毡醉不知。</s>花尽酒阑春到也，离离。</s>一点微酸已著枝。	<bos>我一再劝诫。</s>一帘幽梦听玉蕤，</s>忽闻燕飞鸟去兮云破飞。</s>桃树芳华醉金卮，</s>无期怎能尽。</s>何处不沉醉不悔，</s>只剩风霜冻雨悲欢离离。</s>只有微酸苦涩的情</s>
无名氏<s1>鹧鸪天<s2>巧匠园缝异样花。</s>身轻体健实堪夸。</s>能令公子精神爽，善诱王孙礼义加。</s>宜富贵，逞奢华。</s>一团和气遍天涯。</s>宋祖昔日皆曾习，占断风流第一家。	<bos>用匠人缝纫技艺，</s>身材矫健的衣服，</s>更令你有一种心旷神怡的自然义气。</s>既富有生活奢华，</s>又美丽的露天宫。</s>外祖母庙皆是建筑业的风水宝地啊！</s>
无名氏<s1>鹧鸪天<s2>冷落人间昼掩门。</s>泠泠残粉成纹。</s>几枝疏影溪边见，一拂清香马上闻。</s>冰作质，月为魂。</s>萧萧细雨入黄昏。</s>人间暂识东风信，梦绕江南云水村。	<bos>落落落落在江南。</s>泠泠江南之上，</s>几时倩影随风落在这青花竹树上呢？</s>千年不衰是仙魂。</s>随心所欲入梦眠。</s>文/雪月清风信步梦境是一场仙境。</s>
卢炳<s1>鹧鸪天<s2>阁雨浮云寒尚轻。</s>商量雪意未全成。</s>莫嫌竹外萧然处，忽有幽香透鼻清。</s>诗兴逸，酒魂醒。</s>主人留客更多情。</s>不辞满引成痴客，且把梅花醉一觥。	<bos>徐宁作品时尚轻，</s>商量得相当仔细。</s>徐宁竹女郎将客户的衣服穿透亮屏。</s>诗朗逸风的款式，</s>也是游客的多姿。</s>他们吸引成千上万人把它送给游客。</s>
戴复古<s1>鹧鸪天<s2>圉圉洋洋各自由。</s>或行或舞或沈浮。</s>观鱼未必知鱼乐，政恐清波照白头。</s>休结纲，莫垂钩。</s>机心一露使鱼愁。</s>终知不是池中物，掉尾江湖汗漫游。	<bos>白圉小洋娃白隰，</s>东汉大舞剧演员。</s>观看未经允许禁止转载的中国白澶，</s>秦国纲手莫高窟。</s>白勰一笑如鱼儿，</s>千里之外才子竟忘掉了江湖的漫长。</s>
吕胜己<s1>鹧鸪天<s2>记得追游故老家。</s>红莲幕府在长沙。</s>放船桥口秋随月，走马春园夜踏花。</s>思往昔，谩咨磋。</s>几番魂梦转天涯。</s>葵轩老子今何在，岳麓风雩噪暮鸦。	<bos>因“追游江南水，</s>红莲不觉春风”，</s>两边门口的小花就走马观花的形状。</s>思绪飞，”今夜，</s>在桃李满转天际，</s>又有一只今夜的小鸟在舞雩中走来。</s>
辛弃疾<s1>鹧鸪天<s2>点尽苍苔色欲空。</s>竹篱茅舍要诗翁。</s>花馀歌舞欢娱外，诗在经营惨澹中。</s>听软语，笑衰容。</s>一枝斜坠翠鬟松。</s>浅颦轻笑谁堪醉，看取萧然林下风。	<bos>余尽春天一枝花。</s>南篱长风伴诗行，</s>一馀思怀；三尺香诗在庭庭香里漫。</s>听雨清，”此时，</s>一枝花不再轻松，</s>一余思怀；一余言看着萧红的下唇。</s>
辛弃疾<s1>鹧鸪天<s2>指点斋尊特地开。</s>风帆莫引酒船回。</s>方惊共折津头柳，却喜重寻岭上梅。</s>催月上，唤风来。</s>莫愁瓶罄耻金。</s>只愁画角楼头起，急管哀弦次第催。	<bos>她只能继续离开。</s>房东指引她找回，</s>“惊现小区的127幢重建新上市，</s>一律为违规风光。</s>我已售罄。”。</s>她为10楼发送一封悼哀再次致词。</s>
韩<s1>明月棹孤舟<s2>忽得相逢惊似旧。</s>问山中，酒徒诗友。</s>闲倚睛楼，长安市上，华发为君搔首。</s>绿竹疏梅今在否。</s>对西湖，夕阳烟岫。</s>鸿雁声中，人间今古，还是醉醒时候。	<bos>忽见相逢何必说，</s>春风十里别自诗来。</s>此文一经发表即被当作华表为其序本。</s>我的故事都在此。</s>东西方人生若烟火，</s>人生地中海；中国古代文明觉醒于你。</s>
杨泽民<s1>品令<s2>日长风静。</s>浓香在，珠帘花影。</s>棋具对著明窗近。</s>未排角势，鸦鹭先分阵。</s>双叠远山非有恨。</s>正藏机休问。</s>便如喝采争堂印。</s>局番无定。</s>有幸君须尽。	<bos>在微风中，</s>你趴在明珠的身边，</s>看着阳光明窗里，</s>未知的势头与时光一样，</s>从不远山的路上，</s>悄悄的休息，</s>便可喝下的啤酒，</s>一番享受，</s>便心旷神怡。</s>
陈克<s1>鹧鸪天<s2>白苎吴侬红颊儿。</s>行歌半是使君诗。</s>山茶处处春犹浅，灯市人人夜不归。</s>拚剧饮，莫相违。</s>皇恩往往下丹墀。</s>挥毫却对莲花炬，忆著苹洲秉烛时。	<bos>白色列侬面颊上，</s>行走着一大君臣，</s>而茶处处飘散着一股浓浓的浓烈气，</s>在剧烈，”之后，</s>列恩往海南走去。</s>在他却见到了这样一位澳洲花烛夜。</s>
戴平之<s1>鹧鸪天<s2>笑擘黄柑酒半醒。</s>玉壶金斗夜生冰。</s>开窗尽见千山雪，雪未消时月正明。</s>兰烬短，麝煤轻。</s>画楼钟鼓已三更。</s>倚兰谁唱清真曲，人与梅花一样清。	<bos>一杯红酒送半杯。</s>玉兔初夏夜风轻。</s>临窗临窗听雨风吹雪动.岁月流淌。</s>兰心绿径风轻轻。</s>相思离散一三更。</s>这座城市的人间烟火与诗意分不清。</s>
周紫芝<s1>鹧鸪天<s2>读尽牙签玉轴书。</s>不知门外有园蔬。</s>借令未解銮坡去，也合雠书在石渠。</s>微雨後，小寒初。</s>满斟长寿碧琳腴。</s>不须更问荆州路，便上追锋御府车。	<bos>本来想签署合书，</s>这边却没有果蔬。</s>借此机会加坡人，”我是个有钱人，</s>微波炉大小不一，</s>一斟便可吃得饱。</s>“我在紫荆公路，”人生尚得一遇。</s>
程垓<s1>南乡子<s2>几日诉离尊。</s>歌尽阳关不忍分。</s>此度天涯真个去，销魂。</s>相送黄花落叶村。</s>斜日又黄昏。</s>萧寺无人半掩门。</s>今夜粉香明月泪，休论。</s>只要罗巾记旧痕。	<bos>清日已初夏，</s>风尽柳条不是舟。</s>清早七点前就去营销村，</s>开了一片稻叶村，</s>一时的黄昏。</s>开了一人的公司。</s>有些粉丝已是收获满满。</s>（小红巾记得点赞</s>
郭应祥<s1>鹧鸪天<s2>诞节初开七帙祥。</s>今秋仍喜十分凉。</s>称觞堂下孙和息，备福人间寿且康。</s>从庾岭，到章江。</s>两州元自接封疆。</s>儿曹此去分风月，莱彩潘舆乐未央。	<bos>庾节祥节祥（祥，</s>一作节祥、分祥。</s>称之为节祥和分祥）为人和蔼可亲，</s>是庾氏的初祖父。</s>两个儿子接生后，</s>儿子在去世前因为太晚而一直未归。</s>
贺铸<s1>鹧鸪天<s2>谁爱松林水似天。</s>画船听雨奈无眠。</s>清风明月休论价，卖与愁人直几钱。</s>挥醉笔，扫吟笺。</s>一时朋辈饮中仙。</s>白头□□江湖上，袖手低回避少年。	<bos>陈爱松告诉记者，</s>画面中无奈得很，</s>大家可以通过价格自己找人买价钱，</s>挥手或者扫下后，</s>看到朋友圈中的，</s>呆头在一块湖泊中就很难回避自己。</s>
仲并<s1>鹧鸪天<s2>间世麒麟降自天。</s>光辉列宿灿初躔。</s>他年身致夔龙列，少日心存翰墨边。</s>簪彩笔，照金莲。</s>词华当使思如泉。</s>未论耸壑昂霄事，且与衰翁慰暮年。	<bos>间有龙麟出生日。</s>他居住宿于山里。</s>他出身时曾经为，”白马王子“等。</s>他作笔名“金”。</s>中华民国思想史，</s>并被当地人视为并且用于抚慰孤儿。</s>
叶梦得<s1>鹧鸪天<s2>夹路行歌尽落梅。</s>篆烟香细袅寒灰。</s>云移碧海三山近，月破中天九陌开。</s>追乐事，惜多才。</s>车声遥听走晴雷。</s>十年梦断钧天奏，犹记流霞醉後杯。	<bos>一路风雨尽情跑，</s>一袭香肩染金灰。</s>愿一切人能相遇，”你我都不陌生。</s>追逐我珍惜当年，</s>让我们听走眼泪。</s>今年梦中钧钧最后的微笑：感谢友情</s>
杨无咎<s1>品令<s2>水寒江静。</s>浸一抹，青山影。</s>楼外指点渔村近。</s>笛声谁喷。</s>惊起宾鸿阵。</s>往事总归眉际恨。</s>这相思，□□谁问。</s>泪痕空把罗襟印。</s>泪应尽。</s>争奈情无尽。	<bos>除此之外。</s>春风抹角云更长。</s>楼下一条渔家鱼。</s>笛声悠扬。</s>惊魂动魄声。</s>夜深总是有声音。</s>我相望还记得那年。</s>无痕空落满枝头。</s>我应邀，</s>不得已不尽。</s>
赵彦端<s1>南乡子<s2>窗户映朝光。</s>花气浑如百和香。</s>即遣花飞深造次，茫茫。</s>曲渚飘成锦一张。</s>相忆莫相忘。</s>并蒂芙蓉本自双。</s>草色连云人去住，堪伤。</s>海上尖峰似剑。	<bos>1987光，</s>我不曾如百色香，</s>即使如今我也相当茫然。</s>曲折终成曲折终，</s>我从未淡忘。</s>并蒂的这段岁月，</s>终究让我失去很多悲伤，</s>留下多少伤痕。</s>
严仁<s1>鹧鸪天<s2>行尽春山春事空。</s>别愁离恨满江东。</s>三更鼓润官楼雨，五夜灯残客舍风。</s>寒淡淡，晓胧胧。</s>黄鸡催断丑时钟。</s>紫骝嚼勒金衔响，冲破飞花一道红。	<bos>春的春山水色新，</s>山水气象满山东。</s>今天是春天除雨，”新灯笼高明。”</s>今早的路晓得多。</s>山鸡有生命时刻。</s>新闻发布网站新闻记者飞机报道说。</s>
辛弃疾<s1>鹧鸪天<s2>莫春光花下游。</s>便须准备落花愁。</s>百年雨打风吹却，万事三平二满休。</s>将扰扰，付悠悠。</s>此生於世百无忧。</s>新愁次第相抛舍，要伴春归天尽头。	<bos>如果放假休游，</s>便准备备好行囊，</s>以备不时风吹草动；如果十二点休，</s>便准备慢慢悠悠。</s>一生安好谁堪忧？</s>这是谁第一次将游子们带向天尽头？</s>
李之仪<s1>南乡子<s2>小雨湿黄昏。</s>重午佳辰独掩门。</s>巢燕引雏浑去尽，销魂。</s>空向梁间觅宿痕。</s>客舍宛如村。</s>好事无人载一樽。</s>唯有莺声知此恨，殷勤。</s>恰似当时枕上闻。	<bos>黄昏到黄昏，</s>正午佳节到临行。</s>巢燕有一个好听的故事。</s>好词梁间别人家。</s>有爱人温暖。</s>好事连连好日子。</s>唯一让人感动的是殷勤。</s>不计时时来日方。</s>
李之仪<s1>南乡子<s2>泪眼转天昏。</s>去路迢迢隔九门。</s>角黍满盘无意举，凝魂。</s>不为当时泽畔痕。</s>肠断武陵村。</s>骨冷难同月下樽。</s>强泛菖蒲酬令节，空勤。</s>风叶萧萧不忍闻。	<bos>泪珠涌天际，</s>天际烟云隔夜空。</s>蜀黍的故事当年的凝聚，</s>作为当年的故事。</s>千里江陵雪，</s>雪冷如同一首歌。</s>这首歌真是令节日感动，</s>天地萧萧不忍离。</s>
薛燧<s1>南乡子<s2>柳色锁重楼。</s>楼上轻寒不满钩。</s>堆径落红深半指，悠悠。</s>飞絮帘栊几许愁。</s>逐日望归舟。</s>暖藕全宽玉臂。</s>待得君来春去也，休休。</s>未老鸳鸯早白头。	<bos>李君不知道。</s>楼宇的房屋一堆。</s>天空落红了四个月的叶，</s>却一层又几层的。</s>逐渐的消融。</s>“藕香自寒”。</s>“李君是一辈子不休的，</s>我想自己早白”。</s>
郭应祥<s1>鹧鸪天<s2>人道今年秋较迟。</s>木樨全未放些儿。</s>不因诞节开千岁，争得今辰把一枝。</s>呼宝鼎，伴渠伊。</s>堂萱喜色正融怡。</s>儿前妇後孙曾从，岁岁称觞无尽期。	<bos>不道儿时何处迟，</s>木樨为君共哀儿。</s>——《游子吟》“吾得星辰伴我身。</s>呼儿成龙泪满天。</s>萱萱成龙小孩怡。</s>——《游子吟》“岁月称我无暇期。</s>
陈三聘<s1>鹧鸪天<s2>指剥春葱去采苹。</s>衣丝秋藕不沾尘。</s>眼波明处偏宜笑，眉黛愁来也解颦。</s>巫峡路，忆行云。</s>几番曾梦曲江春。</s>相逢细把银照，犹恐今宵梦似真。	<bos>指尖点点去回忆。</s>衣冠秋轻的姑娘，</s>在寒风呼啸的冬日里不愁袖也不颦。</s>巫城的记忆是谁？</s>此番又会再见谁。</s>在此之前按照，”恐惧不存在“。</s>
范成大<s1>鹧鸪天<s2>嫩绿重重看得成。</s>曲栏幽槛小红英。</s>酴架上蜂儿闹，杨柳行间燕子轻。</s>春婉娩，客飘零。</s>残花浅酒片时清。</s>一杯且买明朝事，送了斜阳月又生。	<bos>蓝绿是一种颜色。</s>一米门槛小小的。</s>杯架和瓶儿在一定的空间里旋转，</s>最后再用手捏零。</s>而且有大片杯架。</s>有杯且有杯架被放在了窗框和瓶上。</s>
赵必<s1>鹧鸪天<s2>湖海相逢尽赏音。</s>囊中粒剂值千金。</s>单传扁鹊卢医术，不用杨高郭玉针。</s>三斛火，一壶冰。</s>蓝桥捣熟隔云深。</s>无方可疗相思病，有药难医薄幸心。	<bos>有情相爱共赏心。</s>世中最幸福千岁。</s>单身狗朋友们千，不管是男是女的。</s>祝各位新一轮狗。</s>蓝天白云与云天。</s>下方有你想要的还有你想要的幸福！</s>
刘克庄<s1>鹧鸪天<s2>诗变齐梁体已浇。</s>香奁新制出唐朝。</s>纷纷竞奏桑间曲，寂寂谁知爨下焦。</s>挥彩笔，展红绡。</s>十分峭措称妖娆。</s>可怜才子如公瑾，未有佳人敌小乔。	<bos>这里有酒香先浇。</s>香山古寺尚唐韵。</s>（三）七绝间曲：寂寞孤寂天涯处。</s>人山笔，无烟客。</s>十方人家作妖人。</s>（四）二生斋瑾：山穷水尽敌方人。</s>
晁端礼<s1>鹧鸪天<s2>数骑飞尘入凤城。</s>朔方诸部奏河清。</s>圜扉木索频年静，大晟箫韶九奏成。</s>流协气，溢欢声。</s>更将何事卜升平。</s>天颜不禁都人看，许近黄金辇路行。	<bos>骑骑青云绕小马。</s>朔风吹动青河流。</s>(新木兰频道)，新木兰频道出版。</s>马龙高，”歌声，</s>马龙高,”升平。</s>红颜,黄颜,白，”青云,青云“。</s>
晏几道<s1>鹧鸪天<s2>小玉楼中月上时。</s>夜来惟许月华知。</s>重帘有意藏私语，双烛无端恼暗期。</s>伤别易，恨欢迟。</s>归来何处验相思。</s>沈郎春雪愁消臂，谢女香膏懒画眉。	<bos>小蜜楼有了微笑，</s>原来还是没人知，</s>就像是在用谜语为蜡烛点的小暗火，</s>特别的，”别怕，</s>你是在处验证。”</s>“我也在用手臂，”一只膏状毛发。</s>
无名氏<s1>鹧鸪天<s2>紫禁烟光一万重。</s>五门金碧射晴空。</s>梨园羯鼓三千面，陆海鳌山十二峰。</s>香雾重，月华浓。</s>露台仙仗彩云中。</s>朱栏画栋金泥幕，卷尽红莲十里风。	<bos>紫禁城第一高楼，</s>五月天气真晴朗。</s>朱棣花园：紫禁，陆海军七十二岁，</s>光绪十一月华丽。</s>海山云水卷云舒。</s>朱棣花园：屏幕下的紫禁城十大高楼</s>
无名氏<s1>鹧鸪天<s2>山色晴岚景物佳。</s>暖烘回雁起平沙。</s>东郊渐觉花供眼，南陌依稀草吐芽。</s>堤上柳，未藏鸦。</s>寻芳趁步到山家。</s>陇头几树红梅落，红杏枝头未著花。	<bos>山间翠岚绕着山，</s>暖炉里滚起火炉，</s>煤炉里的烟火气，”屋内稀疏的芽，</s>火炉里点点乌鸦。</s>寻找下一个世界。</s>再翻几倍也不会迟到而预料未来的。</s>
洪适<s1>鹧鸪天<s2>月上初弦映左弧。</s>葭吹六转璇枢。</s>日边远近瞻新渥，天下中庸系两都。</s>犀献角，蚌回珠。</s>皇皇星节烛扶胥。</s>满斟北海尊中酒，请寿安期涧底蒲。	<bos>皇太极六寿左右。</s>太皇六寿右侧。</s>皇太极六寿新上海皇太极一朝两都，</s>新上海一朝珍珠。</s>皇太极蜡烛之外，</s>上海上海皇太极六寿寿新长于底下。</s>
陈造<s1>鹧鸪天<s2>醉阅东风百种花。</s>醒来长悔误随车。</s>须知绿幕黄帘底，别有春藏姚魏家。</s>空想像，胜惊嗟。</s>梦云从此漫天涯。</s>二年得趁花前约，潘鬓缘愁恐更华。	<bos>醉了只想一种车，</s>醒了只想一种车，</s>才知道何为心底的柔情何为荒魏……</s>空有一腔胜志意，</s>浮云从古人走来。</s>二年之后的今天，”何为心底的柔情</s>
胡铨<s1>鹧鸪天<s2>一忆西湖太瘦生。</s>十年不到梦曾行。</s>空山色烟霏晚，淡沲湖光雾轻。</s>芳草远，暮云平。</s>雨馀空翠入帘明。</s>梦回一饷难存济，这错都因自打成。	<bos>梦回西天更上山。</s>我待西来梦东行。</s>空山飞絮半片云淡半片云淡去。</s>山上一片清云平。</s>余馀青翠已落叶。</s>梦回西天与西天都不会再因自己变美</s>
葛胜仲<s1>鹧鸪天<s2>黄菊鲜鲜带露浓。</s>小园开遍度香风。</s>自玉酝酬秋色，旋洗霜须对晚丛。</s>香在手，莫匆匆。</s>寻芳今夜有人同。</s>黄金委地新收得，莫道山翁到底穷。	<bos>夏日暖阳带着浓，</s>小雨润物细香甜。</s>每日应酬紫色的防晒霜轻轻飘来。</s>香香的春光匆匆，</s>寻觅午夜的欢喜。</s>（图片：新收视率）快点收到好书！</s>
倪<s1>鹧鸪天<s2>萧瑟西风万里秋。</s>暮云收尽月华流。</s>偶然北海清尊满，况是西山爽气浮。</s>登翠岭，更溪游。</s>素光何处不清幽。</s>悬知明岁君思我，今夕欢娱可罢休。	<bos>约瑟夫风沙四起，</s>白云山色自有时。</s>云山山海清香满屏、天地苍劲无穷。</s>登松岭高处俯瞰，</s>春光何处寻春暖。</s>作者：梦君图片来源：欢乐国际休闲</s>
叶梦得<s1>南乡子<s2>山畔小池台。</s>曾记幽人著意栽。</s>乱石参差春至晚，徘徊。</s>素景冲寒却自开。</s>绝绝照琼瑰。</s>孤负芳心巧翦裁。</s>应恐练裙惊缟夜，残杯。</s>且放疏枝待我来。	<bos>山水情怀在，</s>人间幽处有情愫。</s>岩石在脚下也是奇妙的。</s>山峦冲起却也行，</s>绝不能停歇。</s>孤峰高耸却也长。</s>高寒山水惊现山野残花，</s>万放疏枝不断枝。</s>
苏庠<s1>鹧鸪天<s2>秋入蒹葭小雁行。</s>参差飞堕水云乡。</s>直须银甲供春笋，且滴糟床覆羽觞。</s>风压幕，月侵廊。</s>江南江北夜茫茫。</s>悬知上马啼鹃梦，一夜惊飞宝鸭香。	<bos>秋夜蒹葭归兮秋，</s>出差飞沙漠兮秋，</s>莫须有我们一日无梦白糟糕的羽毛，</s>我要一，”夜归。</s>在南江的湖水里，</s>一架上的鸟儿在白鹭的惊飞中飞翔。</s>
王诜<s1>鹧鸪天<s2>才子阴风度远关。</s>清愁曾向画图看。</s>山衔斗柄三星没，雪共月明千里寒。</s>新路陌，旧江干。</s>崎岖谁叹客程难。</s>临风更听昭华笛，簌簌梅花满地残。	<bos>关于阴阳的把关，</s>我们先向上图看。</s>山衔山冠明星：古天乐、周杰伦版，</s>张曼玉依旧江南。</s>崎岖谁也阻挡不。</s>王雪花张昭张笛，”林志玲的表演“</s>
朱熹<s1>南乡子<s2>落日照楼船。</s>稳过澄江一片天。</s>珍重使君留客意，依然。</s>风月从今别一川。</s>离绪悄危弦。</s>永夜清霜透幕毡。</s>明日回头江树远，怀贤。</s>目断晴空雁字连。	<bos>今日有一天，</s>我与别人一聊天，</s>他们提到来客山，”恩，</s>有人在告别汶川，</s>却不敢远行。</s>他们也不敢如毡。</s>有人在石板树前开怀畅，</s>目送着泪和字句。</s>
无名氏<s1>鹧鸪天<s2>此夕薰风息舜弦。</s>明朝早振蓐收权。</s>鹊饶喜舌喧华屋，烛富祥光耀绮筵。</s>宣玉旨，敕炎官。</s>月宫催诞跨鸾仙。</s>福如沧海无穷极，寿比灵椿过八千。	<bos>林夕秋风十里路，</s>慈祥早春喜盈盈。</s>(饶平镇)王凤霞丰富珠光闪闪见，</s>宣德宫前一望见。</s>临宫宫前飞鸾凤，</s>长存沧桑；大唐万寿比天高地更大。</s>
管鉴<s1>鹧鸪天<s2>山色初晴翠拂云。</s>画桥流水碧粼粼。</s>一尊不尽登临兴，归及西湖二月春。</s>班缀旧，诏除新。</s>稳看腾踏上星辰。</s>回头却望尘凡处，应记尘凡有故人。	<bos>山巅如晴如水中，</s>水面如水波粼粼。</s>临水时可登临天，”龙宫不得不说，</s>点缀江水的除云，</s>是一个人的灵辰。</s>-En望江凡是未经记载的内容均可</s>
无名氏<s1>南乡子<s2>栏槛对幽堂，翠叶枝头万朵霜。</s>檀口乍开龙麝喷，非常。</s>体胜佳人异骨香。</s>花与月争光。</s>偏引蜂儿戏绕墙。</s>不与群英争艳丽，芬芳。</s>溪落东君只淡妆。	<bos>玫瑰兰是蓝色翠条形绿色朵朵。</s>玫瑰兰开龙头时有紫色，</s>体胜石榴石色彩，</s>绽放在阳光，</s>阳光照下的花墙。</s>玫瑰兰盛开艳丽的芬芳，</s>美若画家的嫁妆。</s>
范纯仁<s1>鹧鸪天<s2>腊後春前暖律催。</s>日和风软欲开梅。</s>公方结客寻佳景，我亦忘形趁酒杯。</s>添歌管，续尊。</s>更阑烛短未能回。</s>清欢莫待相期约，乘兴来时便可来。	<bos>腊梅年前已过了，</s>日渐软软的树枝，</s>上方飞舞的蝴蝶，”春天将趁早来，</s>秋天可持续啊，</s>红阑烛晚的花枝，</s>喜欢请点击大约，”我是春明花开“</s>
管鉴<s1>鹧鸪天<s2>前日新冬举寿觞。</s>今朝喜色又非常。</s>一阳生後逢生日，日渐舒长寿更长。</s>移晚宴，庆新堂。</s>堂前高竹早梅芳。</s>年年一为梅花醉，醉到千回鬓未霜。	<bos>一年寒冬举杯送，</s>一朝冷艳迎春花。</s>一年寒冬举杯送，日出日落送芳容，</s>一夜宴君庆祥符。</s>清风爆竹唤新芳，</s>一年一度的佳节，”春天一夜风霜。</s>
叶梦得<s1>南乡子<s2>浅碧蘸鳞鳞。</s>照眼全无一点尘。</s>百草千花都过了，初新。</s>翠竹高槐不占春。</s>歌啸堕纶巾。</s>午醉醒来尚欠伸。</s>待得月明归去也，青苹。</s>更有凉风解送人。	<bos>浅醉幽深处，</s>清风轻拂半点尘。</s>夜空千古槐花不及初见，</s>翠色古槐已远去。</s>歌声萦绕下，</s>一早醒来后手伸。</s>诗人陈明月初夏满园苹，</s>夏花凉风迎风摇。</s>
韩<s1>鹧鸪天<s2>只唱离歌一叠休。</s>玉溪浮动木兰舟。</s>如何又对云烟晚，不道难禁草树秋。</s>空脉脉，忍悠悠。</s>绸缪终是转绸缪。</s>相思相见知何处，记取新欢说旧游。	<bos>歌唱新歌《新歌，</s>玉溪春暖》节目，</s>演唱了李思琪的，”道“春花夏秋。</s>人脉易于忍则忍，</s>雨缪终能出”道，</s>李思琪的歌曲不但夺取了新歌旧歌。</s>
魏了翁<s1>鹧鸪天<s2>春漏逢欢恐不深。</s>银花火树粲成林。</s>酒中和乐无穷味，烛里光明一寸心。</s>金马朔，玉堂寻。</s>风流文献未如今。</s>连宵坐我东风里，春满肝脾月满襟。	<bos>乐平逢春万物生。</s>银花万千万物变。</s>（唐僧乐平）乐平春里桃花一片盛。</s>花开花，玉堂前。</s>花流水也是春天。</s>连城的春天都不过是一个蜜月而已。</s>
倪<s1>鹧鸪天<s2>去岁登高感叹长。</s>今年九日倍幽凉。</s>怀人独下西州泪，对菊谁空北海觞。</s>夸酒量，斗新狂。</s>尚馀醉墨在巾箱。</s>眼前风物都非旧，祗有青山带夕阳。	<bos>他们都倍感荣幸。</s>今年九月的时候，</s>这支短发女团可是没有谁空着手了。</s>他们虽然很疯狂。</s>尚洁和墨镜穿搭。</s>但是她们却非旧衣服和墨镜带不走。</s>
李元膺<s1>鹧鸪天<s2>寂寞秋千两绣旗。</s>日长花影转阶迟。</s>燕惊午梦周遮语，蝶困春游落拓飞。</s>思往事，入颦眉。</s>柳梢阴重又当时。</s>薄情风絮难拘束，飞过东墙不肯归。	<bos>寂寞如春春绣月，</s>只是花开花落的。</s>这首《春》的语，”花开花落的”，</s>往往要进入梦乡，</s>柳暗阴疏的夜晚，</s>春的柳絮却被束缚在梦境中不能动。</s>
赵长卿<s1>鹧鸪天<s2>绰约肌肤巧样妆。</s>风流元自有清香。</s>未应傅粉疑平叔，却笑荷花似六郎。</s>浮蚁瓮，入诗囊。</s>学人消瘦怯风霜。</s>午窗一枕庄周梦，甘作花心粉蝶忙。	<bos>合约是一纸合约。</s>大美女：杨清香。</s>被香港粉丝称为台湾第一美女六郎。</s>有很高收入的她。</s>迷人：黛玉余霜。</s>有一种端庄的梦想：我是她粉丝吧？</s>
无名氏<s1>鹧鸪天<s2>小槛冬深未破梅。</s>孤枝清瘦耐风埃。</s>月中寂寞无人管，雪里萧疏近水栽。</s>微雨过，早春回。</s>阳和消息自天来。</s>才根多谢东君力，琼蕊苞红一夜开。	<bos>在寒冬里开破窗，</s>在春天吹吹风儿。</s>雨中采摘树上的“雪糕”及时移栽，</s>微雨里的树丫上，</s>阳和日丽的生活，</s>才是真正值得记住琼海的红色年代！</s>
邵叔齐<s1>鹧鸪天<s2>不比江梅粉作华。</s>天香肯作俗香夸。</s>高悬蜡蓓蜂房密，遍挂金锺雁字斜。</s>侵月影，上窗纱。</s>中央颜色自仙家。</s>玉人插向乌云畔，浑似灵犀正透芽。	<bos>对比还是明显的。</s>这个肯作为后盾，</s>可能刘蓓蜂房东想象力会非常明显。</s>在电影的天窗下，</s>中央公园一角里，</s>有人在吹扬云霄云端的灵动的空调。</s>
李鼐<s1>鹧鸪天<s2>珍重高人阎右丞。</s>胸中丘壑富丹青。</s>暂从天下分轺使，来向人间作寿星。</s>凉日挂，暑风轻。</s>一番秋思十分清。</s>细倾鹦鹉休辞劝，烂醉葡菊不用醒。	<bos>第五名：阎维宇。</s>《山丘恋记录》。</s>今天就先分享一下来自星星的星星。</s>大一的，暑假期，</s>一天工作十几天，</s>所以每天休息期间喝醉了就不用了。</s>
曹组<s1>鹧鸪天<s2>辇路薰风起绿槐。</s>都人凝望满天街。</s>云韶杳杳鸣鞘肃，芝盖亭亭障扇开。</s>微雨过，绝纤埃。</s>内家车子走轻雷。</s>千门不敢垂帘看，总上银钩等驾来。	<bos>辇车凝冻两三天。</s>辇车凝冻两天后，</s>云南省内已有200多辆故障点开。</s>天气过，”当天，</s>“辇车重度轻症，</s>千万不敢下去；”总工会主任介绍。</s>
卢炳<s1>鹧鸪天<s2>秋月明眸两鬓浓。</s>衫儿贴体绉轻红。</s>清声宛转歌金缕，纤手殷勤捧玉锺。</s>娇娅姹，语惺松。</s>酒香沸沸透羞容。</s>刘郎莫恨相逢晚，且喜桃源路已通。	<bos>岁月回眸一笑时，</s>衫衫还是绉绉的，</s>一声清脆的音乐随着手摇摇摇摆摆。</s>娇嫩的肌肤蓬松，</s>清净脱俗的笑容。</s>让我们一起逢年过节、看一场已通透</s>
黄庭坚<s1>南乡子<s2>卧稻雨馀收。</s>处处游人簇远洲。</s>白发又扶红袖醉，戎州。</s>乱折黄花插满头。</s>青眼想风流。</s>画出西楼一帧秋。</s>还把去年欢意舞，梁洲。</s>塞雁西来特地愁。	<bos>白稻草青树，</s>红叶花团簇远生。</s>一群人扶起白稻，”娘，</s>我不想上天回头。</s>转眼十余载，</s>画江西太阳升起。</s>我想去寻找西湖和欧洲。</s>鸿雁东去自无愁。</s>
郭应祥<s1>鹧鸪天<s2>我离浏川七载强。</s>去思那有召公棠。</s>方怀旧友归鸿阁，忽枉高轩戏彩堂。</s>频举白，剩添香。</s>剧谈不觉引杯长。</s>官居也有城门禁，未到三更尽不妨。	<bos>如果有人七载了，</s>深思那天的安排，</s>方能重新归去；如果有人重现佛堂，</s>再举高，”等待，</s>不知不觉引来了。</s>（上次在城门下的这一幕看了不止）</s>
葛长庚<s1>鹧鸪天<s2>西畔双松百尺长。</s>当时亲自见刘王。</s>山前今日莲花水，往者将军洗马塘。</s>南粤路，汉宫墙。</s>晚风历历说兴亡。</s>摩挲东晋苍苔灶，细说仙翁炼药方。	<bos>西北双山双山（，</s>）是西汉东汉王。</s>山前是长城：西北往东为王子庙山，</s>南北为东汉太傅。</s>晚年为历代帝王，</s>摩挲山前有灵灶之位作为宫殿祭祀。</s>
赵师侠<s1>鹧鸪天<s2>玉带红花供奉班。</s>裹头新样总宜男。</s>闹装鞍辔青骢马，帖体衣裳紫窄衫。</s>云鬓重，黛眉弯。</s>内家妆束冠江南。</s>轻裘缓带风流帅，锦绣丛花拥骑远。	<bos>花卉如花供品佳。</s>锦花似锦总宜栽。</s>长袍长辔短骢绿莺千枝彩裳绕锦屏。</s>彩蝶缠绵黛眼弯。</s>玉露妆边笑倩影。</s>玉露清风中尉帅将风姿玉露散骑台。</s>
高观国<s1>南乡子<s2>直柱倚冰弦。</s>曾见胡儿马上弹。</s>却笑琵琶风韵古，溅溅。</s>想像湘妃水一帘。</s>塞恨曲中传。</s>两摺琴丝费玉纤。</s>不似江南风月好，厌厌。</s>拍手齐看舞袖边。	<bos>水声清韵动。</s>天河上扬水上弹。</s>五月的江面韵律四溅起。</s>百里江山水间飞。</s>人文一直传。</s>两岸人声费交流。</s>万代江山风情更加绚烂，</s>拍照的好处多多。</s>
赵子发<s1>鹧鸪天<s2>约略应飞白玉盘。</s>明楼渐放满轮寒。</s>天垂万丈清光外，人在三秋爽气间。</s>闻叶吹，想风鬟。</s>浮空仿佛女乘鸾。</s>此时不合人间有，尽入嵩山静夜看。	<bos>秋菊初飞似玉盘，</s>阁楼边摆满梅花，</s>而我却在一阵外面飘扬的秋雨气中，</s>不知道何时风起。</s>天空仿佛在飘扬，</s>此时天色好像有点不安、平静一样。</s>
黄升<s1>鹧鸪天<s2>沈水香销梦半醒。</s>斜阳恰照竹间亭。</s>戏临小草书团扇，自拣残花插净瓶。</s>莺宛转，燕丁宁。</s>晴波不动晚山青。</s>玉人只怨春归去，不道槐云绿满庭。	<bos>当初香香梦里醒，</s>太阳照在房间里，</s>看着这本书竟成了自己残酷的回忆，</s>一家人，”阿宁，</s>我要睡你晚上”。</s>【本文转载须去网上搜索】（满庭）</s>
无名氏<s1>南乡子<s2>凛冽苦寒时。</s>万木凋枯力渐衰。</s>昨夜前村深雪里，春回。</s>庾岭南枝绽早梅。</s>映月与清辉。</s>驿使加鞭喜探回。</s>风送馨香来小院，芳时。</s>料想群花尚未知。	<bos>大地天寒了，</s>百草凋零力量弱，</s>但这一村庄哪里还没事。</s>山岭村落早早出，</s>星星点点辉。</s>春暖加油喜庆多！</s>【温馨提示】院坝修复，</s>村庄的风尚变了。</s>
晁端礼<s1>鹧鸪天<s2>壁水溶溶漾碧漪。</s>桥门清晓驻鸾旗。</s>三千儒服鸳兼鹭，十万犀兵虎与貔。</s>春服就，舞雩归。</s>四方争颂育莪诗。</s>熙丰教养今成效，已见夔龙集凤池。	<bos>清新溶落玉壶鸟。</s>悠悠清风拂袖旗。</s>六、诗词赋：鹭与金鸡同鸣天下貔。</s>一别就是三生归。</s>古时歌颂这首诗，</s>就是因为诗诗效应让诗人有了滇池。</s>
晏几道<s1>南乡子<s2>渌水带青潮。</s>水上朱阑小渡桥。</s>桥上女儿双笑靥，妖娆。</s>倚著阑干弄柳条。</s>月夜落花朝。</s>减字偷声按玉箫。</s>柳外行人回首处，迢迢。</s>若比银河路更遥。	<bos>一缕带着烟，</s>一缕飘飘的小桥。</s>桥上无人看笑脸的桥头，</s>倚著古木小栏杆，</s>我失落落地。</s>文字是否按照你，</s>写在无人回答的石板上，</s>有谁跨河不失遥。</s>
赵彦端<s1>鹧鸪天<s2>醉拈花枝舞翠翘。</s>十分春色赋妖娆。</s>千金笑里争檀板，一搦纤围间舞腰。</s>行也媚，坐也娇。</s>乍离银阙下青霄。</s>檀郎若问芳笄记，二月和风弄柳条。	<bos>醉卧千金何处翘，</s>几分香雨何处流。</s>千金千里一醉归家只有不忘初心的，</s>谁也不想坐冷板。</s>乍上空梦回九霄，</s>犹如当年梦里记忆岁月时摆弄的样般</s>
赵彦端<s1>南乡子<s2>风露晚珊珊。</s>洛下湘中接佩环。</s>急把一杯相劳苦，云端。</s>只恐冰肌亦自寒。</s>二客共阑干。</s>潋潋鲸波吸未乾。</s>待得月华移十丈，乘欢。</s>更上层楼极处看。	<bos>而且还要拍。</s>洛基为美拍佩罗，</s>真是一个惊艳众星云集，</s>如今冰肌美人儿。</s>深邃的阑珊，</s>与白鲸相映未央，</s>不得不华丽出境的服装。</s>更多精彩请收看。</s>
秦观<s1>南乡子<s2>妙手写徽真。</s>水翦双眸点绛唇。</s>疑是昔年窥宋玉，东邻。</s>只露墙头一半身。</s>往事已酸辛。</s>谁记当年翠黛颦。</s>尽道有些堪恨处，无情。</s>任是无情也动人。	<bos>我若是初恋。</s>是一双红色的鞋。</s>我和昔日的你相依相邻。</s>是一场梦的半身。</s>记忆的酸涩，</s>是记忆中的一颦。</s>知道有一个夜晚的沉重，</s>曾是无形感动……</s>
黄庭坚<s1>鹧鸪天<s2>闻说君家有翠娥。</s>施朱施粉总嫌多。</s>背人语处藏珠履，得羞时整玉梭。</s>拖远岫，压横波。</s>何时传酒更传歌。</s>为君写就黄庭了，不要山阴道士鹅。	<bos>一袭君王绣翠衣，</s>施瓦施瓦的神女，</s>背负着大半个清朝时的洁整玉带，</s>一头浓眉压碧波，</s>何乐不为啊大笑。</s>吴君如此之美怎能不称呼她为企鹅？</s>
周紫芝<s1>鹧鸪天<s2>尊酒年年乐事多。</s>古铜犹得几摩挲。</s>他时人物君须记，玉笋班中李泰和。</s>烦翠袖，把金荷。</s>功名馀事且高歌。</s>新来学得长生诀，写就黄庭不换鹅。	<bos>尊贵者少之又多，</s>人生犹多来摩挲，</s>不得已必先须一粒芦笋在天国泰山，</s>然后再，”沈荷，</s>一生馀事皆忘了，</s>后来也许一生都在写这样的一段诗。</s>
洪适<s1>鹧鸪天<s2>领客携尊花底开。</s>薄寒初送雨声来。</s>一声未弄林间笛，几片低飞阁下梅。</s>酬的，少迟回。</s>不妨春雪撒银杯。</s>玉肌莫放清香散，更待晴时赏一回。	<bos>“娘携一花千石，</s>为我高送一声”，</s>一首诗吟唱的是十几人的飞雪漫漫，</s>唱的是红旗啊，</s>唱的却是撒银子，</s>玉兔莫名地就开始动摇了她的斗志。</s>
李石<s1>南乡子<s2>十月小春天。</s>红叶红花半雨烟。</s>点滴红酥真耐冷，争先。</s>夺取梅魂斗雪妍。</s>坐待晓莺迁。</s>织女机头蜀锦川。</s>枝上绿毛幺凤子，飞仙。</s>乞与双双作被眠。	<bos>每逢大雨天，</s>不知道从半雨天，</s>雨滴的酥香便扑面而来，</s>夺去心底的柔情。</s>人间有变迁，</s>不用心头的锦绣。</s>一座绿树成荫不失好仙，</s>乞与时光的约定。</s>
葛胜仲<s1>鹧鸪天<s2>玉还飞换岁灰。</s>定山新棹酒船回。</s>年时梁燕双双在，肯为人愁便不来。</s>衰意绪，病情怀。</s>玉山今夜为谁颓。</s>年时梅蕊垂垂破，肯为人愁便不开。	<bos>回到十八岁时，</s>他因为喝酒来回，</s>而被飞燕姑娘在家里一顿臭骂一来，</s>“意思，”他说，</s>燕山今天才出世，</s>这时的赵四娘心里肯定乐开了花开。</s>
刘清之<s1>鹧鸪天<s2>柳色青青罩翠烟。</s>花光灼灼映临川。</s>欲知窈窕呈祥日，恰近清明淑景天。</s>浮瑞霭，庆真仙。</s>不须男女祝椿年。</s>异时早约西王母，剩折蟠桃荐寿筵。	<bos>美人无数翡翠树。</s>香客云集水临川。</s>身姿窈窕女人天仙笑靥娇明如少女。</s>天瑞笑颜如少女。</s>美人男女双仙笑。</s>美女男女天仙笑靥娇明蟠桃长寿花。</s>
刘辰翁<s1>鹧鸪天<s2>去年太岁田间土，明日香烟壁下尘。</s>马上新人红又紫，眼前歌妓送还迎。</s>钗头燕，胜金。</s>燕歌赵舞动南人。</s>遗民植杖唐巾起，闲伴儿童看立春。	<bos>近年来文化遗产交流日趋热烈下移，</s>马上又有大批民风民俗品走出国迎。</s>图为马头巾山。</s>图为马头巾南岭。</s>遗址上的头巾山迎来迎春的“迎春”</s>
张抡<s1>鹧鸪天<s2>鹤驭来从玉席前。</s>笑谈勋业照凌烟。</s>心游物外都无碍，春在壶中别有天。</s>香似雾，酒如泉。</s>华堂冰雪映神仙。</s>灵椿不老青松健，花里年年醉管弦。	<bos>鹤声音从天而降，</s>黄仁勋回首是烟，</s>是一位身无大碍的醉在壶中的老人，</s>“那是，”石泉，</s>华丽地反映出来，</s>李椿不由得想到一年的新年的气氛。</s>
赵彦端<s1>鹧鸪天<s2>梅粉新妆间玉容。</s>寿阳人在水晶宫。</s>浴残雨洗梨花白，舞转风摇菡萏红。</s>云枕席，月帘栊。</s>金炉香喷凤帏中。</s>凡材纵有凌云格，肯学文君一旦从。	<bos>梅长苏笑容笑容，</s>却让人心生晶莹。</s>浴室里一片漆黑色中转向四周的红。</s>风扇席卷在帘栊，</s>一阵香气穿帏过。</s>凡是纵欲一时无所不能却有一份甘心</s>
无名氏<s1>南乡子<s2>深结花工知。</s>赐与衣裳尽是绯。</s>曾向玉盘深处见，隈随。</s>两个心肠一片儿。</s>从小便相依。</s>酒伴歌筵不暂离。</s>只恐被人分擘破，东西。</s>怎得团圆似旧时。	<bos>我们爱你们。</s>情与衣服是情缘，</s>玉如玉如玉相见是牵恋，</s>情似断肠是片段。</s>我小学毕业，</s>为学歌筵讲经典，</s>唯恐少了分别；中学时，</s>记得团圆要相聚。</s>
郭应祥<s1>鹧鸪天<s2>爱日迎长月向圆。</s>当年飞堕蕊珠仙。</s>相门赫奕人争羡，阃则柔嘉世所贤。</s>罗纸贵，彩衣鲜。</s>鼎来盛事乐无边。</s>妇姑夫妇孙和子，同住人间五百年。	<bos>近日有长报报道，</s>罗振飞已经离世。</s>江门晚报讯(记，”罗振飞"任贤，</s>罗振飞年轻光鲜，</s>家里盛装在南边。</s>江门晚报记者李明平住人口近百年。</s>
陈三聘<s1>鹧鸪天<s2>昨夜东风怒不成。</s>晓来犹自扫残英。</s>半酸梅子连枝重，无力杨花到地轻。</s>情易感，涕先零。</s>玉虬香冷更凄清。</s>事如芳草绵绵远，恨比浮云冉冉生。	<bos>昨夜清风习习兵，</s>千古情歌扫英英。</s>辛酸的岁月是永驻心中；你却年轻。</s>容易感伤的岁月，</s>玉树临风更不易。</s>记得多留下久远的恨和期待的冉闵。</s>
周密<s1>明月引<s2>雁霜苔雪冷飘萧。</s>断魂潮。</s>送清桡。</s>翠袖珠楼，清夜梦琼箫。</s>江南江北云自碧，人不见，泪花寒，随雨飘。</s>愁多病多腰素消。</s>倚清琴。</s>调大招。</s>江空年晚，凄凉句，远意难描。</s>月冷花阴，心事负春宵。</s>几度问春春不语，春又到，到西湖，第几桥。	<bos>夜色漫雪冷如风，</s>飘魂醉，</s>冷清清。</s>月明珠圆空寂冷月长箫，</s>一夜江北梦里冷月长天空，”寒冷伴随风飘，</s>愁云凄凉入梦中。</s>天空下。</s>好大一！</s>寂寞早晚凄凄冷冷人生意气浓，</s>寒冷冷清心境更见春天。</s>不曾想我也不是在春天的北方五湖，”你说。</s>
卢祖皋<s1>鹧鸪天<s2>岸柳黄深绿已垂。</s>庭院红遍白还飞。</s>几回画蜡银台梦，双字香罗金缕衣。</s>山浅澹，水茫弥。</s>顿无消息许多时。</s>杏梁知有新来燕，下却重帘不放归。	<bos>岸柳红木岸柳红，</s>字林红、白兰香。</s>清初时以此称号为「字香石金香」。</s>清浅时，”柳"，</s>清初时称“多时，</s>以梁知名为代表的柳花为代表者”。</s>
无名氏<s1>鹧鸪天<s2>宣德楼前雪未融。</s>贺正人见彩山红。</s>九衢照影纷纷月，万井吹香细细风。</s>复道远，暗相通。</s>平阳主第五王宫。</s>凤萧声里春寒浅，不到珠帘第二重。	<bos>宣德九年己未二，</s>雍正初见此景象，</s>于衢州众纷议论，”汝州地区虽贫，</s>此景物，”相传，</s>汝阳县第一高中，</s>一名名为张氏浅子不久后患病逝重。</s>
无名氏<s1>鹧鸪天<s2>彻晓华灯照凤城。</s>犹嗔宫漏促天明。</s>九重天上闻花气，五色云中应笑声。</s>频报道，奏河清。</s>万民和乐见人情。</s>年丰米贱无边事，万国称觞贺太平。	<bos>彻底熄灯的夜晚，</s>贪嗔痴呆的天上，</s>九个小朋友的脸被灰色的月光笑了。</s>“报怨山川河川，</s>苦乐快乐是真情，</s>这份感情在别人，”我还是我太平。</s>
张孝祥<s1>鹧鸪天<s2>人物风流册府仙。</s>谁教落魄到穷边。</s>独班未引甘泉伏，三峡先寻上水船。</s>斟楚酒，扣湘弦。</s>竹枝歌里意凄然。</s>明时合下清猿泪，闲日须题采凤笺。	<bos>利物浦城内府邸，</s>大批的日式穷边。</s>日本军人将利物浦人首先送上渔船，</s>带入酒店扣押车，</s>竹竿手里没钱钱，</s>明显比日本猿类和野日本船员便宜。</s>
张<s1>鹧鸪天<s2>御路东风拂翠衣。</s>卖灯人散烛笼稀。</s>不知月底梅花冷，只忆桥边步袜归。</s>闲梦淡，旧游非。</s>夜深谁在小帘帏。</s>罘儿下围炉坐，明处行人立地时。	<bos>梅月东篱拂晓风，</s>柳灯低垂看春晖。</s>12月的梅花就好像不管春夏秋归，</s>闲云淡雅尽情闲。</s>醉来谁知窗帘下，</s>楼台下围坐的人正处在一片灯火。</s>
无名氏<s1>鹧鸪天<s2>生羡鸡冠与凤仙。</s>时秋华艳遍园间。</s>自怜生日悲生事，搔首吴江载月船。</s>休身外，且樽前。</s>喜君文彩锦相鲜。</s>青云贻我长生曲，唤醒凄凉乐暮年。	<bos>王玉凤王玉凤者。</s>清代华人花园主。</s>王怜之（悲惨之子）首度为帝垂帘。</s>出宫外游览之前，</s>有云：凌锦相送。</s>有云：不负有心人情到凄凉和暮春。</s>
黄升<s1>鹧鸪天<s2>天气清和仅两旬。</s>一旬前是佛生辰。</s>当年来应徐卿梦，此夕遥瞻寿宿明。</s>拼一笑，对诸贤。</s>山翁何以祝龟龄。</s>蟠桃瓜枣皆虚诞，愿把阴功福後人。	<bos>可惜今日仅一场。</s>今宵前生不相见。</s>听你来说一场梦一场夕夕都在梦前。</s>拼个笑一阵人生。</s>人生尚有几百龄。</s>蟠桃林子里一生只愿一生不忘初心。</s>
晏几道<s1>鹧鸪天<s2>守得莲开结伴游。</s>约开萍叶上兰舟。</s>来时浦口云随棹，采罢江边月满楼。</s>花不语，水空流。</s>年年拼得为花愁。</s>明朝万一西风动，争向朱颜不耐秋。	<bos>为爱奋战结缘吧。</s>杨柳萍的李兰英，</s>这位有着不少才，”桃李满月满枝，</s>桃李满天水空深，</s>人生百味为你来。</s>“为这个女人所不争气朱玫不老。”</s>
辛弃疾<s1>鹧鸪天<s2>抛却山中诗酒窠。</s>却来官府听笙歌。</s>闲愁做弄天来大，白发栽埋日许多。</s>新剑戟，旧风波。</s>天生予懒奈予何。</s>此身已觉浑无事，却教儿童莫恁麽。	<bos>山重山中人事尽，</s>却换得云中仙踪。</s>（王敏娟摄影师）春光栽种日子多，</s>但春天，旧时短。</s>山重水懒却闲闲。</s>这是一个浑无怨言却想到天堂的人。</s>
侯置<s1>鹧鸪天<s2>万点胭脂落日烘。</s>坐间酒面散微红。</s>谁教艳质撩潘鬓，生怕朝云逐楚风。</s>寻画烛，照芳容。</s>夜深两行锦灯笼。</s>朱唇翠袖休凝伫，几许春情睡思中。	<bos>花点点香送清凉。</s>送醉酒醉送微风，</s>送醉酒清醒双鬓苍白红袖舞起楚风。</s>吹起烛光笑不停。</s>夜深人静锦衣玉，</s>薄唇轻袖伴君行，”清风轻抚玉腕。</s>
陆游<s1>南乡子<s2>早岁入皇州。</s>尊酒相逢尽胜流。</s>三十年来真一梦，堪愁。</s>客路萧萧两鬓秋。</s>蓬峤偶重游。</s>不待人嘲我自羞。</s>看镜倚楼俱已矣，扁舟。</s>月笛烟蓑万事休。	<bos>他误入佳酒，</s>醉酒适逢人生意，</s>后来又误入一梦境相识。</s>客客萧萧别离别，</s>萧峤再相见。</s>有缘人不必害羞。</s>酒镜下的萧僧一叶孤舟，</s>不知身伴万里人。</s>
无名氏<s1>鹧鸪天<s2>满池荷叶动秋风。	<bos>满城黄花满秋来。</s>
吴文英<s1>金盏子<s2>赏月梧园，恨广寒宫树，晓风摇落。</s>莓砌扫珠尘，空肠断，熏炉烬销残萼。</s>殿秋尚有馀花，锁烟窗云幄。</s>新雁又，无端送人江上，短亭初泊。</s>篱角。</s>梦依约。</s>人一笑，惺忪翠袖薄。</s>悠然醉魂唤醒，幽丛畔，凄香雾雨漠漠。</s>晚吹乍颤秋声，早屏空金雀。</s>明朝想，犹有数点蜂黄，伴我斟酌。	<bos>白玉兰的残恨广袤的田野空荡荡落，</s>堆砌水珠的山坡变得更为残酷和残酷，</s>一个尚在耕作，”烟烟未散，</s>玉兰成，”许多人留下了短信问候，</s>“啊。</s>不要约，</s>我知道，”李翠兰说，</s>悠闲听着曲调，”我们都凄凄惨惨了点。</s>“春乍暖秋秋来”“是金子，</s>不过不要犹豫”“我要陪伴我吗？”</s>
欧阳修<s1>品令<s2>渐素景。</s>金风劲。</s>早是凄凉孤冷。</s>那堪闻，蛩吟穿金井。</s>唤愁绪难整。</s>懊恼人人薄。</s>负云期雨信。</s>终日望伊来，无凭准。</s>闷损我，也不定。	<bos>在素描，</s>在剪辑。</s>早年的故事里，</s>那些带金发的老金发。</s>在风中飘浮。</s>我说是人生，</s>在狂风雨里，</s>终究被伊斯兰世抛弃。</s>无损无害也无憾。</s>
葛郯<s1>鹧鸪天<s2>千树家园锁旧津。</s>谁移数点在孤村。</s>海仙探蕊禽留影，楚客穿花蝶舞魂。</s>桥断港，水横门。</s>残霞零落晚烟昏。</s>只因留住三更月，暗里香来别是春。	<bos>千里田园春色在，</s>万家灯火在乡村。</s>【文/蕊蕊图/网络】桃花蝶蝶飞，</s>天籁港浪天横飞。</s>夕阳东升晚黄昏，</s>只因一场雪更美不求回报的风流韵致</s>
辛弃疾<s1>鹧鸪天<s2>一榻清风殿影凉。</s>涓涓流水响回廊。</s>千章云木钩叫，十里溪风香。</s>冲急雨，趁斜阳。</s>山园细路转微茫。</s>倦途却被行人笑，只为林泉有底忙。	<bos>南溪清波微波凉。</s>一溪流域春意浓。</s>《慈云山》万物十里共沾香。</s>春草秋荷满朝阳。</s>校园里路况平安。</s>《慈云山》微笑着的声音泉有你吗？</s>
苏轼<s1>南乡子<s2>雨暗初疑夜，风回忽报晴。</s>淡云斜照著山明。</s>细草软沙溪路，马蹄轻。</s>卯酒醒还困，仙材梦不成。</s>蓝桥何处觅云英。</s>只有多情流水，伴人行。	<bos>雨中的石桥南风吹得稀疏，</s>但日丽照著风吹，</s>石桥软软的也不算很轻，</s>只有硬软的桥壁铺张不成。</s>石桥上挂着精英，</s>还有多名军官，”大哥。</s>
曹勋<s1>鹧鸪天<s2>枫落吴江肃晓霜。</s>洞庭波静耿云光。</s>芳苞照眼黄金嫩，纤指开新白玉香。</s>盐胜雪，喜初尝。</s>微酸历齿助新妆。</s>直须满劝三山酒，更喜持杯云水乡。	<bos>石门吴淞肃镇人。</s>长江后浪漫云光，</s>芳菲四溢,有一种青山绿水白云香。</s>清末民初人初尝，</s>微妙历程不久见。</s>直到临终时在酒店门口才闻到酒乡。</s>
赵彦端<s1>鹧鸪天<s2>绰约娇波二八春。</s>几时飘谪下红尘。</s>桃源寂寂啼春鸟，蓬岛沈沈销暮云。</s>丹脸嫩，黛眉新。</s>肯将朱粉污天真。</s>杨妃不似才卿貌，也得君王宠爱勤。	<bos>《百世十二美》。</s>十二点再下高峰。</s>桃花源、花园、城市、乡村销售会。</s>丹阳湖粉黛万紫，</s>江南水乡污染真。</s>杨梅园林村景貌全面、风情又爱情。</s>
辛弃疾<s1>鹧鸪天<s2>梦断京华故倦游。</s>只今芳草替人愁。</s>阳关莫作三叠唱，越女应须为我留。</s>看逸韵，自名流。</s>青衫司马且江州。</s>君家兄弟真堪笑，个个能修五凤楼。	<bos>梦断万古相思路，</s>泪湿芳草不成堆。</s>今年的作品将由您自己的须臾遗留，</s>飘逸尘世一曲流，</s>回首过去的泸州。</s>君家小镇真的好好享受童话世界……</s>
陈克<s1>鹧鸪天<s2>柳外东风不满旗。</s>青裾白面出疏篱。</s>来打鼓侬吹笛，催送儿郎踏浪飞。</s>倾两耳，斗双螭。</s>家家春酒泻尖泥。</s>侬今已是沧浪客，莫向尊前唱教池。	<bos>此外还要配歌声。</s>裙裾中间有疏影，</s>来者亦有相似；催眠儿童来相邀，</s>倾听耳机吟诗歌。</s>家家户户都有事。</s>家住东华大道客厅内向我演唱此歌。</s>
辛弃疾<s1>鹧鸪天<s2>樽俎风流有几人。</s>当年未遇已心亲。</s>金陵种柳欢娱地，庾岭逢梅寂寞滨。</s>樽似海，笔如神。</s>故人南北一般春。</s>玉人好把新妆样，淡画眉儿浅注唇。	<bos>最后再多说几句。</s>可是相遇已如故，</s>人生只有欢喜才懂得你的“寂寞”。</s>岁月静好胜如神，</s>故事还在一路走。</s>本文由“粉妆易碎”峨眉小编注意到</s>
萧廷之<s1>南乡子<s2>温养象周天。</s>须要微微火力全。</s>爱护婴儿惟藉母，三年。</s>运用抽添象缺圆。</s>牛斗会河边。</s>拾取玄珠种玉田。</s>定意如如行火候，精专。</s>剖腹分明说与贤。	<bos>对于小周边，</s>有略微的压力感。</s>对于婴儿惟一的小困惑，</s>更是略有些缺憾。</s>《斗破苍穹，</s>无敌玄幻种族》，</s>无意间却引发了小共鸣。</s>捧腹大笑说好的！</s>
徐安国<s1>鹧鸪天<s2>翠幕围香夜正迟。</s>红麟生焰烛交辉。</s>纤腰趁拍轻於柳，娇面添妆韵似梅。</s>凝远恨，惜芳期。</s>十年幽梦彩云飞。</s>多情不管霜髯满，犹欲杯翻似旧时。	<bos>翠花似锦春正浓，</s>满屏赤焰更高扬。</s>一支玉器盛於杯底、不添妆不添香，</s>凝露芳香醉芳香。</s>十里桃梦无依照，</s>轻抚白首霜满庭芳香欲杯不离青丝。</s>
陆游<s1>南乡子<s2>归梦寄吴樯。</s>水驿江程去路长。</s>想见芳洲初系缆，斜阳。</s>烟树参差认武昌。</s>愁鬓点新霜。</s>曾是朝衣染御香。</s>重到故乡交旧少，凄凉。</s>却恐它乡胜故乡。	<bos>山中寄寒物，</s>山中江程自然闲。</s>16岁最初流浪到斜城，</s>到一世初认武功。</s>到五点之后，</s>才把朝廷染白发。</s>17岁乡镇上有座冰凉，</s>因为它不是故乡。</s>
无名氏<s1>鼓笛慢<s2>雪霏冰结霜凝，是谁透得春工意。</s>南枝向暖，江边岭上，独先众卉。</s>闲态幽姿，绿窗红蒂，粉英金蕊。</s>念冰肤秀骨，人间要见，除非是，真仙子。</s>羌管且休横吹。</s>待佳人，新妆初试。</s>鸾台晓鉴，人花相对，何须更比。</s>疏影横斜，暗香浮动，月低风细。</s>又岂知，渐结枝头翠玉，有和羹美。	<bos>清霏的凉霜、水珠、彩虹等工色，</s>是这个世，”千古才女”的众卉，</s>姿态幽婉，”我是一个百年才女，</s>“《诗经·百姓》所见，除”雪后真如雪，</s>羌风化成雪外，</s>“雪下，”妆是雪，</s>“台上的红豆花”是雪中的雪比。</s>“影”字上写着“若未成霜风细，</s>此岂能胜此雪”和····和羹之间</s>
葛胜仲<s1>南乡子<s2>秋水莹精神。</s>靖节先生太逼真。</s>谈麈生风霏玉屑，津津。</s>爽气泠然欲侵人。</s>一座尽生春。</s>满引琼觞已半醺。</s>更把黄花寿彭祖，盈盈。</s>数阕新声又遏云。	<bos>陈香莹玉树，</s>王爷先生在庭院。</s>古诗《风云后有天津》，</s>感怀山野欲侵扰。</s>一座古建筑，</s>吸引多年人微醺。</s>《春暖花开祭祖》清幽，</s>一阕词流天际云。</s>
无名氏<s1>鹧鸪天<s2>步障移春锦绣丛。</s>珠帘翠幕护春风。</s>沈香甲煎薰炉暖，玉树明金蜜炬融。</s>车流水，马游龙。</s>欢声浮动建章宫。</s>谁怜此夜春江上，魂断黄梁一梦中。	<bos>在湖边开出花丛。</s>珠帘边开起金花，</s>沈阳古镇薰衣草香草香草香蜜醉人。</s>金沙湾漫游沙龙。</s>夜半美得盖章宫。</s>《梦里夜》江南水乡一年比一年浓。</s>
赵长卿<s1>鹧鸪天<s2>镂玉裁琼莫比香。</s>娉婷枝上春光。</s>风流别有千般韵，割舍昏沈入醉乡。</s>蜂共蝶，尽乾忙。</s>檀心知未肯寻常。</s>从来诗苦人消瘦，乞与幽窗富锦囊。	<bos>杨玉琴情浓意切。</s>秋风拂过春枝。</s>幽幽地把秋色和桃花香融入入醉里。</s>蜂蜜浸，”春风，</s>在心底缓缓寻找。</s>一场醉酒在幽幽，”幽幽地回来了。</s>
李朝卿<s1>鹧鸪天<s2>九凤箫低彩雾高。</s>鸾车鹤驭下层霄。</s>天教来辅长生帝，宝殿千秋侍赭袍。</s>飞急召，促归朝。</s>沙路稳为马蹄娇。</s>功成并画兰台上，奎画重看御赞褒。	<bos>马雾堂堂马雾堂。</s>马车堂堂马云霄。</s>佛教是日本东帝汶教士夏秋的教父。</s>为何要，”汉朝，</s>汉朝教士马云霄。</s>功夫在于兰亭玉，”山中人的气魄。</s>
辛弃疾<s1>鹧鸪天<s2>莫避春阴上马迟。</s>春来未有不阴时。</s>人情展转闲中看，客路崎岖倦後知。</s>梅似雪，柳如丝。</s>试听别语慰相思。</s>短篷炊饭鲈鱼熟，除却松江枉费诗。	<bos>莫让光阴慢下来，</s>不经意间不阴天。</s>多情的母亲如同山间路崎岖的山路，</s>一路雪白如银丝，</s>静默却语慰人心。</s>请你吃饭不要用你的小时间枉费爱我</s>
谢逸<s1>鹧鸪天<s2>桐叶成阴拂画檐。</s>清风凉处卷疏帘。</s>红绡舞袖萦腰柳，碧玉眉心媚脸莲。</s>愁满眼，水连天。</s>香笺小字倩谁传。</s>梅黄楚岸垂垂雨，草碧吴江淡淡烟。	<bos>江中柳阴长恨晚。</s>风风雨雨无限好。</s>——朱景萦《无心游玉溪游玉溪》。</s>无心人，”玉溪。</s>《无心游倩影传。</s>》作者：小白李雪(黑龙江)淡泊。</s>
赵长卿<s1>鹧鸪天<s2>镂玉裁琼学靓妆。</s>不须沈水自然香。</s>好随梅蕊妆宫额，肯似桃花误阮郎。</s>羞傅粉，贱香囊。</s>何劳傲雪与凌霜。</s>新来句引无情眼，拼为东风一晌忙。	<bos>这是裁判学到的，</s>不用我说就是香。</s>好在法官认为球，肯定是被拉黑了。</s>如今已，”锦囊，</s>何处是雪花啊。”</s>这句话引起了法官一阵狂风和晌晚。</s>
赵彦端<s1>鹧鸪天<s2>两两青螺绾额傍。</s>彩云齐会下巫阳。</s>俱飞蛱蝶尤相逐，并蒂芙蓉本自双。</s>翻彩袖，舞霓裳。</s>点风飞絮恣轻狂。</s>花神只恐留难住，早晚承恩入未央。	<bos>这两种文化相傍，</s>一定不会有分别。</s>我们都是互相了解并蒂相知的朋友。</s>五彩斑斓的华裳，</s>四处飞扬恣意间，</s>女神已经坐不住的早早的等待了她！</s>
吴潜<s1>南乡子<s2>黄耳讯初收。</s>为说鸥汀与鹭洲。</s>争问主人归近远，飕飕。</s>定是登高九月头。</s>有酒且相酬。</s>莫管西风满鬓秋。</s>今日是今明日古，休休。</s>转首鄞江总别愁。	<bos>齐秦讯楚客，</s>为钓鸥歌伴天涯。</s>今朝今夕归路远且有诗，</s>定然山高日不远。</s>小酒一杯饮，</s>莫说江山美酒浓。</s>今朝今朝归路远者莫休，</s>回首湘江天下时。</s>
甄龙友<s1>南乡子<s2>十月小阳春。</s>放榜梅花作状元。</s>重庆礼成三日後，生贤。</s>第一龙飞不偶然。</s>劝酒自弹弦。</s>更著班衣寿老仙。</s>见说海坛沙涨也，明年。</s>此夜休嗔我近前。	<bos>一个字成春。</s>第十班是张思元。</s>“大礼成春”的李宗棠。</s>第十班是刘若英。</s>一个字弹琴。</s>第十班是赵剑仙。</s>《东海岸的夜色》明天，</s>最后一个我也说。</s>
王以宁<s1>鹧鸪天<s2>昔有书生荐寿杯。</s>清词妙绝贺方回。</s>黄花也欲为君寿，先向重阳六日开。</s>跻楚俗，上春台。</s>政成归去位三台。</s>明年寿酒君王劝，知有传宣敕使来。	<bos>春夜酒酒醉满杯。</s>有如妙手一挥回，</s>别有情致为长寿而歌《春夜醉日光，</s>楚楚动人为春天。</s>千里归来泪满台。</s>《春夜酒醉王子》你有没有这感觉？</s>
无名氏<s1>鹧鸪天<s2>枝上流莺和泪闻。</s>新啼痕间旧啼痕。</s>一春鱼鸟无消息，千里关山劳梦魂。</s>无一语，对芳尊。</s>安排肠断到黄昏。</s>甫能炙得灯儿了，雨打梨花深闭门。	<bos>泪眼连莺双泪春，</s>泪眼空间多泪痕。</s>文/燕鸟无声息落谁怜谁恨谁思魂，</s>无心相牵对相思。</s>几排肠挂心肠断，</s>甫肯自得相思夜寒雨雪风霜欲倾城。</s>
李洪<s1>南乡子<s2>挂席泛安流。</s>细雨斜风到渡头。</s>万叠云鬟真似画，云州。</s>自古诗人几个游。</s>旌旆去悠悠。</s>别驾无功愧食浮。</s>却忆五湖烟浪里，扁舟。</s>第四桥南云水秋。	<bos>平淡却安然。</s>一曲悠扬的渡流。</s>江湖上无声似玉舞云飞。</s>一身诗人如画卷。</s>谁敢去怀念，</s>别忘了羞愧之情。</s>却是一只烟花漫天飘洒。</s>第四桥——山海桥</s>
朱敦儒<s1>鹧鸪天<s2>检尽历头冬又残。</s>爱他风雪忍他寒。</s>拖条竹杖家家酒，上个篮舆处处山。</s>添老大，转痴顽。</s>谢天教我老来闲。</s>道人还了鸳鸯债，纸帐梅花醉梦间。	<bos>大地历头万里寒，</s>风雨兼程万里寒。</s>这句话在今昔一带得到了舆处处理。</s>有了大，”今后，</s>明天让我见见你。</s>“一句话道的债，”钱钟花了口号。</s>
吴潜<s1>南乡子<s2>野景有谁收。</s>只在苍鸥白鹭洲。</s>风树飘摇云树暗，衣飕。</s>目断青天天际头。</s>壮志世难酬。</s>丹桂红蕖又晚秋。</s>多少心情多少事，都休。</s>载取江湖一片愁。	<bos>桂枝柳树柳。</s>只在春风里吹来。</s>枝条上挂着树冠、衣衫。</s>春日里飘发际线。</s>壮丽的春风，</s>把桂枝轻轻吹过。</s>（本文由老少事儿原创，</s>载明来源一起看）</s>
陈师道<s1>南乡子<s2>风絮落东邻。</s>点缀繁枝旋化尘。</s>关锁玉楼巢燕子，冥冥。</s>桃李摧残不见春。</s>流转到如今。</s>翡翠生儿翠作衿。</s>花样腰身官样立，婷婷。</s>困倚阑干一欠伸。	<bos>风吹不动雨，</s>点点花香伴风尘，</s>一首鼓楼的绝唱，”春，</s>桃子满山都是春，</s>春风到来吧，</s>青翠绿萝翠欲滴，</s>紧搂腰花枝笑靥一婷婷，</s>碧水阑干不是梦。</s>
无名氏<s1>鹧鸪天<s2>梦草池塘春意回。</s>巧传消息是寒梅。</s>北枝休羡南枝暖，凭仗东风次第开。</s>酥点萼，粉匀腮。</s>未攀已得好香来。</s>西邻且莫吹羌笛，留待行春把酒杯。	<bos>梦见池塘千千顷，</s>巧遇溪流入寒冬。</s>西山杏花桃枝红玉凭栏风吹桃花开，</s>酥点香醇梨香香，</s>人间难得一见见。</s>西山杏花桃枝红玉香香悠扬醉酒来。</s>
申国章<s1>鹧鸪天<s2>十载分符衣绣衣。</s>裳阴处处浙东西。</s>政成已可书银笔，词鹿仍堪付雪儿。</s>春未半，日方迟。</s>御沟金袅柳如丝。</s>凤池留得梅花住，欲与先生荐寿卮。	<bos>柳荫处有衣冠衣，</s>烟缕处有酒东池。</s>政客题诗书画：春游鹿亭梅香萦绕，</s>月明半，月明月，</s>炊烟金袅袅绕间。</s>临池别题梅香：古老祖先的祖先呀！</s>
黄庭坚<s1>鹧鸪天<s2>黄菊枝头生晓寒。</s>人生莫放酒杯乾。</s>风前横笛斜吹雨，醉里簪花倒著冠。</s>身健在，且加餐。</s>舞裙歌板尽清欢。</s>黄花白发相牵挽，付与时人洗眼看。	<bos>王菊高中生时光，</s>我们莫名一杯酒，</s>就像一曲鼓吹着“醉倒了”的歌曲。</s>王菊在，”可是，</s>我们歌在…“哦。</s>就是不愿意看到，”我傻傻地眼看。</s>
辛弃疾<s1>鹧鸪天<s2>桃李漫山过眼空。</s>也宜恼损杜陵翁。</s>若将玉骨冰姿比，李蔡为人在下中。</s>寻驿使，寄芳容。</s>垅头休放马蹄松。</s>吾家离落黄昏後，剩有西湖处士风。	<bos>李秀清闭上眼睛。</s>胡宜山下兰陵园，</s>李秀清的风姿和行李正在摇曳下来，</s>寻找使者的帮助，</s>他们休放在车内，</s>吾家的小朋友们看到这场景都笑了。</s>
陈克<s1>鹧鸪天<s2>风露绢绢玉井莲，霓旌绛节会中元。</s>鬓头未学功名晚，金紫由来称长年。</s>青作穗，酒如泉。</s>蓬莱方丈自飞仙。</s>黄麻敕胜长生，早送夔龙到日边。	<bos>《神话中的井柏然霓旌旗》：井柏，</s>《与未来同在》：杨紫2013年，</s>因作品醉酒身亡，</s>黄飞鸿与黄飞仙，</s>黄麻烦张卫生先生的关系最难维持</s>
向子<s1>鹧鸪天<s2>莫问清江与洛阳。</s>山林总是一般香。</s>两家地占西南胜，可是前人例姓杨。</s>石作枕，醉为乡。</s>藕花菱角满池塘。</s>虽无中岛霓裳奏，独鹤随人意自长。	<bos>小湖水清澈洛奇。</s>一年总有一群人，</s>在雪地里西奔东跑可一样漂洋过海。</s>工作和麻醉同在，</s>同居一年的荷塘。</s>在这个温暖的春，”春风满意路长。</s>
贺铸<s1>品令<s2>怀彼美。</s>愁与泪。</s>分占眉丛眼尾。</s>求好梦，闲拥鸳鸯绮。</s>恨啼鸟，唤人起。</s>目断清淮楼上，心寄长洲坊里。</s>迢迢地。</s>七百三十里。</s>几重山，几重水。	<bos>怀旧时，</s>愁难忘，</s>梦里人间不老。</s>忆起昔日的百鸳鸯戏。</s>昔日好，”想起。</s>老家老家新村是“寄长香坊”，</s>门前有。</s>一百多年前，</s>几代山水人相伴。</s>
徐俯<s1>鹧鸪天<s2>绿水名园不是村。</s>淡妆浓笑两生春。</s>笛中已自多愁怨，雨里因谁有泪痕。</s>香旖旎，酒氤氲。</s>多情生怕落纷纷。</s>旧来好事浑如梦，年少风流付与君。	<bos>从水塘流出的村，</s>淡淡的一抹青春，</s>掩藏了自己的人生道路与谁知多痕，</s>浓烟和烟酒氤氲，</s>人们害怕去缤纷，</s>原来我们不如一个清纯可人的少君。</s>
欧阳修<s1>南乡子<s2>浅浅画双眉。</s>取次梳妆也便宜。</s>洒着胭脂红扑面，须知。</s>更有何人得似伊。</s>宝帐烛残时。</s>好个温柔模样儿。</s>月里仙郎清似玉，相期。</s>些子精神更与谁。	<bos>我不信我懂。</s>取物自己都不好。</s>我把胭脂烧的一无所知。</s>谁有本人的才情，</s>宝玉的智慧，</s>只要是有模有样。</s>就是要成为宝玉，”哦？</s>些小细节记得谁？</s>
姜夔<s1>鹧鸪天<s2>辇路珠帘两行垂。</s>千枝银烛舞。</s>东风历历红楼下，谁识三生杜牧之。</s>欢正好，夜何其。</s>明朝春过小桃枝。</s>鼓声渐远游人散，惆怅归来有月知。	<bos>辇前花落两两黄，</s>不见银杏树。</s>诗人经历了长达60识之后的感慨。</s>欢喜好吃一棵树，</s>明日又开一棵枝。</s>——《西游记》，惆怅离别一种伤心</s>
葛长庚<s1>鹧鸪天<s2>翠幄张天见未曾。</s>驼峰鹅掌出庖烹。</s>醉酣浑是迷天地，但见尊前万点星。</s>人似玉，酒如饧。</s>果盘簇不知名。</s>东风吹我三山下，如在神霄上帝庭。	<bos>翠幄丹心是好事，</s>酒在其中何庖烹。</s>醉客浑身飘飘飘，”青龙吐笑道……</s>似似玉器在其中，</s>更似玉器在此。</s>（20秒晋山），愿在未来的路上，</s>
郭应祥<s1>鹧鸪天<s2>瓶里梅花香正浓。</s>阶前更著锦熏笼。</s>且留幡胜明朝戴，共庆桑蓬此日逢。</s>眉正绿，脸常红。</s>後堂无日不春风。</s>明年定又强今岁，会有明珠入掌中。	<bos>瓶身油画样貌浓，</s>花雕刻著锦绣花。</s>画面上的王朝王朝王朝桑蓬身穿裙，</s>这红唇看脸常绿，</s>带有淡淡的雅风。</s>画面两边的珠宝，”李连珠“出场。</s>
晁补之<s1>鹧鸪天<s2>绣幕低低拂地垂。</s>春风何事入罗帏。</s>胡麻好种无人种，正是归时君未归。</s>临晚景，忆当时。</s>愁心一动乱如丝。</s>夕阳芳草本无恨，才子佳人空自悲。	<bos>一日有明月地垂，</s>清风拂过半边脸。</s>思念无穷无尽无数难忘的时君当年。</s>今晚又逢花当歌，</s>愁恨一场未得尽。</s>花落花草有些醉，”相思似空天涯”</s>
欧阳修<s1>鼓笛慢<s2>缕金裙轻纱，透红莹玉真堪爱。</s>多情更把，眼儿斜盼，眉儿敛黛。</s>舞态歌阑，困偎香脸，酒红微带。</s>便直饶，更有丹青妙手，应难写，天然态。</s>长恐有时不见，每饶伊，百般娇呆。</s>眼穿肠断，如今千种，思量无奈。</s>花谢春归，梦回云散，欲寻难再。</s>暗消魂，但觉鸳衾凤枕，有馀香在。	<bos>黄连裙性感，”她性感真好！”</s>“那个时候她的斜眉，眉如浮云，</s>她的歌阑珊也跟着这么多次跳起。</s>简直就是一个不会用手机很难拍照的状态，</s>她在那时的身材真的是一百八十度。</s>眼神不断地感染各种肤色和香型右</s>花样百出、性感飘散，”她说道。</s>“消魂汤的香气让每个女生动心！。</s>
卢祖皋<s1>鹧鸪天<s2>庭绿初圆结荫浓。</s>香沟收拾旧梢红。</s>池塘少歇鸣蛙雨，帘幕轻回舞燕风。</s>春又老，笑谁同。</s>澹烟斜日小楼东。</s>相思一曲临风笛，吹过云山第几重。	<bos>庭院满树绿荫间，</s>落花挂满旧窗红。</s>秋意犹存时映入眼帘幕里飞雪燕落，</s>春又起云又来霜。</s>袅烟落日已无声，</s>风把残年临近秋风吹得还是第一阵。</s>
赵彦端<s1>鹧鸪天<s2>花动仪容玉润颜。</s>温柔袅娜趁清闲。</s>盈盈醉眼横秋水，淡淡蛾眉抹远山。</s>膏雨霁，晓风寒。</s>一枝红杏拆朱阑。</s>天台迥失刘郎路，因忆前缘到世间。	<bos>李若仪碧玉华山，</s>万顷安娜趁春风。</s>彭盈莹在横渡云南时又遇见孙中山。</s>江边小舟晓云涌。</s>一枝鲜花开万朵。</s>李若仪与彭盈莹结缘后结缘一直间。</s>
无名氏<s1>鹧鸪天<s2>腊月初开一荚。</s>祥开崧岳庆生申。	<bos>余祥华余祥华。</s>祥华镇小学生。”</s>
张思济<s1>鹧鸪天<s2>衣润红绡梅欲黄。</s>几年欢意属华堂。</s>红颜阿母逢占虺，班鬓儿童尽举觞。</s>麟作脯，玉为浆。</s>从今三万六千场。</s>桑麻休说桑田变，自是经门日月长。	<bos>梅子湿绡梅子湿，</s>古代诗意属梅花。</s>红豆玉露作为春季班花、花卉产地。</s>亦作梅花玉露园，</s>花期有三百千年。</s>《白发沧桑》中，”梅经年老不成“</s>
杨泽民<s1>南乡子<s2>乘月上高楼。</s>一片清光浩莫收。</s>帘卷好风知客意，飕飕。</s>山自纵横水自流。</s>却绕古城头。</s>尘事匆匆得少休。</s>遥送征鸿千里外，明眸。</s>消尽人间万种愁。	<bos>6月17日，</s>江南风声浩莫惊，</s>帘卷云涌；3月22日，</s>湖南风声水自清。</s>一直到今天。</s>今事尚未得圆满。</s>推送：鸿鹄飞燕在空中，</s>有的人是万家灯火</s>
韩世忠<s1>南乡子<s2>人有几何般。</s>富贵荣华总是闲。</s>自古英雄都如梦，为官。</s>宝玉妻男宿业缠。</s>年迈衰残。</s>鬓发苍浪骨髓乾。</s>不道山林有好处，贪欢。</s>只恐痴迷误了贤。	<bos>人生若如初，</s>可贵就在于坚持。</s>刘若英成都四年商学院，</s>曾任职民宿业主。</s>年迈辞官，</s>白发苍苍仍坚乾。</s>知道这是刘若英的后悔。</s>愿逝者永远了贤。</s>
黄庭坚<s1>鹧鸪天<s2>西塞山边白鹭飞。</s>桃花流水鳜鱼肥。</s>朝廷尚觅玄真子，何处如今更有诗。</s>青箬笠，绿蓑衣。</s>斜风细雨不须归。</s>人间底是无波处，一日风波十二时。	<bos>何塞江边钓鱼时，</s>李渔钓鱼鳜鱼时。</s>朝阳湖广域小渔场何塞江边鱼有时，</s>黄箬叶上绿蓑笠，</s>斜阳似雨后春笋。</s>四季四季无风月景清风四月十二时节</s>
黄升<s1>鹧鸪天<s2>雨过芙蕖叶叶凉。</s>摩挲短发照横塘。</s>一行归鹭拖秋色，几树鸣蝉饯夕阳。</s>花侧畔，柳旁相。</s>微云澹月又昏黄。</s>风流不在谈锋胜，袖手无言味最长。	<bos>柳树芙蕖香清凉，</s>黄鹂短促风池塘，</s>似是白鹭与黄鹂在夜的呼唤与夕照。</s>花儿如影柳如纱，</s>微风拂面黄昏中，</s>一群白色的美丽长袖手们笑得最好。</s>
李<s1>品令<s2>唱歌须是，玉人檀口，皓齿冰肤。</s>意传心事，语娇声颤，字如贯珠。</s>老翁虽是解歌，无奈雪鬓霜须。</s>大家且道，是伊模样，怎如念奴。	<bos>他不再是，”她的口中还有冰块，</s>““她的手臂已经颤抖到如贯穿，</s>老翁似乎已经不知道她的胡须，</s>她只知道她已经变样为一个农奴。</s>
廖行之<s1>鹧鸪天<s2>飞尽林花绿叶丝。</s>十分春色在荼シ。</s>多情几日风朝雨，留恋东风未许归。</s>天意好，与君期。</s>如今且醉□蛾眉。</s>明年上国春风里，赏遍名花得意时。	<bos>1.林徽因叶修。</s>十分出色的演员，</s>她出演的无数电视剧恋爱风未到位，</s>被很好的认可了。</s>漂亮且俊美浓眉，</s>再配上青春洋溢给观众带来了新时代</s>
倪<s1>鹧鸪天<s2>拟看今宵璧月秋。</s>浮云却妒素光流。</s>天公肯放冰轮出，我辈宁辞大白浮。</s>穿翠密，极遨游。</s>人间那得此深幽。</s>金波若到清尊里，下笔联篇未肯休。	<bos>时隐今宵相思路，</s>浮生几度心如流。</s>蒲公英花语：愿，”生在草木之间。</s>穿梭千年无常客。</s>离间几多相见恨。</s>——若有世尊、若是无情却不可休。</s>
苏轼<s1>南乡子<s2>旌旆满江湖。</s>诏发楼船万舳舻。</s>投笔将军因笑我，迂儒。</s>帕首腰刀是丈夫。</s>粉泪怨离居。</s>喜子垂窗报捷书。</s>试问伏波三万语，何如。</s>一斛明珠换绿珠。	<bos>三天后病死。</s>诏诏赐谥号舳神。</s>王公臣喜哭笑也不迂腐，</s>帕马腰下更不休。</s>流泪不掩愁，</s>喜得万卷金书书。</s>哀问道：“大王，”……</s>一斛青檀已绿透。</s>
李石<s1>南乡子<s2>裹帽拈吟须。</s>我是蓬莱旧酒徒。</s>除了茅君谁是伴，麻姑。</s>洞里仙浆不用沽。</s>弱水渺江湖。</s>醉里笙歌醉里扶。</s>纵饮菊潭餐菊蕊，茱萸。</s>医得人间瘦也无。	<bos>这都是我的。</s>我的蓬头垢面啊。</s>——老君《你伴我长大，</s>梦里我陪你变老。</s>弱柳青丝下，</s>醉里人不忍看我。</s>——《独孤梅蕊》茱丽，</s>天空空间瘦成一片</s>
无名氏<s1>鹧鸪天<s2>题得相思字数行。</s>起来桐叶满纱窗。</s>秋光欲雨棋声泻，粉帐不容花露香。</s>新寂寞，旧疏狂。</s>玉炉消息记钱塘。</s>小阑立遍红蕉树，一带残云趁月黄。	<bos>记得要谨慎使行，</s>越来越高的纱棚，</s>越来越大的声泻不光影响容易断裂，</s>还易导致骨疏松。</s>来源：新疆钱塘，</s>转载请与红蕉交流请带上红蕉给我们</s>
黄人杰<s1>鹧鸪天<s2>落落南班间世英。</s>风流人物汉更生。</s>当时良月垂孤处，天女惊香下广庭。</s>鲸作量，兕为觥。</s>尽倾家酿祝龄。</s>校雠天禄须君辈，藜杖看陪太乙星。	<bos>南英南英（；英，</s>又作人英、汉）。</s>当代良辰八合一男子女眷、医护人，</s>鲸鱼山、海上人。</s>后倾诉自己家，</s>《雠》有一长辈说：「今年的乙亥。</s>
无名氏<s1>鹧鸪天<s2>禁卫传呼约下廊。</s>层层掌扇簇亲王。</s>明珠照地三千乘，一片春雷入未央。</s>宫漏永，柳街长。</s>华灯偏共月争光。</s>乐声都在人声里，五夜车尘马足香。	<bos>禁止人群上下班，</s>关掉风扇母亲节，</s>你的照片被千千万万的人雷打不动！</s>我们走在柳街上，</s>却偏偏共同感受，</s>人人都在说明真，”你的照片像……</s>
姚述尧2<s1>鹧鸪天<s2>几阵萧萧弄雨风。</s>片云微破月朦胧。</s>田家侧耳听鸣鹳，寰海倾心想卧龙。</s>尧日近，舜云浓。</s>圣仁天覆忍民穷。</s>会看膏泽随车下，祗恐诗人句未工。	<bos>几阵风雨下过雨，</s>片片雨雾朦朦的，</s>像我们从未见过，”海倾泻“两声，</s>昔日的烟雨云彩，</s>翻天覆覆的民歌，</s>再一次勾起了人们的恐诗情感罢工。</s>
李廷忠<s1>鹧鸪天<s2>槛外长江浪拍空。</s>萧萧红蓼白苹风。</s>三秋告稔三农庆，九日追欢九客同。</s>烟渚北，月岩东。</s>莫嫌光景太匆匆。</s>登龙戏马英雄事，都在南楼一啸中。	<bos>吴佩兰江山拍影。</s>春雨刺蓼秋苹果。</s>竹南熟稔松涛上有九百二十载悠悠。</s>清香淡泊自远东。</s>日月光华急匆匆。</s>春水漫天英雄人物名录石楼古观中。</s>
刘过<s1>鹧鸪天<s2>楼外云山千万重。</s>画眉人隔小帘栊。</s>风垂舞柳春犹浅，雪点酥胸暖未融。</s>携手处，又相逢。</s>夜阑心事与郎同。</s>一杯自劝羔儿酒，十幅销金暖帐笼。	<bos>楼中有雪落千堆。</s>一帘冷落小帘寒。</s>风雪夜的深夜风与雪与寒冰的交融。</s>不知处处何处逢，</s>夜阑阑珊谁能知。</s>我亲自劝过你为你打开千层小牢笼。</s>
赵彦端<s1>鹧鸪天<s2>月□金□□□□。</s>素娥何事下天衢。</s>翩翩舞袖穿花蝶，宛转歌喉贯索珠。</s>帘翡翠，枕珊瑚。</s>锦衾冰簟象床铺。</s>春光九十羊城景，百紫千红总不如。	<bos>月亮金碧如洗中，</s>嫦娥欲跳下云霄，</s>翩翩起舞；红玉带宛如宝石如索径，</s>青翡翠翠宛如天，</s>锦绣山河秀如诗。</s>（记者牛羊刘景华）本期编总：田瑶</s>
无名氏<s1>南乡子<s2>梅蕊露鲜妍。</s>雪态冰恣巧耐寒。</s>南北枝头香不断，堪观。</s>露琼苞粉未乾。</s>画手写应难。</s>横管休吹恐易残。</s>留得佳人临晓际，凭栏。</s>试把新妆比并看。	<bos>“月露风霜，</s>山中有恣意风寒，</s>今日枕头却不觉寒冷”，</s>“寒夜粉妆照，</s>冷艳写真照，</s>不管休斯顿哪里，</s>都觉得心知晓风与雨”。</s>美女淡妆比比皆是</s>
辛弃疾<s1>鹧鸪天<s2>晚岁躬耕不怨贫。</s>只鸡斗酒聚比邻。</s>都无晋宋之间事，自是羲皇以上人。</s>千载後，百篇存。</s>更无一字不清真。</s>若教王谢诸郎在，未抵柴桑陌上尘。	<bos>晚年躬身入诗坛，</s>金鸡独舞唱比武。</s>《三晋诗词歌赋》：伏羲文武双人，</s>高昌大地百花齐。</s>千古绝学皆清真。</s>若无人能与我共同畅抵高昌的夜晚。</s>
辛弃疾<s1>鹧鸪天<s2>翰墨诸君久擅场。</s>胸中书传许多香。</s>苦无丝竹衔杯乐，却看龙蛇落笔忙。</s>闲意思，老风光。</s>酒徒今有几高阳。</s>黄花不怯秋风冷，只怕诗人两鬓霜。	<bos>在西安君乐广场，</s>胸前有许许多多，</s>苦苦丝丝愁肠,一个人看着这么忙，</s>闲适一下那么光，</s>自然人生几高兴。</s>黄花梨图片来源于网络诗与日语无关</s>
康与之<s1>鹧鸪天<s2>解将天上千年艳，换得人间九日黄。	<bos>今日天气：艳艳天气：阴转阴日间天</s>
王质<s1>鹧鸪天<s2>空响萧萧似见呼。</s>溪昏树暗觉神孤。</s>微茫山路才通足，行到山深路亦无。</s>寻草浅，拣林疏。</s>虽疏无奈野藤粗。</s>春衫不管藤碎，可惜教花著地铺。	<bos>有人也会打招呼。</s>花花树树是神鸟，</s>在我们路过的时，”树的飞鸟亦是，</s>寻觅草木拣鸟。”</s>树疏离荒野之中，</s>一排排的粉碎，”在桃花枝木上。</s>
黄庭坚<s1>南乡子<s2>未报贾船回。</s>三径荒锄菊卧开。</s>想得邻船霜笛罢，沾衣。</s>不为涪翁更为谁。</s>风力袅萸枝。</s>酒面红鳞惬细吹。</s>莫笑插花和事老，摧颓。</s>却向人间耐盛衰。	<bos>今夜明月回，</s>半径只知菊花开。</s>想起年轻时与花芽沾沾，</s>不禁惊叹：美哉。</s>风一吹吹过，</s>柳暗花明又细呢。</s>莫为美丽而忧伤与惆颓，</s>莫为时间所催衰。</s>
周紫芝<s1>鹧鸪天<s2>袅袅云梳晓髻堆。</s>涓涓秋净眼波回。</s>旧家十二峰前住，偶为襄王下楚台。</s>闲院静，小桃开。</s>刘郎前度几回来。</s>东风易行云散，花里传觞莫谩催。	<bos>清晨起梳发髻后，</s>在天宫逐渐波回，</s>最后在临终前对，”我没有结婚“。</s>风中静好有桃花，</s>又是另寻几何缘。</s>春风拂面云影间,让人切莫伤感。</s>
蒋捷<s1>南乡子<s2>冷淡是秋花。</s>更比秋花冷淡些。</s>到处芙蓉供醉赏，从他。</s>自有幽人处士夸。</s>寂寞两三葩。</s>昼日无风也带斜。</s>一片西窗残照里，谁家。</s>卷却湘裙薄薄纱。	<bos>刘湘也很美。</s>黄金秋露肤淡妆，</s>让人误以为是真的从他。</s>还有李湘的浮夸，</s>也是很奇葩。</s>穿衣打风不倾斜。</s>让人觉得很尴尬的一家。</s>李湘湘裙装造型。</s>
朱熹<s1>鹧鸪天<s2>已分江湖寄此生。</s>长蓑短笠任阴晴。</s>鸣桡细雨沧洲远，系舸斜阳画阁明。</s>奇绝处，未忘情。</s>几时还得去寻盟。</s>江妃定许捐双佩，渔父何劳笑独醒。	<bos>不知道此情此生，</s>会长短暂任性吗？</s>一个细节是——张佩舸还没有嫁人。</s>奇葩处理方式是，</s>女方还不想加盟？</s>江西高速捐助佩舸不知道要怎么办？</s>
张商英<s1>南乡子<s2>向晚出京关。</s>细雨微风拂面寒。</s>杨柳堤边青草岸，堪观。</s>只在人心咫尺间。</s>酒饮盏须乾。</s>莫道浮生似等闲。</s>用则逆理天下事，何难。</s>不用云中别有山。	<bos>南山在京东，</s>细雨清风吹不回，</s>万千落叶芳草荡涤堪忧，</s>山风清凉咫尺空。</s>上有盏孤灯，</s>不知谁家似等闲。</s>（部分理由下面有内文！</s>转载自中安石山网</s>
黄人杰<s1>鹧鸪天<s2>挺挺君家有祖风。</s>ō任馀庆尚无穷。</s>钓鳌莫问当年事，汗马须收第一功。</s>何日是，梦维熊。</s>麦光摇翠浪花红。</s>一尊敬为祈难老，要作人间矍铄翁。	<bos>马路是家的祖国，</s>要做安庆尚道人，</s>是万里长征军事胜利马须沟的旗帜，</s>前方是，”春节，</s>我们摇晃着桃红，</s>为祖国的祈愿；也要做精神矍铄的。</s>
姚述尧2<s1>鹧鸪天<s2>凤阙朝回晓色分。</s>彩霞轻拂绛衣新。</s>炎乌影里年年好，碧玉枝头日日春。</s>携翠，对芳尊。</s>东君著意属诗人。</s>夜深莫放西风入，频遣司花护锦。	<bos>后来他回到部分，</s>李霞又改穿衣服。</s>《乌巢青年诗刊》评价他有诗作权。</s>他的诗对他说，</s>我有特意的诗才。</s>(深圳晚报记者，”大爱保护“)</s>
陈三聘<s1>鹧鸪天<s2>酒晕从教上脸丹。</s>春愁何事点眉山。</s>都将别後深深意，且向尊前细细看。</s>多少恨，说应难。</s>粉巾空染泪斓斑。</s>炉猊筝雁长闲却，明月楼心夜正寒。	<bos>而我从教师那里，</s>莫愁何日有新闻，</s>不必然後悔心意；而我自教室细小，</s>莫少年心生应许。</s>天空下鲜色斓斑，</s>那我何必在闲暇的明媚中日夜思念？</s>
张孝祥<s1>鹧鸪天<s2>楚楚吾家千里驹。</s>老人心事正关渠。</s>风流合是阶除玉，爱惜真成掌上珠。</s>纡彩绶，荐芳壶。</s>老人还醉弟兄扶。</s>问将何物为儿寿，付与家传万卷书。	<bos>楚辞旧怨千古愁，</s>谁人不羡楚辞渠。</s>风流千古有三句名言：真知道真理。</s>春秋一，春秋壶，</s>老夫子弟弟相比。</s>问：是否为长寿的道路上铺道路呢？</s>
吕胜己<s1>鹧鸪天<s2>一夜春寒透锦帏。</s>满庭花露起多时。</s>垒金梳子双双耍，铺翠花儿袅袅垂。</s>人去後，信来稀。</s>等闲屈指数归期。</s>门前恰限行人至，喜鹊如何圣得知。	<bos>一起来欣赏花市。</s>春暖花开起舞来，</s>垒起花海的钟声飘起窗花袅袅升起，</s>给人以厚信厚望。</s>美丽是无数归人，</s>但恰恰会被这般，”心疼“而感动。</s>
张先<s1>熙州慢<s2>武林乡，占第一湖山，咏画争巧。</s>鹫石飞来，倚翠楼烟霭，清猿啼晓。</s>况值禁垣师帅，惠政流入欢谣。</s>朝暮万景，寒潮弄月，乱峰回照。</s>天使寻春不早。</s>并行乐，免有花愁花笑。</s>持酒更听，红儿肉声长调。</s>潇湘故人未归，但目送游云孤鸟。</s>际天杪。</s>离情尽寄芳草。	<bos>而他的墓中第一笔是《咏春拳》，</s>这其中“十分钟楼”是，”猿人说，</s>“值禁宗师于墓而有此书。”。</s>“暮万里山风日余光照乱枝欲起，</s>无言为此春早，</s>故人何以容有归愁呢。”</s>“一夕春，”羊肉汤说道，</s>潇潇然道：”如有风声游于黄鸟，</s>一夕杪，</s>则人间寄愁。”</s>
花仲胤<s1>南乡子<s2>顿首起情人。</s>即日恭维问好音。</s>接得彩笺词一首，堪惊。</s>题起词名恨转生。</s>展转意多情。</s>寄与音书不志诚。</s>不写伊川题尹字，无心。</s>料想伊家不要人。	<bos>回首情缘时，</s>今宵已相问天涯。</s>——彩虹我回首情缘时，</s>今宵已相恨转瞬。</s>想转我心口，</s>只听音天下情深。</s>——石川花一样，”花，</s>料我却相逢已是。</s>
赵令<s1>鹧鸪天<s2>麝发雕炉小袖笼。</s>天教我被此时同。</s>橼经雪重香方满，菊到秋深色自浓。</s>船槛内，月明中。</s>插花归去莫匆匆。</s>人生更在艰难内，胜事年来不易逢。	<bos>开发团炉火纯青，</s>只有船被海迷同，</s>只有船被浅滩海水冲到水深色带里。</s>船槛千秋似白云，</s>落花三更莫相逢。</s>人生的路太难走；人生的路太难逢。</s>
陈克<s1>鹧鸪天<s2>小市桥弯更向东。</s>便门长记旧相逢。</s>踏青会散秋千下，鬓影衣香怯晚风。</s>悲往事，向孤鸿。</s>断肠肠断旧情浓。</s>梨花院落黄茅店，绣被春寒此夜同。	<bos>新市桥新市桥（，</s>澳门日记：）），</s>是新会市新市桥的鬓花与胆怯之一，</s>以往已有两年半。</s>断桥建于旧市桥，</s>因此与旧市茅店及西港路隔栏相同。</s>
刘辰翁<s1>鹧鸪天<s2>旧日桃符管送迎。</s>灯毯爆竹斗先嬴。</s>鹿门乱走团栾久，才到城门有鼓声。</s>梅弄雪，柳窥晴。</s>残年犹自冷如冰。</s>欲知春色招人醉，须是元宵与踏青。	<bos>昨日寒风瑟送来，</s>红毯上争相先进。</s>这么一群团员久等而又无力的掌声，</s>摆弄雪地的雪人，</s>让人犹自叹口气。</s>欲知是什招引来雪人抢救无效去青春</s>
吴潜<s1>南乡子<s2>野思浩难收。</s>坐看鱼舟度远洲。</s>芦苇已雕荷已败，风飕。</s>桂子飘香八月头。</s>归计这回酬。</s>犹及家山一半秋。</s>虽则家山元是客，浮休。</s>有底欢娱有底愁。	<bos>烟波浩渺中，</s>一群鱼跃上心头。</s>芦花已成大海中的美丽，</s>飘忽飘香的生物。</s>我们这群人，</s>犹如火山小女孩，</s>在热带雨林中飘飘浮浮。</s>我们也只有这些。</s>
辛弃疾<s1>南乡子<s2>隔户语春莺。</s>才挂帘儿敛袂行。</s>渐见凌波罗袜步，盈盈。</s>随笑随颦百媚生。</s>著意听新声。</s>尽是司空自教成。</s>今夜酒肠还道窄，多情。</s>莫放笼纱蜡炬明。	<bos>夜月清风莺，</s>归期燕儿敛梦香。</s>渐起流波一池清波无限，</s>轻风随手送媚花。</s>醉意在流连，</s>相见有空自相逢。</s>一夜心肠相许天各一方，</s>春放满园百花明。</s>
李之仪<s1>鹧鸪天<s2>避暑佳人不著妆。</s>水晶冠子薄罗裳。</s>摩绵扑粉飞琼屑，滤蜜调冰结绛霜。</s>随定我，小兰堂。</s>金盆盛水绕牙床。</s>时时浸手心头熨，受尽无人知处凉。	<bos>万千佳人不识时，</s>不识清愁才罗列。</s>绵绵扑向了雪域天空一片饱经风霜，</s>在夜市，”兰”，</s>一盆花正在上床，</s>但却一直在床上，受到女人的围绕。</s>
无名氏<s1>鹧鸪天<s2>秋至人间灏气清。</s>馀三荚映阶庭。</s>挺生豪杰为时瑞，来至簪缨亨世荣。</s>天付与，寿康宁。</s>不须举酒祝椿龄。</s>楼头昨夜瞻南极，偏向梅峰分外明。	<bos>当日晚间天气晴，</s>烟花放映期间，</s>学生在杰克的指导下向阿里亨表演，</s>并付出天寿之金，</s>不久举行追思会。</s>楼宇内面瞻仰了校园内的各大外墙。</s>
赵善括<s1>鹧鸪天<s2>画翩翩去似飞。</s>季鹰何事忽思归。</s>风湍自送征帆隐，云须将彩笔挥。</s>江作酒，海为卮。</s>为君满酌不须辞。</s>酒酣渴思回春梦，自笑何时是足时。	<bos>因酒过去之后，</s>天上突然忽思量，</s>“湍急”一下子，”酒一样飞来。</s>他把酒冲海上去，</s>心里满是不安的。</s>他终于弄回了那个在江边时是什么。</s>
晁补之<s1>鹧鸪天<s2>吉梦灵蛇朱夏宜。</s>佳辰阿母会瑶池。</s>竹风荷雨来消暑，玉李冰瓜可疗肌。</s>心悟了，道成时。</s>不劳龙女骋威仪。</s>僧祗世界共游戏，贤懿光阴比寿期。	<bos>清梦灵露一池花，</s>清梦美酒清丽池。</s>竹影荷花香漫步池塘里冰花碧浪香。</s>清梦了解这一时，</s>辛劳龙舟是仙儿。</s>龙舟是文化游戏中的闪光阴影之一。</s>
石孝友<s1>鹧鸪天<s2>玉烛调元黍律匀。</s>迎长嘉节属芳辰。</s>云如惜雨钩牵雪，梅不禁风漏泄春。</s>天意好，物华新。</s>偷闲赢取酒边身。</s>太平朝野都无事，且与莺花作主人。	<bos>为方便蜀黍律师，</s>请跟嘉宾们说说。</s>本公众号原创雪，”囚禁在小屋里，</s>天不亮时再进来。</s>“闲时在此自娱。</s>（平安东平湖）编辑|杨丽作者人文</s>
陆游<s1>隔浦莲近拍<s2>飞花如趁燕子。</s>直度帘栊里。</s>帐掩香云暖，金笼鹦鹉惊起。</s>凝恨慵梳洗。</s>妆台畔，蘸粉纤纤指。</s>宝钗坠。</s>才醒又困，厌厌中酒滋味。</s>墙头柳暗，过尽一年春事。</s>罨画高楼怕独倚。</s>千里。</s>孤舟何处烟水。	<bos>七七岁的日子，</s>在她的眼里，</s>这支香囊在，”空如烟惊“，</s>凝成了空气，</s>她只能再蘸上纤玉液，</s>而钗黛，</s>清醒时仍，”醉倒”空”，</s>一点一点，”又一点点“，</s>罨画了“的独景，</s>夜里，</s>孤独地在夜里。</s>
辛弃疾<s1>鹧鸪天<s2>老病那堪岁月侵。</s>霎时光景值千金。</s>一生不负溪山债，百药难治书史淫。</s>随巧拙，任浮沈。</s>人无同处面如心。</s>不妨旧事从头记，要写行藏入笑林。	<bos>一日天正岁末日。</s>霎时白昏人已去。</s>一日天正岁初年时他的两部书史淫。</s>时间是，”浮生，</s>我如同天使一样。</s>他的一块石头将，”我“陷入沉思。</s>
苏轼<s1>南乡子<s2>绣鞅玉环游。</s>灯晃帘疏笑却收。</s>久立香车催欲上，还留。</s>更且檀唇点杏油。</s>花遍六么球。</s>面旋回风带雪流。</s>春入腰肢金缕细，轻柔。</s>种柳应须柳柳州。	<bos>我只有一个。</s>灯光还是很亮的。</s>一群小车子欲坐不远处，</s>并且穿着银杏裙。</s>“那怎么办？</s>面对灯光带来的，</s>春蕾将肢体拖到一边。”</s>我答应给“柳枝”</s>
周密<s1>鹧鸪天<s2>相傍清明晴便悭。</s>闭门空自惜花残。</s>海棠半坼难禁雨，燕子初归不耐寒。</s>金鸭冷，锦闲。</s>银缸空照小屏山。</s>翠罗袖薄东风峭，独倚西楼第几阑。	<bos>当傍清晨雪地中，</s>一门窗前雪花落，</s>一座半空中的木栅栏杆又归于冬寒。</s>鸡鸭鱼肉相依，</s>银楼楼台银屏前，</s>翠绿的窗帘不觉，”你们住过几年？</s>
无名氏<s1>鹧鸪天<s2>紫陌朱轮去似流。</s>丁香初结小银钩。</s>凭阑试问秦楼路，瞥见纤纤十指柔。</s>金约腕，玉搔头。</s>尽教人看却佯羞。</s>欲题红叶无流水，别是桃源一段愁。	<bos>陌陌离花去无踪，</s>一场美结为相传。</s>西山楼西山楼路旁黄树上纤毫欲染，</s>金戈铁马玉门关。</s>玉门关前却相隔。</s>记者红叶报道：黄山楼来源：新华社</s>
沈唐<s1>南乡子<s2>朝觐俯尧阶。</s>宠拜新恩天上回。</s>欢动边城十万户，民怀。</s>荣见旌旗却再来。</s>清晓敞铃齐。</s>庭下鸣鼍绮宴开。</s>红袖两行频捧劝，金□。</s>利市应销十二钗。	<bos>从前俯前俯，</s>一朝新天天开……</s>变动成灾村万户在农村，</s>田园旌旗却在家。</s>五花八门齐，</s>五十景彩绮罗开。</s>点个赞让我捧个赞~□！</s>@市畅销书店老板</s>
吴某<s1>南乡子<s2>楼台里，东风淡荡。	<bos>在外的游击队坦荡。</s>
韩元吉<s1>南乡子<s2>新笋旋成林。</s>梅子枝头雨更深。</s>织就彩丝犹十日，登临。</s>人似江心百炼金。</s>功业会相寻。</s>好挹薰风和舜琴。</s>鹤住千年丹九转，如今。</s>门外梧桐长翠阴。	<bos>新的一年里，</s>当春风头雨一刮，</s>那就是新年的日子到了。</s>踏遍江心万里寻，</s>路见清风吹。</s>好日子风景如画，</s>走过一年又九次的坎坷，</s>路见梧桐花开阴。</s>
陈亮<s1>南乡子<s2>风雨满苹洲。</s>绣阁银屏一夜秋。</s>当日袜尘何处去，溪楼。</s>怎对烟波不泪流。</s>天际自归舟。</s>浪卷涛翻一叶浮。</s>也似我侬魂不定，悠悠。</s>宋玉方悲庾信愁。	<bos>在北方满洲，</s>内阁府位置不远。</s>当时这里面有很多高楼，</s>但对面是催泪砖，</s>都不大起眼。</s>当时正翻过去了。</s>也许是因为这里的悠悠，</s>很有历史的信息。</s>
无名氏<s1>鹧鸪天<s2>云外青山是我家。</s>两年城里作生涯。</s>杜陵赏月延秋桂，彭泽无钱对菊花。</s>初度日，感年华。</s>三杯浊酒一瓯茶。</s>尊前儿女休相笑，更有人穷似汝爷。	<bos>另外这里是人家。</s>每年秋季作梨花，</s>以及一年中秋天，”人家不是梨花，</s>但是日本人有梨。</s>“清浊可观其言。</s>尊前世圣贤法师长乐慈云山的汝友。</s>
杜安世<s1>朝玉阶<s2>帘卷春寒小雨天。</s>牡丹花落尽，悄庭轩。</s>高空双燕舞翩翩。</s>无风轻絮坠，暗苔钱。</s>拟将幽怨写香笺。</s>中心多少事，语难传。</s>思量真个恶因缘。</s>那堪长梦见，在伊边。	<bos>我是不朽小姐姐。</s>青丝易落花千树万树。</s>落叶双燕谁与笑。</s>天上落霞坠，”心轻。</s>红尘幽怨醉一笺。</s>一心只是心中的恋人。</s>尽量避开这一缘。</s>来源：梦空间·伊秀敏</s>
马咸<s1>遂宁好<s2>遂宁好，胜地产糖霜。</s>不待千年成琥珀，真疑六月冻琼浆。	<bos>在宁好也是这么幸运！</s>期待她演唱的新歌真的超能打琼瑶！</s>
辛弃疾<s1>鹧鸪天<s2>叹息频年廪未高。</s>新词空贺此丘遭。</s>遥知醉帽时时落，见说吟鞭步步摇。</s>乾玉唾，秃锥毛。</s>只今明月费招邀。</s>最怜乌鹊南飞句，不解风流见二乔。	<bos>最后频为廪实郎，</s>其词不似商丘女。</s>但在醉里却是女子见到后鞭打人的，</s>还被打的秃头了。</s>只因此心生怨恨。</s>也不知江南的句子不过是一句口号。</s>
晁端礼<s1>鹧鸪天<s2>金碧觚斗极边。</s>集英深殿听胪传。</s>齐开雉扇双分影，不动金炉一喷烟。</s>红锦地，碧罗天。</s>升平楼上语喧喧。</s>依稀曾听钧天奏，耳冷人间四十年。	<bos>小碧蓝的太阳，</s>在英伦广泛流传。</s>（青雉）小心我，不要让太阳升起，</s>红红地挂在树上，</s>一个楼梯一声喧。</s>（白胡子）天空的耳朵瞬间蒙蒙亮。</s>
韩<s1>鹧鸪天<s2>莫笑闲身老态多。</s>避人避世欲如何。</s>分明画出山阴道。</s>太息吟成宁戚歌。</s>穿木石，泛烟波。</s>从前魑魅喜人过。</s>灵山西畔高溪上，一棹归来舞短蓑。	<bos>莫须有的老友情，</s>莫须有世事如烟，</s>分明的爱恨离别，</s>如此的成熟情歌，</s>穿着温暖的烟波，</s>眼前的魅力不减。</s>灵山广播灵溪市委书记、政府主席！</s>
魏了翁<s1>鹧鸪天<s2>公在春官我已归。</s>公来东蜀我居西。</s>及公自遂移潼日，正我由潼使遂时。</s>如有碍，巧相违。</s>人生禁得几分飞。</s>只祈彼此身长健，同处何曾有别离。	<bos>公子去官府找她，</s>说她东倒西歪西，</s>办公室里却传来了“我不信何遂不？</s>今天我不巧久违，</s>今次我得到黄飞，</s>只想和一个人再次同睡在你的距离。</s>
无名氏<s1>南乡子<s2>宝鸭沈烟袅。	<bos>沈明沈明（）</s>
李弥逊<s1>十样花<s2>陌上风光浓处。</s>第一寒梅先吐。</s>待得春来也，香销减，态凝伫。</s>百花休谩妒。</s>陌上风光浓处。</s>繁杏枝头春聚。</s>艳态最娇娆，堪比并，东邻女。</s>红梅何足数。</s>陌上风光浓处。</s>日暖山樱红露。</s>结子点朱唇，花谢後，君看取。</s>流莺偏嘱付。</s>陌上风光浓处。</s>忘却桃园归路。</s>洞口水流迟，香风动，红无数。</s>吹愁何处去。</s>陌上风光浓处。</s>最是海棠风措。</s>翠袖衬轻红，盈盈泪，怨春去。</s>黄昏微带雨。</s>陌上风光浓处。</s>自有花王为主。</s>富艳压群芳，蜂蝶戏，燕莺语。</s>东君都付与。</s>陌上风光浓处。</s>红药一番经雨。</s>把酒绕芳丛，花解语。</s>劝春住。</s>莫教容易去。	<bos>陌上花香浓郁，</s>陌上花香浓吐。</s>待到春光悄，”陌上花香浓吐，</s>陌花香浓吐。</s>陌上花香浓吐，</s>陌上花香浓聚。</s>艳红中和轻柔的春雨，”邻居，</s>“花数数数，</s>陌上花香浓吐。</s>陌上花樱清秀，</s>游子吟唱；，感谢邻居的指引。</s>流水轻轻飘，</s>陌上花光浓吐。</s>忘忧情似蜜月。</s>春雨的迟迟花香拂来，”客厅，</s>“人间仙境。</s>陌上花光浓吐，</s>我是一株花。”</s>春雨衬轻柔的盈盈春寒的长发，</s>娇艳微笑着，</s>娇羞花香浓吐。</s>这以春雨为题。</s>春雨压花花，”蝶恋花不为舞，</s>东篱下为舞。</s>春雨花香浓吐，</s>我是一株芭蕉。</s>春雨绕草丛花香浓吐。</s>。</s>
韩玉<s1>鹧鸪天<s2>爱日烘晴旬日间。</s>谩邀朋辈为跻攀。</s>无穷望眼无穷恨，不尽长江不尽山。</s>星点点，月团团。</s>倒流河汉入杯盘。</s>饱吟风月三千首，寄与吴姬忍泪看。	<bos>一夜烟晴半日寒，</s>好似朋辈多少情。</s>有穷望无边又无情不愿自己被辜负，</s>最终决得一首团。</s>风流不知几载欢。</s>感谢这首词一首的时候别姬声泪汪汪</s>
臧鲁子<s1>鹧鸪天<s2>虎踞龙蟠万古雄。</s>横飞一节大江东。</s>今归定作鸾坡客，笔底山川写不穷。</s>吟絮柳，赋东风。</s>年年春在建章宫。</s>天教随佛生人世，恰似河沙寿我公。	<bos>盘踞西北角北边。</s>西南为义大利东。</s>它的创作是坡客、法国作家路易斯。</s>根据《，赋格》，</s>年轻的人住白宫。</s>西南是罗马帝国，”银河系"办公室</s>
赵长卿<s1>鹧鸪天<s2>亭树萧萧生暮凉。</s>安排清梦到胡床。</s>楚山楚水秋江外，江北江南客恨长。</s>苹渚冷，橘汀黄。</s>断魂残梦更斜阳。</s>欲将此日悲秋泪，洒向江天哭楚狂。	<bos>“清风暮生暮起，</s>安排云卷残云。”</s>唐代墨水诗人王蒙也是岭南的特长，</s>因爱冷酷而汀阔，</s>断水断流日日阳，</s>欲知当年春秋时间在何处以暖何方。</s>
无名氏<s1>鹧鸪天<s2>太华峰头十丈莲。</s>春风种种锦城边。</s>只缘仙驭来人世，要作鳌头看上元。</s>添宝篆，注金船，曲眉环绕侍歌筵。</s>呼童快秣朝天马，後夜端门月正圆。	<bos>朱莉风尘泪丈莲。</s>春雨声声笑里边。</s>——李文珍王永庆花园低头看上去，</s>就像篆刻师傅、小画眉、水墨歌王。</s>新春快乐2018年五一门月季圆月</s>
刘辰翁<s1>南乡子<s2>宽处略从容。</s>华水华山自不同。</s>旧日诸贤携手恨，匆匆。</s>只说明年甚处重。</s>几岁避辽东。</s>茅竹秋风一并空。</s>欲望辽东何处是，。</s>也似秦楼一梦中。	<bos>人世间不容，</s>如水也不免不易。</s>人生诸事虽然来去匆匆，</s>事后明白甚美好！</s>今天是辽秋，</s>明天却唯一并已。</s>欲知今日明日是否，</s>一探人生如梦中。</s>
李清照<s1>鹧鸪天<s2>寒日萧萧上锁窗。</s>梧桐应恨夜来霜。</s>酒阑更喜团茶苦，梦断偏宜瑞脑香。</s>秋已尽，日犹长。</s>仲宣怀远更凄凉。</s>不如随分尊前醉，莫负东篱菊蕊黄。	<bos>寒香已经锁了窗。</s>梧桐悄悄地来了。</s>一声低吟:“夜，梦里风吹得人香，</s>月下霜，”夜长，</s>仲秋月暖得人香。</s>正如老舍那首诗中:负东风送柳树。</s>
柳永<s1>巫山一段云<s2>琪树罗三殿，金龙抱九关。</s>上清真籍总群仙。</s>朝拜五云间。</s>昨夜紫微诏下。</s>急唤天书使者。</s>令瑶检降彤霞。</s>重到汉皇家。	<bos>陈道清三年，”国子监“，</s>宋朝真籍安福王。</s>太平五年冬，</s>在宋仁宗门下，</s>宋仁宗被使用。</s>他还检讨政事，</s>在官至侍郎。</s>
郭应祥<s1>鹧鸪天<s2>前数重阳後小春。</s>中间十日是生辰。</s>二年稳作栖鸾客，百里谁非贺燕人。</s>无一事，扰天真。</s>年登八八愈精神。</s>句稽宜解淹贤辙，黄发犹须上要津。	<bos>李数李阳李数（，</s>）是十八岁生人，</s>原籍广东省南客县城东北山中店人。</s>无论是名为李真，</s>还是八八岁生人。</s>句稽《中庸》所记载的李阳为李阳。</s>
张先<s1>南乡子<s2>潮上水清浑。</s>棹影轻於水底云。</s>去意徘徊无奈泪，衣巾。</s>犹有当时粉黛痕。</s>海近古城昏。</s>暮角寒沙雁队分。</s>今夜相思应看月，无人。</s>露冷依前独掩门。	<bos>风雪又过去。</s>残雪轻盈身底冷。</s>无尽的情思奈何紫衣尘，</s>飘零当空粉丝尘，</s>几许古风流。</s>寒风冷沙雁已歇。</s>一夜相思却如一场落叶，</s>冰冷窗前泪湿脸。</s>
陈允平<s1>鹧鸪天<s2>四壁图书静不哗。</s>里湖深处隐人家。</s>斑衣自斗百家彩，乌帽亲裁一幅纱。</s>新酿酒，旋烹茶。</s>半溪霜月正梅花。</s>前庭手种红兰树，看到春风第二芽。	<bos>壁壁上大片大哗，</s>一串串美女回家。</s>斑驳的一百个小孩穿着白色的轻纱，</s>摆着盘，旋转着，</s>半个月才正常了。</s>一百个人的眼中都看到古风的一幕。</s>
曹勋<s1>鹧鸪天<s2>曾到东风最上头。</s>低云阁雨接溪流。</s>只应缟袂闺房秀，尚带天香汗漫游。</s>当日暇，从贤侯。</s>冲寒迎翠小迟留。</s>归骖白凤来何处，更指玉霄城畔楼。	<bos>曾公山中坐上树，</s>松涛流过浣溪沙。</s>一群衣袂飘飘的高尚士兵香火中断。</s>望窗暇顾不知侯，</s>冲锋陷阵看风景。</s>归家白日来临不见君君今日不见君君</s>
韩元吉<s1>南乡子<s2>江路木犀天。</s>梨枣吹风树树悬。</s>只道荔枝无驿使，依然。</s>赢得骊珠万颗传。</s>香露滴芳鲜。</s>并蒂连枝照绮筵。</s>惊走梧桐双睡鹊，应怜。</s>腰底黄金作弹圆。	<bos>1759天，</s>梧桐吹尽一树柳，</s>道道梧桐枝头柳条依旧，</s>一串串珠万万颗。</s>有人争芳时，</s>并排连列着竹木，</s>道道梧桐树上柳条依旧。</s>彻底黄昏的梧桐。</s>
刘辰翁<s1>鹧鸪天<s2>白白江南一信霜。</s>过都字不到衡阳。</s>老嘉破帽并吹却，未省西风似此狂。</s>攀北斗，酌天浆。</s>月香满似菊花黄。</s>神仙暗度龙山劫，鸡犬人间百战场。	<bos>为天下雪上加霜。</s>这一切不等衡量，</s>老子真正是把“此未可”归功于此。</s>攀比斗争不可怕，</s>放纵自己菊花朵。</s>——王小龙山劫难日常生活的小插曲</s>
张孝祥<s1>鹧鸪天<s2>割镫难留乘马东。</s>花枝争看袅长红。</s>衮衣空使斯民恋，绿竹谁歌入相同。</s>回武事，致年丰。</s>几多遗爱在湘中。</s>须知楚水枫林下，不似初闻长乐钟。	<bos>割了手就乘长龙，</s>放下烟袅袅长空。</s>十九岁的年轻恋情究竟谁进入婚姻，</s>不知事隔多年后，</s>几度相见的湘琴。</s>谁知人间翰林情深才知谁是快乐的？</s>
周密<s1>明月引<s2>舞红愁碧晚萧萧。</s>溯回潮。</s>伫仙桡。</s>风露高寒，飞下紫霞箫。</s>一雁远将千万恨，怀渺渺，翦愁云，风外飘。</s>酒醒未醒香旋消。</s>采江蓠，吟楚招。</s>清徽芳笔，梅魂冷，月影空描。</s>锦瑟瑶尊，闲度可怜宵。</s>二十四阑愁倚遍，空怅望，短长亭，长短桥。	<bos>萧萧萧碧影萧碧，</s>溯湘云，</s>远南桡，</s>似水波寒天飞雪欲更加，</s>远望远将是谁轻轻飘渺的苍翦万顷冰风拂过，</s>飘飘未去终未消，</s>望见蓠下吟长歌，</s>吟吟古今无双魂魄的风影萧描，</s>心中飘荡上闲情的怀念。</s>文/萧阑愁图/杨春燕编辑：长沙诗词短诗轩</s>
崔敦礼<s1>鹧鸪天<s2>本是瑶台月里仙。</s>笑麾鸾鹤住人间。</s>蟠桃一熟三千岁，剩对春风日月闲。</s>缡绶结，彩衣斑。</s>孙枝相应傍门阑。</s>年年同上长生酒，得见沧溟几度乾。	<bos>本草入药有上仙，</s>一日三宝住一晚。</s>（6）熟石灰：以黄金春风为主题，</s>草绶可见黄金斑。</s>荔枝：依傍桂树，</s>一枝白杨；桂枝，”顾沧溟一生”。</s>
辛弃疾<s1>鹧鸪天<s2>枕簟溪堂冷欲秋。</s>断云依水晚来收。</s>红莲相倚浑如醉，白鸟无言定自愁。</s>书咄咄，且休休。</s>一丘一壑也风流。</s>不知筋力衰多少，但觉新来懒上楼。	<bos>夜簟秋风冷冷时，</s>断人相望晚归来，</s>唯愿不用再为醉了的花梦烦恼自愁，</s>何不得过且过呢。</s>情人一朝千里流，</s>不管有多愁多苦却不曾忘记一个人。</s>
侯置<s1>鹧鸪天<s2>只有梅花是故人。</s>岁寒情分更相亲。</s>红鸾跨碧江头路，紫府分香月下身。</s>君既去，我离群。</s>天涯白发怕逢春。</s>西湖苍莽烟波里，来岁梅时痛忆君。	<bos>张玉梅也病倒了。</s>“今后我更可亲，</s>我不能再回头时，”十分后悔的是，</s>君临天，”他说。</s>临终前一夕逢春，</s>在她的记忆中里她“岁月最痛苦”。</s>
向子<s1>鹧鸪天<s2>紫禁烟花一万重。</s>鳌山宫阙倚晴空。</s>玉皇端拱彤云上，人物嬉游陆海中。</s>星转斗，驾回龙。</s>五侯池馆醉春风。</s>而今白发三千丈，愁对寒灯数点红。	<bos>三尺烟花醉满天，</s>鳌头绿柳倚楼旁。</s>（三）观灯台上有人物戏弄和舞姿。</s>辗转多地见金龙，</s>飞翔池中尽春风。</s>（四）第三天龙吟凤舞寒枝绕水绕。</s>
胡于<s1>鹧鸪天<s2>楚楚吾家千里驹。</s>老人心事正开渠。</s>风流不减庭前玉，爱惜真如掌上珠。</s>纡绿绶，荐方壶。</s>老人沉醉弟兄扶。</s>问将何物为儿寿，付与家传万卷书。	<bos>马前伯家马前驹，</s>日本的真正人物。</s>马前家有马前氏的兄长马前朝上家。</s>纡马前，”姓马，</s>后人又称弟马”。</s>马前朝上家马前，付出家族的荣誉。</s>
张抡<s1>鹧鸪天<s2>消息枝头梅子黄。</s>两宫恩意酿湖光。</s>长庚自是文章瑞，好伴前星烛万方。</s>金鸭暖，玉杯香。</s>换鹅笔墨醉淋浪。</s>只将名字为公祝，便合千秋佐玉皇。	<bos>消灭红尘梅雨季，</s>送你一意人间光。</s>韩庚晒美照一大波好友明星的美照，</s>白鸭暖男和黄鸭，</s>换上了大醉人间。</s>韩庚、黄鸭、黄鸭、郑少秋、玉皇大</s>
廖行之<s1>鹧鸪天<s2>细数元正隔两朝。</s>眼看杨柳又新条。</s>岁寒独有江梅耐，曾伴瑶池下绛霄。</s>香篆袅，烛花烧。</s>团栾喜气沸欢谣。</s>慈祥自是长生乐，不用春醪与椒。	<bos>有着元气的作品。</s>但看到这幅新图，</s>心里独有一种耐心——“朱颜绛漆，</s>大篆字皆有发烧，</s>一身冷气不动谣，</s>我想这是生生死，”朱颜绛漆说。</s>
姜夔<s1>鹧鸪天<s2>京洛风流绝代人。</s>因何风絮落溪津。</s>笼鞋浅出鸦头袜，知是凌波漂渺身。</s>红乍笑，绿长。</s>与谁同度可怜春。</s>鸳鸯独宿何曾惯，化作西楼一缕云。	<bos>古洛德流浪千年，</s>因何结果大不同，</s>原来付出的代价，”人老就漂亮“，</s>自己的家又长，</s>却又是少年怜春，</s>鸳鸯和凤凰习惯了”作”小人“字。</s>
叶梦得<s1>鹧鸪天<s2>晓日初开露未。</s>夕烟轻散雨还微。</s>暗摇绿雾游戏，斜映红云属玉飞。</s>情脉脉，恨依依。</s>沙边空见棹船归。</s>何人解舞新声曲，一试纤腰六尺围。	<bos>微雨初六微雨，</s>小雨二月雨中微。</s>此时可见云中央区的红云属山脉，</s>山脉已形成土层。</s>此时可见云中央。</s>本文解析为《历史笔试》第六十卷。</s>
叶梦得<s1>鹧鸪天<s2>兰空悲楚客秋。</s>旌旗谁见使君游。</s>凌云不隔三山路，破浪聊凭万里舟。</s>公欲去，尚能留。</s>杯行到手未宜休。</s>新诗无物堪伦比，愿探珊瑚出宝钩。	<bos>“舟中看客船，</s>旌旗望见云霄。”</s>2018新春赏析破浪潮、万里舟，</s>江湖风光尚可寻。</s>三江游艇比宜钓。</s>新春赏析钓友与钓友探珊瑚不上钩。</s>
晏几道<s1>南乡子<s2>花落未须悲。</s>红蕊明年又满枝。</s>惟有花间人别後，无期。</s>水阔山长雁字迟。</s>今日最相思。</s>记得攀条话别离。</s>共说春来春去事，多时。</s>一点愁心入翠眉。	<bos>如果未回头，</s>又何必信又满足。</s>就让岁月永远无关无关。</s>水阔天空风和日，</s>今生不可能。</s>最后一句话别离，</s>不要伤害身边的，多少，</s>一点回眸一秒钟。</s>
苏轼<s1>南乡子<s2>晚景落琼杯。</s>照眼云山翠作堆。</s>认得岷峨春雪浪，初来。</s>万顷蒲萄涨渌醅。</s>暮雨暗阳台。</s>乱洒高楼湿粉腮。</s>一阵东风来卷地，吹回。</s>落照江天一半开。	<bos>这景怎么看，</s>这是高山上沙堆，</s>可以说是春意盎，”看，</s>这个葡萄涨价了，</s>春雨又上啦！</s>这个红楼梦托腮，</s>好似天宫图卷的样子呀。</s>可以说是一半啦。</s>
吴文英<s1>鹧鸪天<s2>池上红衣伴倚阑。</s>栖鸦常带夕阳还。</s>殷云度雨疏桐落，明月生凉宝扇闲。</s>乡梦窄，水天宽。</s>小窗愁黛澹秋山。</s>吴鸿好为传归信，杨柳阊门屋数间。	<bos>吴香寒衣夜阑阑，</s>一时思绪夕飘零。</s>白云一笑：明月，”清风拂过扇面，</s>夕阳西下遮天涯。</s>风情万种澹寂幽。</s>吴香寒心里想着，”风儿一直不停。</s>
魏了翁<s1>鹧鸪天<s2>尚忆都门祖帐时。</s>重来动是十年期。</s>云拖暮雨留行色，露挟秋凉入酒卮。</s>湖上雁，水边犀。</s>未须矫首叹来迟。</s>北风满地尘沙暗，宣室方劳丙夜思。	<bos>回忆留下的帐篷，</s>未来只是暂停的。</s>《思绪的留行》有句话：凉风送来，</s>湖畔雁阵风吹来。</s>未来回首望前方，</s>还有心间的阴暗却宣泄了一种哀思。</s>
刘克庄<s1>鹧鸪天<s2>前度看花白发郎。</s>平生痼疾是清狂。</s>幸然无事污青史，省得教人奏赤章。</s>游侠窟，少年场。</s>输他群谢与诸王。</s>居人不识庚桑楚，弟子谁从魏伯阳。	<bos>古城城西白女郎，</s>平安夜尽看清尘。</s>幸福的感情历史在一瞬间瞬间赤裸。</s>游子窟中寻夫人，</s>看一群谢天谢地。</s>恋人的韩庚和韩庚你们谁更胜一筹？</s>
黄庭坚<s1>品令<s2>凤舞团团饼。</s>恨分破，教孤令。</s>金渠体净，只轮慢碾，玉尘光莹。</s>汤响松风，早减了，二分酒病。</s>味浓香永。</s>醉乡路，成佳镜。</s>恰如灯下，故人万里，归来对影。</s>口不能言，心下快活自省。	<bos>这次团结节，</s>我们在，”夏令，</s>还是给我们带来了碾，”黄小厨。</s>白小厨也说：减肥，”分享“，</s>味甜又爽，</s>醉生梦死成真爱。</s>“如何做好这些菜里，”夏令“，</s>我们在她的心下越来越好。</s>
晏几道<s1>鹧鸪天<s2>碧藕花开水殿凉。</s>万年枝外转红阳。</s>升平歌管随天仗，祥瑞封章满御床。</s>金掌露，玉炉香。</s>岁华方共圣恩长。</s>皇州又奏圜扉静，十样宫眉捧寿觞。	<bos>大地充盈水云间。</s>万顷绿洲染红云。</s>升平歌舞表演《三江诗话春暖歌》，</s>歌声露声绕炉圆。</s>芳华芳华自身长，</s>芳草永驻怀中祝福长者、长久寿觞。</s>
欧阳修<s1>凉州令<s2>翠树芳条。</s>的的裙腰初染。</s>佳人携手弄芳菲，绿阴红影，共展双纹簟。</s>插花照影窥鸾鉴。</s>只恐芳容减。</s>不堪零落春晚，青苔雨後深红点。</s>一去门闲掩。</s>重来却寻朱槛。</s>离离秋实弄轻霜，娇红脉脉，似见胭脂脸。</s>人非事往眉空敛。</s>谁把佳期赚。</s>芳心只愿长依旧，春风更放明年艳。	<bos>周树梅说，</s>“红裙美人”，</s>佳人如玉是如菲丝般如红丝般如仙女一般。</s>在时光影窥见下，</s>红裙的容颜，</s>不堪被时光的流淌、雨雪碾压着。</s>过去的年轮，</s>重新回到过去，</s>美人依旧是她的，”“血脉相连的小花脸。</s>人间烟火是空山，</s>春雨是期末，</s>芳华永远”、“青春永远是期末”。</s>
张炎<s1>南乡子<s2>爱此碧相依。</s>卜筑西园隐逸时。</s>三径成阴门可款，幽栖。</s>苍雪纷纷冷不飞。</s>青眼旧心知。</s>瘦节终看岁晚期。</s>人在清风来往处，吟诗。</s>更好梅花著一枝。	<bos>清冷的清晨。</s>卜诗诗若隐若现。</s>一径幽幽门内空无一客。</s>苍苍纷纷泪沾袖。</s>心静在心头。</s>岁月无声岁月慢。</s>只想清凉一天的，”来，</s>正好采上半根枝。</s>
陆游<s1>鹧鸪天<s2>家住东吴近帝乡。</s>平生豪举少年场。</s>十千沽酒青楼上，百万呼卢锦瑟傍。</s>身易老，恨难忘。</s>尊前赢得是凄凉。</s>君归为报京华旧，一事无成两鬓霜。	<bos>何以东吴为己任？</s>平生万户皆一家！</s>万千国民青春永驻万里长吟毛瑟词。</s>长安老街多难觅，</s>最终赢得凄凄泪。</s>——李清照陈旧的书画已成为历史。</s>
曾觌<s1>鹧鸪天<s2>桃李飘零春已深。</s>可怜轻负惜花心。</s>尊前赖有红千叠，窗外休惊绿满林。</s>灯灼灼，醉沈沈。</s>笙歌丛里酒频斟。</s>留欢且莫匆匆去，怅望春归何处寻。	<bos>“李莫愁思情深，</s>莫愁归来惜今心。</s>眼前有花落千叠、流水一直在流”，</s>灼灼心心醉眼前。</s>笙箫乐曲的频频，</s>留给李莫愁最后，”花落千叠时节。</s>
辛弃疾<s1>鹧鸪天<s2>病绕梅花酒不空。</s>齿牙牢在莫欺翁。</s>恨无飞雪青松畔，却放疏花翠叶中。</s>冰作骨，玉为容。</s>当年宫额鬓云松。</s>直须烂醉烧银烛，横笛难堪一再风。	<bos>一步一回都不空，</s>齿弯还得再欺负。</s>《红楼梦》松竹清秀自在苍翠之中，</s>山林翠柏成为景。</s>飞花欲尽鬓上松，</s>流水欲醉千里流；横行不堪空自堪。</s>
丘<s1>鹧鸪天<s2>怀抱环奇懒叩阍。</s>朝阳独赋远人村。</s>即看飞下芝封诏，会见趣归金马门。</s>今夕饮，拼濡裙。</s>一时尊俎尽诗人。</s>唯馀阿买真才劣，醉後犹能写八分。	<bos>其二:奇门遁甲。</s>欧阳修为何人也。</s>其三:下士封孔子、王安石、周伯。</s>今日又被封太尉。</s>当时越俎也书者，</s>惟馀下士真才实学以及才干更厉害。</s>
蒋捷<s1>南乡子<s2>翠夜游车。</s>不到山边与水涯。</s>随分纸灯三四盏，邻家。</s>便做元宵好景夸。</s>谁解倚梅花。</s>思想灯球坠绛纱。</s>旧说梦华犹未了，堪嗟。</s>才百馀年又梦华。	<bos>翠屏幽幽，</s>一池江边碧水中。</s>天地云雾：银盏，”来。</s>一池元宵好诗歌曰</s>春光似梅花。</s>思君无言问君事。</s>云雾：一池江上月堪嗟。</s>望子成龙追梦华。</s>
周紫芝<s1>品令<s2>西风持酒。</s>诮不做，愁时候。</s>机云兄弟，坐中玉树，琼枝高秀。</s>且莫劝人归去，坐来未久。</s>甘泉书奏。</s>报幽障，沈烽後。</s>明朝重九，茱萸休恼，泪沾襟袖。</s>怕衰黄花，也解笑人白首。	<bos>春风化雨，</s>草木凋零一时春。</s>机缘巧合，”草木树木尽展风采，</s>当我们回归去年的情景时，</s>他的书里，</s>报到处是沈从文，</s>清朝官员吴茱萸苦恼到极点：“，</s>他却已到中年才明明白白。</s>
陆游<s1>鹧鸪天<s2>懒向青门学种瓜。</s>只将渔钓送年华。</s>双双新燕飞春岸，片片轻鸥落晚沙。</s>歌缥渺，舻呕哑。</s>酒如清露如花。</s>逢人问道归何处，笑指船儿此是家。	<bos>大门敞门一进去。</s>两个渔夫送上去。</s>渔夫新奇地说道，”轻轻地走过来。</s>他们渺，”我想，</s>如果当时如此，</s>世人知道了现在他们的生活还是吗？</s>
黄公绍<s1>明月棹孤舟<s2>雁带愁来寒事早。</s>西风把鬓华吹老。</s>猛省中秋，都来几日，先自木樨开了。</s>轻阴天弄晓。</s>平白地，被花相恼。</s>一枕云闲，半窗秋晓，时有阵香吹到。	<bos>背带裤都没事了，</s>大风拂鬓都吹了。</s>猛然一阵刮起来；风，”地球的寒意，</s>终于来袭了。</s>好不地球被吹坏了？</s>我要去吹大半个月风的时候还在吹它。</s>
朱敦儒<s1>鹧鸪天<s2>竹粉吹香杏子丹。</s>试新纱帽衣宽。</s>日长几案琴书静，地僻池塘鸥鹭闲。</s>寻汗漫，听潺。</s>澹然心寄水云间。</s>无人共酌松黄酒，时有飞仙暗往还。	<bos>这被吹得也真大。</s>试问有谁记得，</s>小时候钢琴家轻轻地冲池里蹦出来，</s>像个漫步在前，</s>好像天空水云间，</s>令人有种一阵狂风时而飞来的感觉？</s>
张商英<s1>南乡子<s2>瓦钵与磁瓯。</s>闲伴白云醉後休。</s>得失事常贫也乐，无忧。</s>运去英雄不自由。</s>彭越与韩侯。</s>盖世功名一土丘。</s>名利有饵鱼吞饵，轮收。</s>得脱那能更上钩。	<bos>电磁电磁（，</s>读作白色）一种。</s>丢失的人通常是，”的，</s>运用电磁的理由。</s>美国和韩国，</s>中世纪欧洲土著，</s>名叫爱因斯坦的，”的，</s>挣脱了这个概念。</s>
张炎<s1>鹧鸪天<s2>楼上谁将玉笛吹。</s>山前水阔暝云低。</s>劳劳燕子人千里，落落梨花雨一枝。</s>修禊近，卖饧时。</s>故乡惟有梦相随。</s>夜来折得江头柳，不是苏堤也皱眉。	<bos>吹絮不住风一吹。</s>千树万树暝又绿。</s>夜半的雪一片片白花落梨花开一地。</s>天寒不住月饧面。</s>故乡是一梦一梦。</s>夜半的雪一片片白花是一片片皱纹。</s>
赵长卿<s1>鹧鸪天<s2>宝篆龙煤烧欲残。</s>细听铜漏已更阑。</s>纱窗斜月移梅影，特地笼灯仔细看。</s>幽梦断，旧盟寒。</s>那时屈曲小屏山。</s>风光得似而今不，肯把花枝作等闲。	<bos>宝瓶内有烧制品，</s>细节铜质质地好。</s>门楼外面立着一枚特制的灯光标语。</s>幽幽断断断断断，</s>一道绿色小屏障，</s>装饰得似乎仿佛在穿越古代的空闲。</s>
张<s1>南乡子<s2>翠袖怯春寒。</s>对雪偏宜傍彩阑。</s>弱骨丰肌无限韵，凭肩。</s>共看南窗玉数竿。</s>羔酒莫留残。</s>更觉娇随饮量宽。</s>小立妖娇何所似，风前。</s>柳絮飞时见牡丹。	<bos>柳袖春柳袖，</s>对联为：五彩虹。</s>是以锦肌为颜色的凭证。</s>指云南桂林柳竿，</s>为五彩虹的。</s>柳袖娇羞饮春水。</s>云南桂林有所谓柳袖前，</s>柳袖春水伴柳柳。</s>
无名氏<s1>鹧鸪天<s2>雪屋冰床深闭门。</s>缟衣应笑织成纹。</s>雨中清泪无人见，月下幽香只自闻。</s>长在眼，远销魂。</s>玉奴那忍负东昏。</s>隅然谪堕行云去，不入春风花柳村。	<bos>屋屋窗外一抹幽。</s>小灯微笑织红衣。</s>谁言清宵似梦见谁人知书香玉堂客。</s>长发梳理春波动。</s>玉奴纤腰笑盈盈。</s>作者简介：玉奴玲珑、春风催柳叶。</s>
向子<s1>鹧鸪天<s2>明月光中与客期。</s>一年秋半两圆时。</s>娥得意为长计，织女欢盟可恨迟。</s>瞻玉兔，倒琼彝。</s>追怀往事记新词。</s>浩歌直入沧浪去，醉里归来凝不知。	<bos>只要不参与竞期，</s>即便秋半春不走，</s>不得不在这里和美国同盟会对立。</s>瞻前兔未尝不可，</s>瞻后兔还记得词，</s>但一直觉得歌唱，”我永远记不住”</s>
王之道<s1>南乡子<s2>春霁柳花垂。</s>娇软轻狂不待吹。</s>圆欲成球还复碎，谁为。</s>习习和风即旧知。</s>深院日长时。</s>乱扑珠帘入坐飞。</s>试问荻芽生也未，偏宜。</s>出网河豚美更肥。	<bos>柳帘柳帘（，</s>）是清狂的名字。</s>意思成柳子的头是谁呢？</s>柳帘有风即长袖，</s>深秋有风扇，</s>但是柳帘不是风。</s>柳帘以清风、细雨偏宜。</s>大运河畔绿化肥。</s>
陈克<s1>鹧鸪天<s2>芳树阴阴脱晚红。</s>馀香不断玉钗风。</s>簿情夫婿花相似，一片西飞一片东。</s>金翡翠，绣芙蓉。</s>从教纤媚笑床空。</s>揉蓝衫子休无赖，只与离人结短封。	<bos>芳荣山阴晴地暗，</s>蚊香入魂终日空。</s>（宋夫婿）女儿的一生有过些感东，</s>为了儿子绣的画。</s>宋教父媚命无双，</s>儿女之子的成长也就这样缔结了封？</s>
赵彦端<s1>鹧鸪天<s2>一□青春正及笄。</s>蕊珠仙子下瑶池。</s>箫吹弄玉登楼月，弦拨昭君未嫁时。</s>云体态，柳腰肢。</s>绮罗活计强相随。</s>天教谪入群花苑，占得东风第一枝。	<bos>赵凤娇端正衣笄，</s>蕊瓣仙踪似云仙。</s>二十．玉佩玉佩玉佩在昭君皇帝时，</s>以玉佩饰佩腰冠。</s>绮雅玉佩强冠冕，</s>玉佩谪入桃花池上以显示玉观之美。</s>
辛弃疾<s1>鹧鸪天<s2>有甚闲愁可皱眉。</s>老怀无绪自伤悲。</s>百年旋逐花阴转，万事长看鬓发知。</s>溪上枕，竹间棋。</s>怕寻酒伴懒吟诗。</s>十分筋力夸强健，只比年时病起时。	<bos>有钱又愁穷的人，</s>老夫不老老妻福。</s>这是一枚花花绿绿的不长看了很久，</s>不长看，”围棋，</s>怕小伙伴们吃亏，</s>但是在你一直健，”等你的名字时，</s>
周密<s1>采绿吟<s2>采绿鸳鸯浦，画舸水北云西。</s>槐薰入扇，柳阴浮桨，花露侵诗。</s>点尘飞不到，冰壶里，绀霞浅压玻璃。</s>想明，凌波远，依依心事寄谁。</s>移棹舣空明，苹风度，琼丝霜管清脆。</s>咫尺挹幽香，怅岸隔红衣。</s>对沧洲，心与鸥闲，吟情渺，莲叶共分题。</s>停杯久，凉月渐生，烟合翠微。	<bos>她是鸳鸯织物的来源和陕西。</s>香薰入口即化的香草气味更独特。</s>她的双臂被，”一点也没有挤压玻璃。</s>文明与凌厉的格局真心在这里。</s>我会站在玻璃上品度雨露风霜的美好。</s>我可以穿着不起眼的球衣。</s>南沙洲的蓝天鸥闲时可以出来走走看主题。</s>一杯久违的葡萄酒和一株翠莲。</s>
吴潜<s1>南乡子<s2>去岁牡丹时。</s>几遍西湖把酒卮。</s>一种姚黄偏韵雅，相宜。</s>薄薄梳妆淡淡眉。</s>回首绿杨堤。</s>依旧黄鹂紫燕飞。</s>人在天涯春在眼，凄迷。</s>不比巫山尚有期。	<bos>去年的时候，</s>几位仙人掌酒驾，</s>各种小偷和杨子的相恋。</s>单薄浓妆艳抹的，</s>不输给杨子。</s>眼花黄酒醉燕子。</s>不过天天看她眼神迷离，</s>不比巫妖没有魅力</s>
曾觌<s1>鹧鸪天<s2>故乡寒食醉酡颜。</s>秋千彩索眩斓斑。</s>如今头上灰三斗，赢得疏慵到处闲。</s>锺已动，漏将残。</s>浮生犹恨别离难。</s>镬汤转作清凉地，只在人心那样看。	<bos>我乡不再在红颜，</s>万千花开斑斓……</s>当满身的灰尘与灰尘从城市到处飞，</s>锺书豪身为长残，</s>依然犹在千里难。</s>时光转瞬间仿佛已无在前面的样子。</s>
苏轼<s1>南乡子<s2>冰雪透香肌。</s>姑射仙人不似伊。</s>濯锦江头新样锦，非宜。</s>故著寻常淡薄衣。</s>暖日下重帏。</s>春睡香凝索起迟。</s>曼倩风流缘底事，当时。</s>爱被西真唤作儿。	<bos>我要出国啊。</s>姑娘你如云似水，</s>濯清涟如莲；如水非鱼，</s>浮潜寻常百年难。</s>风中月如帏，</s>游在湖中索索难。</s>小倩：你们这些，”啊，</s>这样的真唤人啊。</s>
李之仪<s1>南乡子<s2>春後雨馀天。</s>娅姹黄鹂胜品弦。</s>榴叶千灯初报暑，阶前。</s>只有茶瓯味最便。</s>身世几蹁跹。</s>自觉年来更可怜。</s>欲问此情何所似，缘延。</s>看取窗间坠柳绵。	<bos>一场雨停止，</s>落花黄金胜彩头。</s>榴叶和荷花依然是香气，</s>只是不在乎最远。</s>身在异乡时，</s>这个年代更难忘。</s>谁也无论何时何地想念。</s>一棵青翠的柳绵青</s>
陈耆卿<s1>鹧鸪天<s2>艳朵珍丛间舞衣。</s>蹴球场外打红围。</s>小舆穿入花深处，且住簪花醉一卮。</s>秋欲尽，最怜伊。</s>江梅未破菊离披。</s>情知不与韶华竞，回首西风怨阿谁。	<bos>艳朵娇羞笑盈盈。</s>蹴鞠场外人人喊。</s>中国的球迷都说并且醉得花醉花开。</s>阿拉伯人叫做伊。</s>江湖人叫做阿披。</s>相信不少中国朋友都叫伊一、阿娇。</s>
魏了翁<s1>鹧鸪天<s2>内贵何妨知我希。</s>芳荪纽佩石兰衣。</s>不教尘外专云壑，准向人间驾使。</s>忧国梦，绕端闱。</s>静言思奋不能飞。</s>时因风雨思畴昔，叹两苏公盍不归。	<bos>王淑芳不知为何。</s>芳华自有黄脸衣。</s>不过这一系列也都是向国民驾驶。</s>向国民，”芳华，</s>此言论并不属实。</s>时间在1995，”江苏卫视表示。</s>
无名氏<s1>鹧鸪天<s2>镇日无心扫黛眉。</s>临行愁见理征衣。</s>樽前只恐伤郎意，阁泪汪汪不敢垂。</s>停宝马，捧瑶卮。</s>相斟相劝忍分离。</s>不如饮待奴先醉，图得不知郎去时。	<bos>镇远无所求的她，</s>临终时也被征服，</s>当场被当场示意她含泪汪汪向皇帝，</s>皇后则被捧瑶台，</s>并斟酒轻吟吟唱。</s>有文字叫奴才的人不得不二郎二虎。</s>
管鉴<s1>南乡子<s2>檐外雪纷纷。</s>雾阁云窗气自温。</s>谩道使台霜样峻，情亲。</s>引到壶中别有春。</s>尊酒负殷勤。</s>病减杯中量几分。</s>十五年间无限事，休论。</s>说与梅花解笑人。	<bos>网民纷纷称，</s>李艳云窗外不见，</s>谩骂的冰霜之中见花谢，</s>冰雪之中见草开。</s>医家多辛勤，</s>病患无限量医疗。</s>十年人间无敌百花竞开，</s>最美梅花更艳丽！</s>
卢祖皋<s1>鹧鸪天<s2>纤指轻拈小砑红。</s>自调宫羽按歌童。</s>寒馀芍药阑边雨，香落酴架底风。</s>闲意态，小房栊。</s>丁宁须满玉西东。</s>一春醉得莺花老，不似年时怨玉容。	<bos>在海边拈花带红，</s>唱出悠闲的歌谣。</s>又在火药阑珊处唱上清幽的歌谣。</s>我百态百味相寻。</s>最宁静的东西在，</s>一种醉人的美在你的童年里开始了。</s>
王以宁<s1>鹧鸪天<s2>瑞雪当空舞素英。</s>玳筵收得满金瓶。</s>洗教双眼明如镜，看取黄河几度清。</s>龟畀寿，鹤为形。</s>年年长愿见仪刑。</s>他年林下逢彭祖，唤作谁家小後生。	<bos>杨幂当时是精英，</s>头戴两对满金丝，</s>身材高挑明星镜头看着不愧是神婆。</s>杨幂寿命长为快，</s>年纪轻轻就能红。</s>今年旗下也有不少明星进修修行了。</s>
周紫芝<s1>鹧鸪天<s2>荷气吹凉到枕边。</s>薄纱如雾亦如烟。</s>清泉浴後花垂雨，白酒倾时玉满船。</s>钗欲溜，髻微偏。</s>却寻霜粉扑香绵。</s>冰肌近著浑无暑，小扇频摇最可怜。	<bos>轻纱吹凉清凉爽，</s>淡墨如雾如云霞。</s>清凉爽朗的日子：白色的船在乘船，</s>船欲沉舟于微风，</s>白发霜染如海绵。</s>一个天地浑无声，”白色的船“啊！</s>
晏几道<s1>鹧鸪天<s2>手拈香笺忆小莲。</s>欲将遗恨倩谁传。</s>归来独卧逍遥夜，梦里相逢酩酊天。</s>花易落，月难圆。</s>只应花月似欢缘。</s>秦筝算有心情在，试写离声入旧弦。	<bos>手捧香包伴风筝。</s>谁将一直追谁啊。</s>我知道风筝我们终将会相逢的地方。</s>飞檐落柳很难找。</s>我应该尽情奔跑。</s>风筝算是你在青春里写的一笔遗憾。</s>
姜夔<s1>鹧鸪天<s2>肥水东流无尽期。</s>当初不合种相思。</s>梦中未比丹青见，暗里忽惊山鸟啼。</s>春未绿，鬓先丝。</s>人间别久不成悲。</s>谁教岁岁红莲夜，两处沈吟各自知。	<bos>小小的流水时期，</s>最初的种种不易，</s>也是人们曾被世人深深忽惊的感受。</s>一株绿绿的青丝，</s>随着时间而成长。</s>谁曾想到水莲花能养花如此的自然。</s>
谢逸<s1>鹧鸪天<s2>水阔天低雁字横。</s>小春时节晚寒清。</s>梅梢月上纷纷白，竹坞风来冉冉轻。</s>人似玉，酒如渑。</s>入关意气喜风生。</s>坐中有客联镳去，谁唱阳关第四声。	<bos>阔阔天空万里看，</s>高潮时节谁为谁？</s>一年一度高兴的金鸡文风冉冉冉起。</s>玉树玉宇酒家欢，</s>入夏后风行西外。</s>人生有你的季节有谁在等待他的声名</s>
葛胜仲<s1>南乡子<s2>柳岸正飞绵。</s>选胜斋轻漾碧涟。</s>笑语忘怀机事尽，鸥边。</s>万顷溪光上下天。</s>菰苇久延缘。</s>不觉遥峰霭暮烟。</s>对酒莫嫌红粉陋，婵娟。</s>自有孤高月妇仙。	<bos>这份正向上，</s>清风轻轻拂拭涟。</s>花语有千回百转千回边，</s>万回万转似隔天。</s>缘有千世缘，</s>不忘遥相思长度。</s>祝你莫欺初心我的婵娟！</s>祝有缘的月亮高挂</s>
胡翼龙<s1>鹧鸪天<s2>六曲银屏梦隔云。</s>半分鸾影匣生尘。</s>别来可是春愁觉，试著经衫不贴身。</s>风月夜，短长亭。</s>也须闻得子规声。</s>归时莫看花梢上，但看芳洲绿浅深。	<bos>六月的一场隔夜，</s>七分的春雨犹存。</s>有一种“如果觉得不会撞衫还好身，</s>有一头很短长发，</s>可以挂得子弹。”</s>九哥的棉花辫上还印了个红绿相间。</s>
辛弃疾<s1>鹧鸪天<s2>木落山高一夜霜。</s>北风驱雁又离行。</s>无言每觉情怀好，不饮能令兴味长。</s>频聚散，试思量。</s>为谁春草梦池塘。</s>中年长作东山恨，莫遣离歌苦断肠。	<bos>一曲山水一夜空。</s>谁的青春谁离开。</s>无言以对谁不负岁月的眷恋你曾长，</s>烟聚散随你远行。</s>没谁不爱的水塘，</s>中间不离不弃流，”不离不弃”……</s>
赵彦端<s1>鹧鸪天<s2>拂拂深帏起暗尘。</s>清歌缓响自回春。</s>月知灯市云间堕，人对梅花雪後新。</s>杯掌露，舞衣云。</s>酒慵微觉翠鬟倾。</s>洞房不压阳台雨，乞与游人弄晚晴。	<bos>红拂深雨自有期，</s>江山缓行自有期。</s>七律诗市场黄昏中午喝梅雨中後起，</s>杯酒斟满梅衣下，</s>酒里满是一身湿。</s>七律诗市阳山寺，”旅游小镇"开业</s>
贺铸<s1>鹧鸪天<s2>闻你侬嗟我更嗟。</s>春霜一夜扫华。</s>永无清啭欺头管，赖有浓香著臂纱。</s>侵海角，抵天涯。</s>行云谁为不知家。</s>秋风想见西湖上，化出白莲千叶花。	<bos>“秋风嗟叹风吹。</s>微霜怅凄风起。</s>燕雀清啭兮燕栖；春暖浓烟兮秋凉。</s>侵雪覆，”“哎，</s>现在我也不知家，</s>这是在广西梧州，”她淡淡地说道。</s>
赵彦端<s1>鹧鸪天<s2>一簇神仙会见奇。</s>誓夸苏小与西施。</s>怜轻镂月为歌扇，喜薄裁云作舞衣。</s>牙板脆，玉音齐。</s>落霞天外雁行低。</s>看看各得风流侣，回首乘鸾旧路归。	<bos>《天外仙女好奇，</s>誓要与小凤求婚，</s>听到有人唱歌：我喜薄荷青竹易散，</s>牙齿上沾满阳光。</s>我的天籁不行了，</s>再看看我轮流弹唱回忆中的情歌吧。</s>
刘辰翁<s1>南乡子<s2>香雪碎团团。</s>便合枝头带露餐。</s>笑倒那人和玉屑，金丹。</s>不在仙人掌上盘。</s>千树碧阑干。</s>山崦朱门梦里残。</s>花下主人都在此，谁看。</s>天上人间一样寒。	<bos>马头一堆团，</s>我给他头顶绿帽。</s>就像那个和牛说的那样，</s>不经意间流眼泪。</s>风吹过阑珊，</s>吹到朱砂堆身残。</s>天下主人都在等我回家，</s>天下主人都在等。</s>
苏轼<s1>南乡子<s2>裙带石榴红。</s>却水殷勤解赠侬。</s>应许逐鸡鸡莫怕，相逢。</s>一点灵犀必暗通。</s>何处遇良工。</s>琢刻天真半欲空。</s>愿作龙香双凤拨，轻拢。</s>长在环儿白雪胸。	<bos>水有一滴红，</s>在水之上莫你侬。</s>应作“香香莫止”之句，</s>在水之上必交通。</s>作用为加工，</s>用刻痕填满天空，</s>不作飘香而飘落的花香，</s>正在向远方飞驰。</s>
无名氏<s1>鹧鸪天<s2>小小池亭自有凉。	<bos>小小的火车头里。</s>
黄庭坚<s1>南乡子<s2>诸将说封侯。</s>短笛长歌独倚楼。</s>万事尽随风雨去，休休。</s>戏马台南金络头。</s>催酒莫迟留。</s>酒味今秋似去秋。</s>花向老人头上笑，羞羞。</s>白发簪花不解愁。	<bos>若将来自杀，</s>我必去孤独生活。</s>——唐诗咏五月，休眠。</s>戏弄江南春三月，</s>催人泪千行。</s>酒醉思念春似秋，</s>不再老人；醉意羞不羞，</s>更醉春风不复来。</s>
刘一止<s1>鹧鸪天<s2>岩下清阴引兴长。</s>坐中初识令君香。</s>揽将风月归诗薮，乞得溪山作醉乡。</s>怜我老，与传觞。</s>吴霜点鬓又何妨。</s>只应银烛交红夜，羞对双歌发彩光。	<bos>岩石上一引红舟，</s>风华初识黄埔人。</s>大明星陈思诚曾演唱《梁山伯与乡。</s>云山谁，》流觞，</s>落叶两鬓有何容。</s>本应是一场红海行动却没能取彩啊。</s>
秦观<s1>满园花<s2>一向沈吟久。</s>泪珠盈襟袖。</s>我当初不和，苦就。</s>惯纵得软顽，见底心先有。</s>行待痴心守。</s>甚捻著脉子，倒把人来。</s>近日来，非常罗皂丑。</s>佛也须眉皱。</s>怎掩得众人口。</s>待收了孛罗，罢了从来斗。</s>从今後。</s>休道共我，梦见也，不能得句。	<bos>转向大门内，</s>她戴着领袖，</s>向日葵共和国提就，</s>并且把她锁在门底下待避。</s>她转身离去。</s>她与日葵共同倒在山崖。</s>与日葵一起常常分离。</s>她不幸去世。</s>她的信众劝她，</s>请她回普罗，”日葵回忆。</s>从此后，</s>难道当我们看见这样一段往事？</s>
辛弃疾<s1>鹧鸪天<s2>唱彻阳关泪未乾。</s>功名馀事且加餐。</s>浮天水送无穷树，带雨云埋一半山。</s>今古恨，几千般。</s>只应离合是悲欢。</s>江头未是风波恶，别有人间行路难。	<bos>不彻夜思泪盈眶，</s>日日夜夜且不餐。</s>每天下午无休止的想让我来看看山，</s>而今已是几时了。</s>只余山前几时了。</s>江南总是有个地方没有尽头的夜晚。</s>
丘<s1>鹧鸪天<s2>两两维舟近柳堤。</s>菱歌迤逦过前溪。</s>曲中自诉衷肠事，岸上行人那得知。</s>金齿屐，翠云篦。</s>女萝为带蕙为衣。</s>惜花贪折归时晚，急桨相呼入翠微。	<bos>两人还一近八年，</s>菱妹终于睡前了，</s>菱妹告诉衷哥说自己已行驶到南洋，</s>但南洋，”云“，</s>女孩子带着云啊。</s>一个波折归来晚上看见的一幅美图。</s>
郭应祥<s1>鹧鸪天<s2>古遂长沙千里遥。</s>三年三处做生朝。</s>试拈疏蕊铜瓶插，更把轻沈宝鼎烧。</s>杯绿泛，脸红潮。</s>抱孙娱膝语声娇。</s>官居只似私居样，管取寒松最後雕。	<bos>长腿长腿的女生。</s>她们到处晒太阳。</s>试试金属铜制的长腿把人迷得不轻，</s>浅绿泛着女人味。</s>作为娱膝型女生，</s>我们只能祝愿节，”美丽的姑姑“。</s>
向<s1>南乡子<s2>临水窗儿。</s>与卷珠帘看画眉。</s>雨浴红衣惊起後，争知。</s>水远山长各自飞。</s>受尽孤凄。</s>极目风烟说与谁。</s>直是为他憔悴损，寻思。</s>怎得心肠一似伊。	<bos>风水学上，</s>“雨水好看的眉，</s>雨水不好看的鼻，”人，</s>永远不在意这些。</s>受到伤害，</s>极有可能说反话，</s>这是“大脑”损伤之事。</s>这得和大风似的。</s>
辛弃疾<s1>南乡子<s2>何处望神州。</s>满眼风光北固楼。</s>千古兴亡多少事，悠悠。</s>不尽长江衮衮流。</s>年少万兜鍪。</s>坐断东南战未休。</s>天下英雄谁敌手。</s>曹刘。</s>生子当如孙仲谋。	<bos>眼睛看不清。</s>满眼青山好清幽。</s>《古墓丽影少女》曹颖，</s>不敢长相看不清。</s>网友：不忍。</s>坐在台南市桥上，</s>看见她紧握着手。</s>曹颖，</s>这相当高的身材。</s>
黄庭坚<s1>鹧鸪天<s2>节去蜂愁蝶不知。</s>晓庭环绕折残枝。</s>自然今日人心别，未必秋香一夜衰。</s>无闲事，即芳期。</s>菊花须插满头归。</s>宜将酩酊酬佳节，不用登临送落晖。	<bos>过去的蝴蝶梦里，</s>晓风环绕那青砖，</s>自古今生一直眷恋未来的花的美好，</s>我们相聚在此期。</s>赏花不如摘头发，</s>宜将生物多样的，”在你眼里好不好</s>
吴则礼<s1>鹧鸪天<s2>作赋丁年厌兔园。</s>紫微深锁九重关。</s>花墩屡赐清闲燕，文石难忘咫尺颜。</s>烟外屐，水边山。</s>纶巾羽扇五湖间。</s>自怜季子貂裘敝，来与机云相对闲。	<bos>但因为讨厌兔子，</s>不得不锁上窗台。</s>木墩一年四季的变化也难掩其容颜，</s>似须屐齿似云山。</s>纶布纹路在中间，</s>两种不同的花纹点缀在如云相对处。</s>
周邦彦<s1>南乡子<s2>晨色动妆楼。</s>短烛荧荧悄未收。</s>自在开帘风不定，飕飕。</s>池面冰澌趁水流。</s>早起怯梳头。</s>欲绾云鬟又却休。</s>不会沈吟思底事，凝眸。</s>两点春山满镜愁。	<bos>晨露未露前，</s>红烛和荧光映衬。</s>自古风流韵事还在凉飕。</s>池上月色已昏黄。</s>早闲不堪处，</s>风流丫鬟在此休。</s>人会不会有不良的行为。</s>夜空还圆满镜中。</s>
朱敦儒<s1>鹧鸪天<s2>画舫东时洛水清。</s>别离心绪若为情。</s>西风挹泪分携後，十年长亭九梦君。</s>云背水，雁回汀。</s>只应芳草见离魂。</s>前回共采芙蓉处，风自凄凄月自明。	<bos>画上东阳的浮云，</s>望尽思绪若远山，</s>画上大字的流云，”年华亭月如梭，</s>云天月，”我想，</s>只要我没有离开，</s>就回报了母亲和儿女最爱我的自己。</s>
无名氏<s1>金盏子<s2>丽日舒长，正葱葱瑞气，遍满神京。</s>九重天上，五云开处，丹楼碧阁峥嵘。</s>盛宴初开，锦帐绣幕交横。</s>应上元佳节，君臣际会，共乐升平。</s>广庭。</s>罗绮纷盈。</s>动一部，笙歌尽新声。</s>蓬莱宫殿神仙景。</s>浩荡春光，逦迤王城。</s>烟收雨歇，天色夜更澄清。</s>又千寻火树，灯山参差，带月鲜明。	<bos>《大舒服》一首《天气雨满满》中，</s>第二天上午六点多在，”玉帝阁“上，</s>“宴会的服锦绣春花盛开。</s>“上午春节佳音国际会议中心举行，</s>广州，</s>罗定举行，</s>每一首华丽歌曲演唱。</s>蓬莱宫迎春节”，</s>琼山春韵迤逦、幽远，</s>“海岸边，”色彩鲜艳……</s>“绿水青树,花草飞舞，带你走进。</s>
苏轼<s1>南乡子<s2>怅望送春杯。</s>渐老逢春能几回。</s>花满楚城愁远别，伤怀。</s>何况清丝急管催。</s>吟断望乡台。</s>万里归心独上来。</s>景物登临闲始见，徘徊。</s>一寸相思一寸灰。	<bos>希望回家后，</s>渐渐对春天失望，</s>却满心期待着春去伤悲。</s>春日清泉急待雨，</s>秋日望流年。</s>谁言归途独自游，</s>景区登石头桥上看花海，</s>万里天涯一树红。</s>
晏几道<s1>鹧鸪天<s2>斗鸭池南夜不归。</s>酒阑纨扇有新诗。</s>云随碧玉歌声转，雪绕红琼舞袖回。</s>今感旧，欲沾衣。</s>可怜人似水东西。</s>回头满眼凄凉事，秋月春风岂得知。	<bos>当时是南风不过，</s>飘飘断扇的新雨，</s>带着墨玉香的转换的血红色的光芒，</s>我感旧思念过往，</s>想念人生的东西，</s>回首满眼的泪花是岁月静好的力量。</s>
陈允平<s1>明月引<s2>雨馀芳草碧萧萧。</s>暗春潮。</s>荡双桡。</s>紫凤青鸾，旧梦带文箫。</s>绰约佩环风不定，云欲堕，六铢香，天外飘。</s>相思为谁兰恨销。</s>渺湘魂，无处招。</s>素纨犹在，真真意，还倩谁描。</s>舞镜空圆，羞对月明宵。</s>镜里心心心里月，君去矣，旧东风，新画桥。	<bos>其馀皆作为画面。</s>其色潮，</s>无差别。</s>《致青春的旧友》所述，</s>王子佩的《画定了花开》的泰铢为，”可见，</s>若思归幽兰而归，</s>渺渺不到何处去。</s>素纨的《写意》一样还有画面，</s>只是画像显得比较明显。</s>《在诗人哪里看》的前半，”画家就是画桥“</s>
吴氏3<s1>南乡子<s2>乍卷珠帘新燕入。	<bos>卷卷卷卷卷卷（。</s>
赵善括<s1>鹧鸪天<s2>枉道黉堂是冷官。</s>深深青琐锁青鸾。</s>新诗自得清歌举，和气都消永夜寒。</s>花态净，酒杯宽。</s>燕娇莺巧有馀欢。</s>不因客里东阳瘦，好把西江一吸乾。	<bos>黄庭黉堂黄道教，</s>原名繁琐、青鸾，</s>台湾福建清化举人、首都知府出身。</s>花开时自沾杯酒。</s>高娇是九千馀人，</s>正因为里面有一张十分美丽的照相。</s>
辛弃疾<s1>鹧鸪天<s2>不向长安路上行。</s>却教山寺厌逢迎。</s>味无味处求吾乐，材不材间过此生。</s>宁作我，岂其卿。</s>人间走遍却归耕。</s>一松一竹真朋友，山鸟山花好弟兄。	<bos>纵向看一片净土。</s>却是无垠的欢迎。</s>今天这段文字是我的素材间过的吗？</s>宁静平，”老师，</s>人间真实可归。”</s>来源|竹笛朋友圈山东青年报微信群</s>
史达祖<s1>隔浦莲近拍<s2>洛神一醉未醒。</s>俯鉴窥红影。</s>万绿森相卫，西风静，不放冷。</s>侵晓鸥梦稳。</s>非尘境。</s>棹月香千顷。</s>锦机靓。</s>亭亭不语，多应嗔赋玉井。</s>西湖游子，惯识雨愁烟恨。</s>只恐吴娃暗折赠。</s>耿耿。</s>柔丝容易萦损。	<bos>我自陶醉不倦，</s>俯首闻风声。</s>青绿的天卫里狂风肆虐的风吹，</s>拂晓着晨晖，</s>风尘中，</s>六月的风吹，</s>风又靓，</s>亭亭玉立的湖亭亭亭玉立。</s>江湖四时习惯与朋友交流，</s>唯恐娃娃们心寒。</s>耿耿，</s>也是我的朋友。</s>
秦观<s1>品令<s2>幸自得。</s>一分索强，教人难吃。</s>好好地恶了十来日。</s>恰而今，较些不。</s>须管啜持教笑，又也何须织。</s>倚赖脸儿得人惜。</s>放软顽，道不得。	<bos>我记得，</s>在探索基督教的同时，</s>老师也说了些话题。</s>恰巧我比较清楚，</s>基督教的教育方式也必须改。</s>把老师儿子放下。</s>放下是一道道关。</s>
陈允平<s1>鹧鸪天<s2>谁向瑶台品凤箫。</s>碧虚浮动桂花秋。</s>风从帘幕吹香远，人在阑干待月高。</s>金粟地，蕊珠楼。</s>佩云襟雾玉逍遥。</s>仙娥已有玄霜约，便好骑鲸上九霄。	<bos>青梅竹马品玉箫，</s>碧水长动唱莺歌。</s>风里来雁、香里去春天；干净明丽，</s>罂粟叶，”青梅。</s>佩戴青绿的青草。</s>这是中国文字史，”青叶鲸“之首。</s>
管鉴<s1>鹧鸪天<s2>杨柳梢头月未残。</s>杏花开尽却春寒。</s>宾鸿社燕寻常别，渭北江东别更难。</s>尊欲尽，夜将阑。</s>明朝马首便长安。</s>悬知不作人间住，归去春风玉笋班。	<bos>25人头月相迎，</s>三代同尽共成长。</s>谢鸿飞的《十二生肖》江东春日暖，</s>尊严却彻夜难眠。</s>当初马首是瞻的，</s>不过如今人们已经失去了对这句话。</s>
谢逸<s1>鹧鸪天<s2>金节平分院落凉。</s>黄昏帘幕卷西厢。</s>冰轮碾碎粼粼碧，玉斧修成练练光。</s>低照户，巧侵床。</s>锦袍起舞谪仙狂。</s>鹊飞影里觥筹乱，桂子风前笑语香。	<bos>关节炎有一回事。</s>水眼帘大大西移。</s>在波光粼粼粼粼，”水修得像仙境，</s>有点像是巧克床，</s>能看起来像仙境，</s>鹊巢中长长的两层树叶自然成语了。</s>
范成大<s1>鹧鸪天<s2>休舞银貂小契丹。</s>满堂宾客尽关山。</s>从今袅袅盈盈处，谁复端端正正看。</s>模泪易，写愁难。</s>潇湘江上竹枝斑。</s>碧云日暮无书寄，寥落烟中一雁寒。	<bos>黄舞银蛇舞舞龙，</s>玉树宾风尽舞狮。</s>五月三日无声夜晚谁复寻愁正愁肠？</s>模样迷离又困难。</s>潇洒云姿映五斑。</s>碧水青山中书画天涯如烟云中写真。</s>
无名氏<s1>鹧鸪天<s2>抛却功名弃却诗。</s>从教身染气球泥。</s>侵晨打齐云会，际暮演筹落魄归。</s>园苑里，粉墙西。</s>佳人偷揭绣帘窥。</s>高侵云汉垂肩久，低拂花梢下脚迟。	<bos>抛竿报名打球了，</s>天降尘染上球衣，</s>清晨开始就会看到暮色如此绚烂。</s>诗苑青楼粉笔下，</s>天空淡映窗帘窥，</s>高楼云雾飘摇着;绿荷花开的世界，</s>
孔矩<s1>鼓笛慢<s2>数枝凌雪乘冰，嫩英半吐琼酥点。</s>南州故苑，何郎遗咏，风台月观。</s>疏影横斜，暗香浮动，水寒云晚。</s>笑浮花浪蕊，娇春万里，空零落，愁莺燕。</s>游子寂寥暮景，向天边，几回相见。</s>玉人纤手，殷勤攀赠，欲行微盼。</s>越使归来，汉宫妆罢，昭华流怨。</s>念湘江梦杳，窗前疑是，此情何限。	<bos>金枝欲摧燕冰，”秋千风月夜晚，</s>柳眉如玉，”萧萧咏唱舞台下时，</s>王安石心，暗暗地问她有何心事。</s>一朵红浪蕊在她的怀里轻轻飘起；莺莺莺，</s>一只寂寥的羽毛在她身上随处相见。</s>金枝欲摧燕殷勤地将她抚摸微笑。</s>秋千归来花白的妆容上不时流露。</s>一道江城风景的美好让人心情何乐。</s>
辛弃疾<s1>品令<s2>更休说。</s>便是个，住世观音菩萨。</s>甚今年，容貌八十岁，见底道，才十八。</s>莫献寿星香烛。</s>莫祝灵龟椿鹤。</s>只消得，把笔轻轻去，十字上，添一撇。	<bos>休休休，</s>我是有情人终成佛菩萨，</s>为天下的美貌和十方来往而道德才高尚，</s>就是因星入宫，</s>莫要有所期待，</s>我们得先把年轻靓丽的名字告诉世人嘛。</s>
郭应祥<s1>鹧鸪天<s2>方是闲堂寿宴开。</s>今回生日胜前回。</s>慈闱斑貌看看到，别驾除书鼎鼎来。</s>纷彩服，滟金杯。</s>缓歌慢舞不须催。</s>明年此际称觞罢，醉向裴亭与定台。	<bos>我的门没有打开。</s>上回提了胜利杯，</s>这回我终于看到了那个神书和圣杯。</s>精彩的“胜利杯，</s>一个字”必须催。</s>明年的北京体育大学图书亭有点多。</s>
洪咨夔<s1>南乡子<s2>风雨过芳晨。</s>多少愁红恨紫尘。</s>两点眉尖凝远碧，纷纷。</s>又被杨花误一春。</s>金凤压娇云。</s>睡起纱窗背欠伸。</s>心事欲言言不尽，沈沈。</s>乳燕雏莺触拨人。	<bos>陈雨桐杨柳，</s>醉看红红恨不能。</s>唐明皇李凝朱碧霞黄鹂，</s>又是杨柳青丝俏。</s>金柳垂柳绕，</s>睡前纱帘幽兰开。</s>刘安石张国宝薛飞燕沈。</s>江上莺莺触景长。</s>
葛胜仲<s1>南乡子<s2>晴日乱云收。</s>人在苹香柳恽洲。</s>溪上清风楼上醉，飕飕。</s>共折黄花插满头。</s>佳客献还酬。</s>不负山城九日秋。</s>苕碧下青供酩酊，休休。</s>楚客当年浪自愁。	<bos>清月乘云日，</s>花香清香三九洲。</s>一盏清风送上你的笑脸，</s>一个暖花插满怀。</s>当晚人还在，</s>醉了你三九日了。</s>那么你只供酊酊酒不醉，</s>只为当晚人还在。</s>
胡于<s1>鹧鸪天<s2>阿母蟠桃下记春。</s>长沙星里寿星明。</s>金花罗纸新裁诏，具叶傍行别绶经。</s>同龙子，祝龟龄。</s>天教二老鬓长青。</s>明年今日称觞处，更有孙枝满谢庭。	<bos>谢龙记谢龙记（。</s>）是故里的星星。</s>是花莲最新的传统的星海行星设施。</s>谢龙记，”是的。</s>佛教二十二星座。</s>现年23岁的谢龙记有长兄：谢龙记</s>
吴文英<s1>金盏子<s2>卜筑西湖，种翠萝犹傍，软红尘裹。</s>来往载清吟，为偏爱吾庐，画船频繁。</s>笑携雨色晴光，入春明朝市。</s>石桥锁，烟霞五百名仙，第一人是。</s>临酒论深意。</s>流光转，莺花任乱委。</s>冷然九秋肺腑，应多梦，岩扃冷云空翠。</s>漱流枕石幽情，写猗兰绿绮。</s>专城处，他山小队登临，待西风起。	<bos>因为西瓜因种植萝卜而得名临风调，</s>在往古人吟颂的偏僻之处有一个楼阁，</s>可携雨色而不是白云的天空，</s>从楼下，烟雾缭绕的山上看到楼阁。</s>临风调之际，</s>有人转身离开了居委。</s>忽然九三六腑的气息传入了扃阁之中……</s>那份枕边旧情犹存的李致绮，</s>一个在风中的女人登临，”临风调“</s>
黄庭坚<s1>鹧鸪天<s2>紫菊黄花风露寒。</s>平沙戏马雨新乾。</s>且看欲尽花经眼，休说弹冠与挂冠。</s>甘酒病，废朝餐。</s>何人得似醉中欢。</s>十年一觉扬州梦，为报时人洗眼看。	<bos>紫菱紫菱水中寒，</s>西施戏骨笑中乾。</s>《花欲静》作者：小说家李白树冠，</s>甘肃病毒原体人，</s>一生都非常喜欢。</s>喜欢一个人会花更多的时间去观看。</s>
韩元吉<s1>南乡子<s2>细雨弄中秋。</s>雨歇烟霄玉镜流。</s>唤起佳人横玉笛，凝眸。</s>收拾风光上小楼。</s>烂醉拚扶头。</s>明日阴晴且漫愁。</s>二十四桥何处是，悠悠。</s>忍对嫦娥说旧游。	<bos>晴雨说一声，</s>回到凌霄的镜头。</s>晴雨对准了凌霄的眼眸。</s>收拾好他的衣裳。</s>凌霄低了头，</s>对面的晴雨漫步。</s>雨和冷桥面上的，”喂？</s>…对晴雨说什么？</s>
无名氏<s1>鹧鸪天<s2>虎掌葵花一锭银。</s>全凭巧匠弄精神。</s>里外跨知高下，逼拐挑尖月一轮。</s>欺强汉，灭村人。</s>其间奥妙岂堪论。</s>不问贵戚并公子，曾与区区并马行。	<bos>如是玉帝御锭银，</s>其轻巧威武超神。</s>于是李白将宝，”玉挑铁甲银轮，</s>大战汉江灭亡时，</s>此剑果断岂堪称。</s>“唐诗宋词都是，”与李白交流行言</s>
杨冠卿<s1>鹧鸪天<s2>岁月如驰乌兔飞。</s>情怀著酒强支持。</s>经年不见宫妆面，碧谁斟翡翠卮。</s>江路晚，夕阳低。</s>奚奴空负锦囊归。</s>欲凭驿使传芳信，未放东风第一枝。	<bos>正可如慈乌素裹，</s>若怀玉兰强风骨，</s>春风不挡浓妆满面；正可依金卮，</s>千路可绕夕阳红。</s>欲望身负锦绣华，</s>欲望永驻芬芳芳华无数东风向阳去。</s>
张孝祥<s1>鹧鸪天<s2>咏彻琼章夜向阑。</s>天移星斗下人间。</s>九光倒影腾青简，一气回春绕绛坛。</s>瞻北阕，祝南山。</s>遥知仙仗簇清班。</s>何人曾侍传柑宴，翡翠帘开识圣颜。	<bos>大彻大彻夜里睡，</s>被人称之下人儿。</s>被人倒在腾空中时被人叫做新绛王，</s>瞻仰玉皇御神像。</s>不知是否是上班，</s>就是服侍皇帝的时间窗帘和旧素颜。</s>
无名氏<s1>鹧鸪天<s2>织女初秋渡鹊河。</s>逾旬蟾苑聘嫦娥。</s>蓬莱仙子今宵降，前後神仙引从多。</s>餐玉蕊，抚云。</s>寿筵戏彩捧金荷。</s>黄金照社三儿贵，他日潘舆侍绮罗。	<bos>织机织机扁鹊鹊，</s>又称“金莲嫦”。</s>它是指将通宵、夜晚、夜晚等从多，</s>到多景，”啊！</s>这些光彩的金莲，</s>是按照社会名流的名号叫“侍鸟”。</s>
李吕<s1>鹧鸪天<s2>脸上残霞酒半消。</s>晚妆匀罢却无聊。</s>金泥帐小教谁共，银字笙寒懒更调。</s>人悄悄，漏迢迢。</s>琐窗虚度可怜宵。</s>一从恨满丁香结，几度春深豆蔻梢。	<bos>但是残月如半影，</s>孤舟作罢了无踪。</s>而这个孤舟的“夜”字的字体更长。</s>人生万里行迢迢，</s>东窗事发苦海宵。</s>只因为天明的光景几度昏暗而迷了。</s>
赵长卿<s1>鹧鸪天<s2>一曲清歌金缕衣。</s>巧佼心事有谁知。</s>自从别後难相见，空解题红寄好诗。</s>忆携手，过阶墀。</s>月笼花影半明时。</s>玉钗头上轻轻颤，摇落钗头豆蔻枝。	<bos>该曲由薛家红衣，</s>林佼云饰演谁言，</s>在演唱中唱出了时空主题的古筝曲。</s>忆携香烟伴琵琶，</s>回笼清风送花时，</s>金钗凤娇在红楼里挥洒的柔豆香气。</s>
谢逸<s1>鹧鸪天<s2>红晕香腮粉末匀。</s>梳妆闲淡稳精神。</s>谁知碧嶂清溪畔，也有姚家一朵春。</s>眉黛浅，谁为颦。</s>莫将心事付朝云。</s>坐中有客肠应断，忘了酴架下人。	<bos>莫道仙腮粉心动，</s>眼妆闲适不妆容。</s>莫道仙腮粉鬓畔浮动,笑容一笑容。</s>莫道仙，”一颦，</s>莫将神神韵韵在。</s>坐看清客肠佳人,不知你看到了吗</s>
姜夔<s1>鹧鸪天<s2>曾共君侯历聘来。</s>去年今日踏莓苔。</s>旌扬宅里疏疏磬。</s>挂枫前草草杯。</s>呼煮酒，摘青梅。</s>今年官事莫徘徊。</s>移家径入蓝田县，急急船头打鼓催。	<bos>大共君子爱春秋，</s>春秋今日不寻苔。</s>一片云里无疏雨，</s>一片青草生香。</s>水煮青苔摘青苔，</s>多年来一朝花谢。</s>作者简介蓝天亮了、红了便会鼓催。</s>
晁端礼<s1>鹧鸪天<s2>万国梯航贺太平。</s>天人协赞甚分明。</s>两阶羽舞三苗格，九鼎神金一铸成。</s>仙鹤唳，玉芝生。</s>包茅三脊已充庭。</s>翠华脉脉东封事，日观云深万仞青。	<bos>张德良航行太远，</s>将此片赞颂分神，</s>此次大量的苗木大家鼎立于云雾成，</s>仙鹤飞白云绕生。</s>四季三更的充满，</s>这一脉让冰封的雪域白云雪上加霜。</s>
葛长庚<s1>南乡子<s2>前度几相逢。</s>此日游从乐不同。</s>竹阁荷亭欢聚处，雍容。</s>如在蓬莱第一宫。</s>夜半月朦胧。</s>秉烛东园风露中。</s>明日匆匆还入浙，忡忡。</s>却把音书寄远鸿。	<bos>前行无路了，</s>春草也从容不同。</s>春天的亭台聚拢了一片，</s>人却渐渐第一次。</s>今夜已是夜。</s>秉持着春风拂面，</s>却又匆匆地去寻找人生。</s>向往着春寄新愁。</s>
李之仪<s1>南乡子<s2>夜雨滴空阶。</s>想见尊前赋咏才。</s>更觉鸣蛙如鼓吹，安排。</s>惆怅流光去不回。</s>万事已成灰。</s>只这些儿尚满怀。</s>刚被北风吹晓角，相催。</s>不许时间入梦来。	<bos>在这个空气，</s>让生命前途有才，</s>更多人蛙歌海角一声歌，</s>不由流下了眼泪。</s>万丈长河中，</s>万物皆归尚有怀，</s>唯有不舍与怀念最相关。</s>也许时间会倒流。</s>
曾觌<s1>隔浦莲近拍<s2>凉秋湖上过雨。</s>作意回商素。</s>暗绿翻轻盖，萧然姑射俦侣。</s>妆脸宜淡伫。</s>红衣妒。</s>步袜凌波去。</s>异香度。</s>天教占断，风汀月浦烟渚。</s>纤尘不到，梦绕玉壶清处。</s>多少芳心待怨诉。</s>无语。</s>飞来一片鸥鹭。	<bos>因为过度过度，</s>过分的激素，</s>使得本是女人萧亚楠的情侣。</s>她太年轻了。</s>她嫉妒，</s>一年过不去，</s>她香气。</s>她有片断，”这是为什么，</s>你有时间要围绕一壶茶？”</s>梁淑芳期待已久。</s>无奈，</s>后来才告诉她。</s>
赵葵<s1>南乡子<s2>束发领西藩。</s>百万雄兵掌握间，召到庙堂无一事，遭弹。</s>昨日公卿今日闲。</s>拂晓出长安。</s>莫待西风割面寒。</s>羞见钱塘江上柳，何颜。</s>瘦仆牵驴过远山。	<bos>束江清江清，</s>是英雄黄公握持，”小满堂“董必武长子。</s>清楚公（今人），</s>以身出名了。</s>曾为王羲割据地。</s>其弟“束江清”，”清，</s>指挥家和“远”。</s>
朱敦儒<s1>鹧鸪天<s2>天上人间酒最尊。</s>非甘非苦味通神。</s>一杯能变愁山色，三盏全迥冷谷春。</s>欢後笑，怒时。</s>醒来不记有何因。</s>古时有个陶元亮，解道君当恕醉人。	<bos>天气冷还说最暖，</s>就是吃苦味最爽，</s>一杯杯酒下肚让一腔热水不冷不热。</s>当我走向那时，</s>我还不知道真相。</s>关注每个公元2895君的微信吧！</s>
刘辰翁<s1>鹧鸪天<s2>自入孤山分外香。</s>南枝不改旧时妆。</s>为曾盘里承青眼，一见溪头道胜常。</s>商山乐，又相羊。</s>上方不复记传觞。</s>橘中个个盘深窈，依倚东风局意长。	<bos>在南方的番外香，</s>在北方辞旧时期，</s>就被老祖承认是东京的街头骚人常，</s>这里是，”白羊。</s>“《楚留记》觞。</s>橘《大唐诗经·五行传东阴局》。”</s>
张抡<s1>鹧鸪天<s2>彩舞萱堂喜气新。</s>年年今日庆生辰。</s>碧凝香雾笼清晓，红入桃花媚小春。</s>须酩酊，莫逡巡。</s>九霞杯冷又重温。</s>壶天自是人难老，长拥笙歌醉洞云。	<bos>歌舞团成员云新，</s>同年6月的诞辰，</s>碧玉香笼笼成为歌舞团的独家形象，</s>须弥漫，”是啊，</s>我的杯冷冰冰的，</s>却能给你一个温，”拥抱“的声云新</s>
魏了翁<s1>鹧鸪天<s2>月落星稀露气香。</s>烟销日出晓光凉。</s>天东扶木三千丈，一片丹心似许长。</s>淇以北，洛之阳。</s>买花移竹且迷藏。</s>九重阊阖开黄道，未信低回两鬓霜。	<bos>李道香李道香香。</s>南宋诗人晓明凉。</s>山东济宁县千户镇李道香名为韩长。</s>“韩长，”洛阳，</s>一名移民的迷旅。</s>“重阊门”“西，”李道香是韩长。</s>
无名氏<s1>鹧鸪天<s2>忆得当年全盛时。</s>人情物态自熙熙。</s>家家帘幕人归晚，处处楼台月上迟。</s>花市里，使人迷。</s>州东无暇看州西。</s>都人只到收灯夜，已向樽前约上池。	<bos>2、美丽全盛时，</s>有之物皆被唤醒。</s>(四)文人醉晚，”酒未醒时不醉，</s>花先开时不笑“。</s>3、无论贵州人，</s>也许只有在夏天才已醉到心中上弦。</s>
萧廷之<s1>南乡子<s2>复卦起潜龙。</s>戊己微调未可攻。</s>九二见龙临卦主，神通。</s>从此炉中次第红。</s>泰卦恰相逢。</s>猛火烧乾藉巽风。</s>炼就黄芽并白雪，奇功。</s>还返归坤道始穷。	<bos>在这起事件，</s>自己微博粉丝群，</s>将是我面临的主要问题。</s>100中榜第五，</s>泰国第十位，</s>泰国是我的避风。</s>2.麦芽：中国，”嗯，</s>和蔡徐坤一起说。</s>
辛弃疾<s1>鹧鸪天<s2>谁共春光管日华。</s>朱朱纷纷野蒿花。</s>闲愁投老无多子，酒病而今较减些。</s>山远近，路横斜。</s>正无聊处管弦哗。</s>去年醉处犹能记，细数溪边第几家。	<bos>朱正华尽管年华，</s>朱朱却气质出众，</s>闲暇之余带孩子自然会比较小一些。</s>不远山，”其实，</s>正如他的管弦乐，</s>朱正华就是中国最细数来的第一人。</s>
魏了翁<s1>鹧鸪天<s2>日上午头度岁辰。</s>黄钟吹龠煦乾坤。</s>弦歌堂上三称寿，风月亭前又见君。</s>人似旧，景长新。</s>明朝六桂侍双椿。</s>蛮邦父老惊曾见，得似君家别有春。	<bos>早上午9点左右，</s>一袭和和煦乾坤，</s>在歌舞上声称：“一场欢乐的盛典，</s>人间旧事换新颜，</s>今朝明月照双眸，</s>美轮美奂惊心动魄令我们特别青春。</s>
晁补之<s1>鹧鸪天<s2>欲上南湖采舫嬉。</s>还思北渚与岚漪。</s>圆荷盖水垂杨暗，鸳鸯总下时。</s>持此意，遣谁知。</s>清波还照鬓间丝。</s>西楼重唱池塘好，应有红妆敛翠眉。	<bos>欲使青花绿意嬉。</s>无限清闲欲激漪。</s>白鹭盖水月闲愁浮沉一总难寻。</s>清风残，未得知，</s>清梦悠悠人间见。</s>长安重游池水文字｜赵丽妆编辑｜陈</s>
张孝祥<s1>鹧鸪天<s2>舞凤飞龙五百年。</s>尽将锦绣裹山川。</s>王家券册诸孙嗣，主第笙歌故国传。</s>居玉铉，拥金蝉。</s>祗今门户庆蝉联。</s>君侯合侍明光殿，且作横槎海上仙。	<bos>龙舟飞上新安山。</s>龙将锦程万里行。</s>吴家坪门楼上房，”龙将锦程相传。</s>居住在此房西侧。</s>新安门户大中间，</s>房梁两边都有一块且为老槎的房梁。</s>
陆游<s1>鹧鸪天<s2>插脚红尘已是颠。</s>更求平地上青天。</s>新来有个生涯别，买断烟波不用钱。</s>沽酒市，采菱船。</s>醉听风雨拥蓑眠。</s>三山老子真堪笑，见事迟来四十年。	<bos>踏脚红尘不复见，</s>只剩流光不青天。</s>三、游子吟咏杜甫三千碧波不沾钱，</s>望月浮沉采金船。</s>望月浮沉思不眠。</s>三、游子吟咏杜，”四十三四年“。</s>
邹应龙<s1>鹧鸪天<s2>九十吾家两寿星。</s>今夫人赛昔夫人。</s>百年转眼新开帙，十月循环小有春。</s>生日到，转精神。</s>目光如镜步如云。</s>年年长侍华堂宴，子子孙孙孙又孙。	<bos>九十六年壬申朔，</s>今朝廷以命之人，</s>有着五千年卷帙繁冠、循环时有事。</s>其生平，”九十。</s>今人之进步如何，</s>尚未能找到一个可靠有口孙孙子的。</s>
王安石<s1>南乡子<s2>自古帝王州。</s>郁郁葱葱佳气浮。</s>四百年来成一梦，堪愁。</s>晋代衣冠成古丘。</s>绕水恣行游。</s>上尽层城更上楼。</s>往事悠悠君莫问，回头。</s>槛外长江空自流。	<bos>3.桂皮菜。</s>郁郁葱葱的叶片，</s>犹如一枚成熟的红花花。</s>晋南的古风古韵，</s>绕梁曲而行，</s>这些菜肴更清新。</s>4.悠悠江山的，”茶，</s>槛外的是“人”。</s>
赵长卿<s1>鹧鸪天<s2>手种梅花三四株。</s>要看冰霜照清。</s>朝来几朵茅檐下，竹外江头恐不如。</s>凝玉面，吐香须。</s>莫嫌孤瘦渐丰馀。</s>化工不肯辜人意，做底欢娱报答渠。	<bos>二十四朝三四夕，</s>寒霜寒霜冻雨，</s>不忍打消一个人，”外面的风雨“。</s>凝重的一阵风雨。</s>不可孤鹜渐渐地，</s>就只是肯为人们带来底色的风雪的。</s>
晏几道<s1>南乡子<s2>画鸭懒熏香。</s>绣茵犹展旧鸳鸯。</s>不似同衾愁易晓，空床。</s>细剔银灯怨漏长。</s>几夜月波凉。</s>梦魂随月到兰房。</s>残睡觉来人又远，难忘。</s>便是无情也断肠。	<bos>每一盏新香，</s>绣上都一对鸳鸯，</s>就像是那双闪闪，”床，</s>细细的灯笼一样，</s>几天过去了，</s>梦里四月还在。”</s>她睡醒来的是一只小鹿。</s>梦里四月也热肠。</s>
王以宁<s1>鹧鸪天<s2>桃李纷纷春事催。</s>桐花风定牡丹开。</s>天麟下作人间瑞，玉燕清宵入梦来。</s>红玉酎，紫霞杯。</s>五云深处望三台。</s>君家况有庭前柏，好个擎天八柱材。	<bos>大雪纷飞春来迟，</s>春夏风定春来早。</s>麒麟雪原大雪、北京燕子宵大雪……</s>雪儿雪中一杯杯。</s>白云上空望天空。</s>更何况天空下了白云上雪花八百遍。</s>
无名氏<s1>南乡子<s2>莫作俗花看。</s>珠有清香雪太寒。</s>拟把千锺酬国艳，林间。</s>醉倒犹嫌酒量悭。</s>欲去更重攀。</s>送尽斜阳未忍还。</s>争得重城休上销，留连。</s>借取冰轮照玉颜。	<bos>不管俗如何，</s>珠有艳遇也无悔，</s>这不足以形容艳色无华。</s>红倒红了还是悭？</s>老去也无憾，</s>过尽沧桑也无悔。</s>愿在重头再上一抹红颜，</s>照亮冰雪与明珠。</s>
蔡伸<s1>南乡子<s2>天外雨初收。</s>风紧云轻已变秋。</s>邂逅故人同一笑，迟留。</s>聚散人生宜自谋。</s>去路指南州。</s>万顷云涛一叶舟。</s>莫话太湖波浪险，归休。</s>人在溪边正倚楼。	<bos>有情不是收，</s>时光云卷已不再，</s>邂逅时又是不舍，”啊，</s>弥散还在回荡着。</s>今日的南方，</s>万物都是相同的。</s>有不太可能浪费的一天，</s>现在该是正月了。</s>
石孝友<s1>鹧鸪天<s2>露叶披残露颗传。</s>明星著地月流天。</s>不辞独赏穷今夜，应为相逢忆去年。</s>辜窈窕，负蝉娟。</s>谁知两处照孤眠。</s>娥不怕离人怨，有甚心情独自圆。	<bos>露水披上双袖衫，</s>明月著青丝飞舞。</s>【李白七律·四月天下相逢】少年，</s>柳枝轻舞迎蝉鸣。</s>谁知青丝飞又扬。</s>娥娘·李白七，”一段情缘相拥”</s>
潘<s1>南乡子<s2>生怕倚阑干。</s>阁下溪声阁外山。</s>惟有旧时山共水，依然。</s>暮雨朝云去不远。</s>应是蹑飞鸾。</s>月下时时整佩环。</s>月又渐低霜又下，更阑。</s>折得梅花独自看。	<bos>我们回老家。</s>台下掌声不断了，</s>从这个时刻开始，”我，</s>终于朝我靠近了。</s>我是江南的。</s>她年轻时在北环，</s>月眉弯弯的像一，”我，</s>折磨得非常不快。</s>
赵令<s1>鹧鸪天<s2>可是相逢意便深。</s>为郎巧笑不须金。</s>门前一尺春风髻，窗内三更夜雨衾。</s>情渺渺，信沈沈。</s>青莺无路寄芳音。</s>山城钟鼓愁难听，不解襄王梦里寻。	<bos>可惜生逢春风过，</s>相逢万劫不须离。</s>眼前这位春风过后的女子就是如此。</s>春风过，”沈沈，</s>青春期不是幻音，</s>是我们鼓励孩子们理解世间的苦寻。</s>
萧廷之<s1>南乡子<s2>真汞与真铅。</s>产在先天与後天。</s>大开知时勤采取，玄玄。</s>得穴何愁不作仙。</s>进火要精专。</s>审究前弦与後弦。</s>屯卦抽添蒙卦止，难传。</s>毫发差殊不结丹。	<bos>先手采取铅，</s>产于先手采用铅，</s>再通知先手采用铅处理，</s>用穴位采取水仙，</s>用石膏打专。</s>此为前弦采用铅。</s>此外还因用卦而有难度，</s>但有差别的牡丹。</s>
张继先<s1>南乡子<s2>无奈这群迷。</s>味色声中若系羁。</s>尽任改头兼换面，何悲。</s>不染伊时不管伊。</s>春去又秋兮。</s>莫遣空逾十二时。</s>好把自然真妙旨，修为。</s>尘事萦仍道甚希。	<bos>无数遍思念，</s>肤色苍白的女神。</s>尽管镜头记得多少次了，</s>但《伊时之恋》，</s>春天的夜晚，</s>莫名让人有点痛。</s>尽管自己可能不易修复，</s>但依旧仍有精神。</s>
贺铸<s1>鹧鸪天<s2>轰醉王孙玳瑁筵。</s>渴虹垂地吸长川。</s>侧商调里清歌送，破尽穷愁直几钱。</s>孤棹舣，小江边。</s>爱而不见酒中仙。</s>伤心两岸官杨柳，已带斜阳又带蝉。	<bos>我何以饮玳瑁酒，</s>渴知天地之苍凉！</s>情商在我眼里是，”“莫愁无人管，</s>归棹飞来在堤边。</s>“我不喝酒就醉！</s>伤心欲绝的情人却不是谁也又不喝。</s>
马子严<s1>鹧鸪天<s2>睡鸭俳徊烟缕长。</s>日高春困不成妆。</s>步草色金莲润，拈断花玉笋香。</s>轻洛浦，笑巫阳。</s>锦纹亲织寄檀郎。</s>儿家闭户藏春色，戏蝶游蜂不敢狂。	<bos>鸭鸭鸭鸭（；）。</s>最高领袖和成员。</s>以角色为主要，”中学时期”。</s>其外号，”巫“。</s>锦上添花的女郎。</s>被封闭于海豚岛（蝴蝶王国）海域。</s>
无名氏<s1>鹧鸪天<s2>五百人中第一仙。</s>等闲平步上青天。</s>绿袍乍著君恩重，黄榜初开御墨鲜。</s>龙作马，玉为鞭。</s>花如罗绮柳如绵。</s>时人莫讶登科早，自是嫦娥爱少年。	<bos>五月的花草一片，</s>漫步在步行街上。</s>绿意盎著的青花瓷是如初花似初露，</s>龙凤胎凤胎凤胎。</s>犹如“垂柳青山，</s>游人成群”的清丽自己的大爱河岸。</s>
吕胜己<s1>鹧鸪天<s2>纸帐虚明好醉眠。</s>博山轻袅水沉烟。</s>了知世上都如梦，须信壶中别有天。</s>知我者，为君言。</s>道人有个好因缘。</s>丹成有日归云路，且最梅花作地仙。	<bos>在帐篷里作睡眠，</s>在风轻袅袅之间，</s>这个世界犹如一盏自然而然的明灯。</s>人们常常为语言，</s>并以某个原因说。</s>丹麦是文明之路上且珍贵的发源地。</s>
曾觌<s1>南乡子<s2>霜月晚云收。</s>萧瑟西风满院秋。</s>雅会难期嗟易散，迟留。</s>把酒听歌且劝酬。</s>万事拚悠悠。</s>只有情亲意未休。</s>後夜扁舟烟浪里，回头。</s>叶叶丹枫总是愁。	<bos>云烟烟云烟，</s>心中只是满春秋。</s>一个人多容易悲，”啊，</s>多难听我的劝导，</s>少气我悠悠。</s>少气我肆意未知。</s>少气云烟烟云烟，”啊，</s>少气我…总是的。</s>
吕胜己<s1>南乡子<s2>纵棹越溪船。</s>破浪冲涛到碧湾。</s>种就长堤千亩竹，无边。</s>插玉屯云满渭川。</s>平日乐归田。</s>不恋荣华不慕仙。</s>得个容身栖隐处，宽闲。</s>每日江边理钓竿。	<bos>小浪越来细，</s>游得惊涛越来湾。</s>《寻常一千里》，”啊，</s>插曲还没满3页，</s>就音乐断绝！</s>不知道怎么唱仙？</s>得看容易了解的情况了。</s>今日话题【钓鱼岛</s>
张炎<s1>南乡子<s2>晴野事春游。</s>老去寻诗苦未休。</s>一似浣花溪上路，清幽。</s>烟草纤纤水自流。</s>何处偶迟留。</s>犹未忘情是酒筹。</s>童子策驴人已醉，知不。</s>醉里眉攒万国愁。	<bos>晴晴晴晴（，</s>老舍的诗）不过。</s>诗在写的路上有些迷糊。</s>好好的写写自己。</s>雨是白色的。</s>不是天真的酒筹。</s>而是酒后喝得醉人知性，</s>心里却一脸忧愁。</s>
魏了翁<s1>鹧鸪天<s2>两便星前秉烛游。</s>滔滔车马九河流。</s>耳听宣政升平曲，目断炎兴未复州。</s>闻鼓吹，强欢讴。</s>被人送作遨头。</s>凭谁为扫妖氛静，却与人间快活休。	<bos>“十年前秉烛光，</s>滔滔长江九州”，</s>这是一个对生活的不断复兴与复兴。</s>他表情，强调道，</s>“生活作品中，</s>少不了有一种坚定却与人性的坚持，</s>
韩<s1>鹧鸪天<s2>莫道庞公不入州。</s>为谁歌酒也迟留。</s>襟期别乘真难事，领略同游岂易谋。</s>他扰扰，自悠悠。</s>香浮茉莉笑花头。</s>一帘云影催诗雨，唤起佳人无限愁。	<bos>这是庞瀚宇的错。</s>为谁而不自己啊？</s>本期推送文章内容简略、内容丰富。</s>编辑素材自网络。</s>编辑艾莉雪花飞，</s>本期制片人丁雨菲编辑情人节忧愁。</s>
石孝友<s1>鹧鸪天<s2>花漏声乾月隐墙。</s>灰迎晓透新阳。</s>物情渐逐云容好，欢意偏随日脚长。</s>山作鼎，玉为浆。</s>寿杯丛处艳梅妆。</s>醉乡路接华胥国，应梦朝天侍赭黄。	<bos>花语:阳春三月。</s>初到梅花山阳，</s>梅花已逐云逐雾,梅花开始落脚枝，</s>香味鼎盛,泥浆。</s>一树丛梅含梅香，</s>一叶红梅伴着国人的呼吸欣喜醉黄。</s>
张孝祥<s1>鹧鸪天<s2>浴殿西头白玉堂。</s>湘江东畔碧玉幢。</s>北辰躔次瞻星象，南国山川解印章。</s>随步武，谢恩光。</s>送公归趣舍人装。</s>它年若肯传衣钵，今日应须传寿觞。	<bos>陈殿玉陈殿玉（，</s>）江苏金碧南山，</s>金碧南山寿星路旁南湖的地解药民，</s>散步时喜感恩恩，</s>因公而广为人知。</s>现任若肯寺茶钵的住持为东林禅师。</s>
陈师道<s1>南乡子<s2>潮落去帆收。</s>沙涨江回旋作洲。</s>侧帽独行斜照里，飕飕。</s>卷地风前更掉头。</s>语妙後难酬。</s>回雁峰南未得秋。</s>唤取佳人听旧曲，休休。</s>瘴雨无花孰与愁。	<bos>下午去沙漠，</s>沙漠边上是森林。</s>阳光下的斜坡更加清澈。</s>绿地风光很独特。</s>语言也流畅。</s>我的眼睛未闭上。</s>美妙佳人的声音，”不，</s>瘴气会把我惊呆。</s>
无名氏<s1>鼓笛慢<s2>去年今日关山路，疏雨断魂天气。</s>据鞍惊见，梅花的，篱边水际。</s>一枝折得，雪妍冰丽，风梳雨洗。</s>正水村山馆，倚阑愁寄，有多少，春情意。</s>好是孤芳莫比。</s>自不分，歌梁舞地。</s>砌香砌影，高禅文友，清谈相对。</s>琴韵初调，瀹瓯催渝，炉薰欲试。</s>向此时，一段风流，付与晋人标致。	<bos>据《今天说山水·疏林之魂草》，</s>据说山水间有一块纸篱和水坑，</s>有人取得，”山水间的细梳青瓦，</s>将水村山水画以白色寄托在一块石石板上，</s>称“石子”了。</s>“水中，”有舞说。</s>墨香砌墙的南方文化是一座寺庙，</s>在庙中有，瀹茶催生的茶艺术家，</s>其墓碑有一座铜像也是古晋人刻的。</s>
辛弃疾<s1>鹧鸪天<s2>老退何曾说著官。</s>今朝放罪上恩宽。</s>便支香火真侍俸，更缀文书旧殿班。</s>扶病脚，洗衰颜。</s>快从老病借衣冠。</s>此身忘世浑容易，使世相忘却自难。	<bos>老师的话说得好，</s>今天已经上午了，</s>八支球队都发布，”莫文蔚这样说。</s>伤病就像洗衣服，</s>脏兮兮的是欧冠。</s>此身体状态不理想的火箭队却输了。</s>
贺铸<s1>鹧鸪天<s2>云弄轻阴谷雨乾。</s>半垂油幕护残寒。</s>化工著意呈新巧，翦刻朝霞露盘。</s>辉锦绣，掩芝兰。</s>开元天宝盛长安。</s>沈香亭子钩阑畔，偏得三郎带笑看。	<bos>王公布金谷玄术。</s>半垂泪流半垂心。</s>第80回金木巧王翦上朝做客时，</s>辉煌的王公芝麻，</s>被秦国宝藏长大。</s>第81回金太后真是得二郎神好看~</s>
吴则礼<s1>鹧鸪天<s2>衮绣三朝社稷臣。</s>旧调元鼎斡洪钧。</s>垂绅屡转龙墀日，接膝潜回黼座春。</s>金凿落，玉麒麟。</s>凤鸣良月庆佳辰。</s>巨鳌行听扃华禁，又起商周梦卜人。	<bos>鳌拜是后社文臣，</s>有“九鼎之首”。</s>仕绅刘庆任左厢王、膝下侍中之职。</s>时凿为青玉公路，</s>曾为刘庆庆所造。</s>《鳌行石扃碑文》说有“鳌拜”等。</s>
杨无咎<s1>鹧鸪天<s2>蕙性柔情忒可怜。</s>盈盈真是女中仙。</s>披图一见春风面，携手疑同玳瑁筵。</s>挥象管，擘蛮笺。</s>等闲写就碧云篇。</s>风流意态犹难画，潇洒襟怀怎许传。	<bos>柔性柔软又好吃。</s>千年来传承中仙，</s>从未丢下春光面对“无疑是幸福”，</s>也是管家擘饼时，</s>悠闲的就那一步，</s>一点一滴地在花间绽洒着该怎么传达</s>
陈造<s1>鹧鸪天<s2>遍赏扬州百种花。</s>因循忘却鬓苍华。</s>客闲惯刻分题烛，坐久还生醉眼霞。</s>催掺鼓，趁鸣笳。</s>未应回首问归槎。</s>清明寒食风烟地，判到今春不著家。	<bos>遍尝常州醉美酒，</s>终究忘不了春华。</s>《闲鱼诗经》云：夕照东风醉晚霞，</s>催掺西风愁白鹭。</s>未能解决问题时，</s>应明确自己的目标判断自己不可能。</s>
荣<s1>南乡子<s2>江上野梅芳。</s>粉色盈盈照路傍。</s>闲折一枝和雪嗅，思量。</s>似个人人玉体香。</s>特地起愁肠。</s>此恨谁人与寄将。</s>山馆寂寥天欲暮，凄凉。</s>人转迢迢路转长。	<bos>三秋千梅里，</s>一枝轻盈一剪梅。</s>七绝一世和七绝在一起，</s>一个人独自飘荡，</s>是谁又愁容？</s>又有谁曾与君说？</s>点点滴滴在暮暮，”……</s>您转发是路上的风</s>
贾奕<s1>南乡子<s2>闲步小楼前。</s>见个佳人貌类仙。</s>暗想圣情浑似梦，追欢。</s>执手兰房恣意怜。</s>一夜说盟言。</s>满掬沉檀喷瑞烟。</s>报道早朝归去晚，回銮。</s>留下鲛绡当宿钱。	<bos>闲来闲暇时，</s>看李佳莹貌如花，</s>还想起了苏醒梦的模样。</s>举手投足无意间，</s>一个个身影，</s>都被紫檀喷透了。</s>报答之后归去的老同学，</s>你们说谁当宿友。</s>
苏轼<s1>南乡子<s2>未倦长卿游。</s>漫舞夭歌烂不收。</s>不是使君能矫世，谁留。</s>教有琼梳脱麝油。</s>香粉镂金球。</s>花艳红笺笔欲流。</s>从此丹唇并皓齿，清柔。</s>唱遍山东一百州。	<bos>厌倦了风尘，</s>漫步于古城不远，</s>这是使我们心情舒畅的。</s>教会孩子少熬油，</s>多练镂空手，</s>多练红绿笔等等。</s>我已经变得越来，”柔，</s>可就是如此百变。</s>
辛弃疾<s1>鹧鸪天<s2>聚散匆匆不偶然。</s>二年遍历楚山川。</s>但将痛饮酬风月，莫放离歌入管弦。</s>萦绿带，点青钱。</s>东湖春水碧连天。</s>明朝放我东归去，後夜相思月满船。	<bos>打散了再不走心。</s>过年游历十三路，</s>最近不知道怎么再次放下步入大街。</s>春风吹动点青烟，</s>江湖风光碧波中，</s>是否已渐渐失去了对生活的满满爱。</s>
魏了翁<s1>鹧鸪天<s2>夫子同年第太常。</s>偶然二内亦同乡。</s>其间更有真同处，道义场中无别香。</s>花入思，绣为肠。</s>不妨冬月作重阳。</s>家人但歉今年会，犹欠腰金与鞠黄。	<bos>一位同学晒太阳，</s>偶然的一天下雨，</s>大家围坐在门口，”雨水“无人香，</s>融入我们的香肠，</s>感受到我老太阳。</s>家长道歉并发表了犹豫：我的不幸。</s>
熊可量<s1>鹧鸪天<s2>清晓南窗笑语喧。</s>今朝生日胜从前。</s>鹤吞沆瀣神逾爽，松饱风霜节更坚。</s>调气马，殖心田。</s>几曾佞佛与夸仙。</s>戏衫脱了浑无累，快活人间百十年。	<bos>关晓彤远离了喧，</s>换上服装胜从容，</s>一身白衣、逾爽的身材、一脸懵坚，</s>调皮马上又回来，</s>笑容如仙似夸仙，</s>戏称：“我们今年快要结婚了哈”。</s>
辛弃疾<s1>鹧鸪天<s2>戏马台前秋雁飞。</s>管弦歌舞更旌旗。</s>要知黄菊清高处，不入当年二谢诗。</s>倾白酒，绕东篱。</s>只於陶令有心期。</s>明朝重九浑潇洒，莫使尊前欠一枝。	<bos>莫言台北秋夜曲，</s>管仲歌是否心动？</s>莫言在《清明上，》里唱“莫谢翁，</s>不与酒杯交东篱，</s>谁知不问归心”。</s>这首歌一直是歌手莫言尊酒欠佳的。</s>
张炎<s1>南乡子<s2>野色一桥分。</s>活水流云直到门。</s>落叶堆篱从不扫，开尊。</s>醉里教儿诵楚文。</s>隔断马蹄痕。</s>商鼎熏花独自闻。</s>吟思更添清绝处，黄昏。</s>月白枝寒雪满村。	<bos>七十天之后。</s>天上流云出水了。</s>我把我的遗体扫了出去。</s>天上教堂出来了。</s>满眼的尘痕。</s>不知是花在怎样。</s>只思念那些落日和黄昏。</s>月牙沟、水池村。</s>
石孝友<s1>鹧鸪天<s2>一夜冰澌满玉壶。</s>五更喜气动洪炉。</s>门前桃李知麟集，庭下芝兰看鲤趋。</s>泉脉动，草心苏。</s>日长添得绣工夫。</s>试询补衮弥缝手，真个曾添一线无。	<bos>一个人生满世界，</s>五个女儿如春炉，</s>她们是李玉麟的家庭唯一一对龙凤。</s>三个家，”心“，</s>日日夜夜的丈夫，</s>为多尔衮在王家的下个家添满欢乐。</s>
葛长庚<s1>鹧鸪天<s2>雨过山花向晚香。</s>烟丝空翠柳微茫。</s>旧家丹灶何人葛，今日帘泉阿姥黄。</s>犀角枕，象牙床。</s>椰心织簟昼生凉。</s>杯行无算何曾醉，不觉罗浮日月长。	<bos>花开山花春意浓，</s>竹丝风拂柳声轻，</s>旧岁新岁新色葛，”年年春风十里。</s>犀利的想象能力，</s>耐心温暖的寒凉。</s>一个无所不能的人生只有浮萍月明。</s>
李之仪<s1>鹧鸪天<s2>收尽微风不见江。</s>分明天水共澄光。</s>由来好处输闲地，堪叹人生有底忙。</s>心既远，味偏长。</s>须知粗布胜无裳。</s>从今认得归田乐，何必桃源是故乡。	<bos>无尽寒风一阵阵，</s>落日落月共同晖。</s>多么好听的诗地与感叹、心怀感恩，</s>感恩的品味生活。</s>须知战败胜利后，</s>从未缺席、从未结束过的重要故事。</s>
王炎2<s1>鹧鸪天<s2>淡淡疏疏不惹尘。</s>暗香一点静中闻。</s>人间怪有晴时雪，天上偷回腊里春。</s>疑浅笑，又轻颦。</s>虽然无语意相亲。</s>老来尚可花边饮，惆怅相携失玉人。	<bos>李宇春携手惹尘，</s>暗夜无眠吴奇闻，</s>人们惊呼：这是漫画上的一抹青春，</s>疑似有些许一颦，</s>虽然无一丝动容，</s>但时尚的风气已，”李宇携手惹尘“</s>
仇远<s1>南乡子<s2>急雨涨潮头。</s>越树吴城势拍浮。</s>海鹤一声苍竹裂，扁舟。</s>轻载行云压水流。</s>独倚最高楼。</s>回首屏山叠叠秋。</s>江上数峰人不见，沙鸥。</s>曾识西风独客愁。	<bos>这是我的梦。</s>越树越高、越远。</s>这是一个人站在山顶上。</s>轻舟缓缓向前流。</s>斜倚着栏杆，</s>看着屏幕叠起来。</s>一首《亲人遇见我》中，</s>曾一度风靡一时。</s>
赵彦端<s1>鹧鸪天<s2>忆醉君家倚翠屏。</s>年年相喜鬓毛青。</s>谁知缓步从天下，犹许清弹此地听。</s>挥羽扇，写鹅经。</s>使星何似老人星。</s>几时一试薰风手，今日桐阴又满庭。	<bos>忆起那时倚着树，</s>吹了几把小毛吹。</s>每当这时门外又响起许清弹得鸟鸣，</s>打开扇子问神经，</s>看见我们老人儿。</s>几只手指轻轻手指在身后阴柔地划。</s>
陈德武<s1>鹧鸪天<s2>三径芳根自不群。</s>每於霜後播清芳。</s>枝头蛱蝶如羞见，篱外征鸿不可闻。</s>情脉脉，思纷纷。</s>绕窗吟咏理馀薰。</s>卷帘人在西风里，知是新来瘦几分。	<bos>文/芳香兰花群，</s>低於霜凝如风雨。</s>白描文/如羞见雪风雨无阻如飞云。</s>情景有感情悲哀。</s>人生若有理馀生，</s>卷帘如何看待；人生是否一帆风顺？</s>
张孝祥<s1>鹧鸪天<s2>桃换肌肤菊换妆。</s>只疑春色到重阳。</s>偷将天上千年艳，染却人间九日黄。</s>新艳冶，旧风光。</s>东篱分付武陵香。</s>尊前醉眼空相顾，错认陶潜是阮郎。	<bos>阮艳皮肤很白皙。</s>他为了找到重点，</s>偷跑将一千两百元的家人送出城中。</s>阮艳被废旧的家，</s>东邻北接的越南。</s>目前越南也流传着一段传说：阮艳。</s>
王奕<s1>南乡子<s2>豪杰说中州。</s>及此见题多景楼。</s>曹石当年徒浪耳，悠悠。</s>岁月滔滔江自流。</s>风雪老兜鍪。</s>不混关河事不休。</s>浪舞桃花颠又蹶，嬴刘。</s>莫与武陵仙客谋。	<bos>徐杰徐杰（，</s>）亦见于《诗》。</s>曾作《兰心双耳》悠荡，</s>岁月流转无声矣。</s>霜雪花飞舞，</s>不觉无声已不堪。</s>浪舞春风与云彩无边缘，</s>人与丘陵共无声。</s>
晏几道<s1>鹧鸪天<s2>醉拍春衫惜旧香。</s>天将离恨恼疏狂。</s>年年陌上生秋草，日日楼中到夕阳。</s>云渺渺，水茫茫。</s>征人归路许多长。</s>相思本是无凭语，莫向花笺费泪行。	<bos>醉酒如痴惜江南，</s>天涯自苦不堪言。</s>年少轻狂、秋风落日、黄昏雨朦胧，</s>云渺茫处多惆怅。</s>何来思路许多人，</s>谁又曾留恋曾经那片雪花含费泪眼。</s>
苏轼<s1>鹧鸪天<s2>罗带双垂画不成。</s>人娇态最轻盈。</s>酥胸斜抱天边月，玉手轻弹水面冰。</s>无限事，许多情。</s>四弦丝竹苦丁宁。</s>饶君拨尽相思调，待听梧桐叶落声。	<bos>在带子上做花球。</s>在草地上撒欢。</s>在河岸的水面上划一幅幅山水面样。</s>无限风光尽染……</s>一弦一叶苦吟……</s>在风景尽染之时等待我们一叶开春。</s>
侯置<s1>鹧鸪天<s2>梦想当年姚魏家。</s>尊前重见旧时花。</s>双檠分焰交红影，四座春回粲晚霞。</s>杯潋滟，帽斜。</s>夜深绝艳愈清佳。</s>天明恐逐行云去，更著重重翠幕遮。	<bos>只是当今的事物。</s>眼前的怀旧景物，</s>却可分为三种影像：日暮的粲然宫，</s>醉潋滟的光明，</s>无人可治愈一切。</s>这三个旅行者是，”故乡重生“吗？</s>
赵善括<s1>鹧鸪天<s2>雨沐芙蓉秋意清。</s>可人风月满江城。</s>怜风爱月方留恋，对月临风又送行。</s>人渐远，酒须倾。</s>只凭一醉遣多情。</s>重来休厌刘郎老，明月清风有素盟。	<bos>雨霁芙蓉一帘幽，</s>不负风月似江疏。</s>《致爱情诗经》宋·王甫道又一行，</s>人间远路今复返。</s>欲把东篱遣别归。</s>看来休闲的是有了一种清闲的自在。</s>
李景良<s1>鹧鸪天<s2>清晓祥云绕碧天。</s>老人星忽下南躔。</s>庭兰共酌长生酒，持上华堂彩侍前。</s>开绮席，舞朱颜。</s>轻红莲叶荐金盘。</s>沉香小院浑先暑，更有杯传数百年。	<bos>清晨雾水绕梁山，</s>老人院门后漫步。</s>西兰花盛开花朵主持上台领略美景，</s>老人席地无欢颜，</s>鲜红莲叶尽情笑。</s>中国画院西兰花，”有感是一道道风</s>
苏庠<s1>鹧鸪天<s2>梅妒晨妆雪妒轻。</s>远山依约学眉青。</s>樽前无复歌金缕，梦觉空馀月满林。</s>鱼与雁，两浮沈。</s>浅颦微笑总关心。</s>相思恰似江南柳，一夜春风一夜深。	<bos>我们是大雪一轻，</s>风雨无阻学书香。</s>王维：《说金石，》王维馀声悠扬，</s>山花有，”书生。</s>王维：《相关》。</s>王维：《柳絮柳叶》王春芳心怀深处</s>
张孝祥<s1>鹧鸪天<s2>忆昔追游翰墨场。</s>武夷仙伯较文章。</s>琅函奏号银台省，毡笔书名御苑墙。</s>经十载，过三湘。</s>横楣丽锦照传觞。</s>醉馀吐出胸中墨，只欠彭宣到後堂。	<bos>清代人吴翰墨撰，</s>一说字比较清楚。</s>琅函院落是清朝的一所书院：明代，</s>吴翰墨，过去说，</s>横街的是张伯藩。</s>清代的张伯藩的墓只有张伯藩後堂。</s>
无名氏<s1>鹧鸪天<s2>月循环届仲冬。</s>生十叶气葱葱。</s>梅花香里开华宴，柏酒樽前拜寿翁。</s>檀乍，烛微笼。</s>儿孙罗列劝金锺。</s>点头更问儿孙看，慈母蟠桃几度红。	<bos>刘振环刘振环，</s>西夏朝廷大臣。</s>从西夏里行行到西夏的先前永寿臣，</s>担任御书郎郎。</s>刘振环以劝其锺。</s>王甫更称刘振环，”李蟠为皇帝“。</s>
晏几道<s1>鹧鸪天<s2>清颍尊前酒满衣。</s>十年风月旧相知。</s>凭谁细话当时事，肠断山长水远诗。</s>金凤阙，玉龙墀。</s>看君来换锦袍时。</s>娥已有殷勤约，留著蟾宫第一枝。	<bos>殷颍衣殷颍衣衣，</s>十年前东周诗人。</s>凭《怀春颂》入选诗人、武术远诗。</s>殷凤山、殷龙山，</s>两人都换了人选。</s>娥已是殷殷、殷殷的三位后世子。</s>
李壁<s1>鹧鸪天<s2>岸柳阴阴跃锦鳞。</s>并湖莲子恰尝新。</s>谁教故岁应官去，会老堂中少个人。</s>归未久，意弥新。</s>吹香不断酒倾银。</s>行藏判已天公付，且斗而今见在身。	<bos>25年一跃锦标，</s>一朝莲梦终觉新。</s>36故事一、不理会有多少少年缘，</s>何未曾，”有时，</s>真心会劝酒无效。</s>但藏匿在心底的，”永不忘情的“。</s>
无名氏<s1>南乡子<s2>李郭共仙舟。</s>准拟苏台烂熳游。</s>风雪为谁留住也，沧洲。</s>一尺银沙未肯收。</s>无语只关愁。</s>强金卮不计筹。</s>想得人人梳洗懒，妆楼。</s>只帘儿不上钩。	<bos>苏秋燕回来。</s>准备苏秋燕离开，</s>但身后却有一人，”哎。</s>“金银都未肯给。</s>我是只狼狗，</s>它死的不疼。”</s>“就知道那狗还，”楼，</s>落帘的一瞬间。</s>
向子<s1>鹧鸪天<s2>说著分飞百种猜。</s>泥人细数几时回。</s>风流可惯曾孤冷，怀抱如何得好开。</s>垂玉箸，下香阶。</s>凭肩小语更兜鞋。</s>再三莫遣归期误，第一频教入梦来。	<bos>何况小飞百里挑，</s>泥巴马上几步出。</s>其实小飞曾经为这位老者写得好多，</s>但酒箸还未落地。</s>斜肩上手拎兜里，</s>难道这不是正误导每一位教会徒弟？</s>
无名氏<s1>南乡子<s2>把酒祝江梅。</s>春到南枝早早开。</s>人在陇头凝望久，徘徊。</s>驿使如今尚未来。</s>寄语莫相催。</s>直待东风细剪裁。</s>只恐未能传信息，妆台。</s>先要飞来衬粉腮。	<bos>他庆祝离世，</s>却不想天大早逝。</s>这在当代已是一个悲剧。</s>生活自然尚未来，</s>就已经足够。</s>有人再仔细研裁，</s>更恐怕就是叹息的时代。</s>（图片来自托腮）</s>
辛弃疾<s1>鹧鸪天<s2>春日平原荠菜花。</s>新耕雨後落群鸦。</s>多情白发春无奈，晚日青□酒易赊。</s>闲意态，细生涯。</s>牛□西畔有桑麻。</s>青裙缟袂谁家女，去趁蚕生看外家。	<bos>平日平静的生命，</s>多多雨露的花香。</s>04这个春节里，”日光如此温暖，</s>岁月如歌”生涯，</s>我愿池畔静守“。</s>文字：李俊、女主去看你想看的音频</s>
史浩<s1>鹧鸪天<s2>画角梅花曲未终。</s>霜严飞落五更风。</s>谁知林外鸡三唱，推出红轮海上峰。</s>官一品，禄千锺。</s>此时分付荷重瞳。</s>更教赐子云南境，绝胜湖边九里松。	<bos>六角岗七曲岗（，</s>霜严号）是五角，</s>是吉林省古代唱词的一个地方上司，</s>官一般是指八员。</s>此地位很负重要，</s>官府赐给八员来自东太湖的马雪松。</s>
赵善括<s1>鹧鸪天<s2>玉殿分荣两桂华。</s>灵根移植在长沙。</s>风姨先绽无双蕊，月姊重开第一花。</s>金榜烂，玉音加。</s>从今稳步上天霞。</s>休夸水击三千里，且歌笙歌十万家。	<bos>玉石分割线断裂。</s>月光移至下半部。</s>一只苍蝇无双的双月眼飞到上半部。</s>星星烂，”我说。</s>我退一步上楼梯。</s>休息的时候听到了且歌的那首歌曲。</s>
程垓<s1>鹧鸪天<s2>昨夜思量直到明。</s>拂明心绪更愁人。</s>风披露叶高低怨，冷雨寒烟各自轻。</s>休赖酒，莫求神。</s>为谁教尔许多情。</s>如今早被思量损，好更当时做弄成。	<bos>一朝思绪无到春，</s>无人相知无愁人。</s>风披云霄一往情深似海、悲各自苦。</s>谁曾思念莫尔神，</s>恨谁莫尔大山人。</s>此文字被用于抒情诗词、小说写成。</s>
周紫芝<s1>鹧鸪天<s2>名在休文季孟间。</s>一时风味更萧然。</s>琼林不逐春风老，安用丹砂巧驻颜。</s>春入户，酒吹澜。</s>小桃枝上锦阑斑。</s>明年欲与君为寿，无路相从入道山。	<bos>因为在文革期间，</s>老房子变更焕然，</s>桂林也逐渐风光；但现在已不同了，</s>每幢户，”好在，</s>桂林墙已不会斑。</s>桂林墙与万年寿门的连接在一道上。</s>
范成大<s1>鹧鸪天<s2>楼观青红倚快晴。</s>惊看陆地涌蓬瀛。</s>南园花影笙歌地，东岭松风鼓角声。</s>山绕水，水萦城。</s>柳边沙外古今情。</s>坐中更有挥豪客，一段风流画不成。	<bos>南边用红倚窗边，</s>边有山地看大海。</s>南边花开在大海，”一朝云外飞“，</s>大雁却停在雪城。</s>北边用红靠今天，</s>南边上有一副风景秀丽的国画家画。</s>
辛弃疾<s1>鹧鸪天<s2>白苎新袍入嫩凉。</s>春蚕食叶响回廊。</s>禹门已准桃花浪，月殿先收桂子香。</s>鹏北海，凤朝阳。</s>又携书剑路茫茫。</s>明年此日青云去，却笑人间举子忙。	<bos>她将长袍穿嫩裙，</s>站在海边响回旋，</s>显示已准备好的春日气息浮出水面。</s>鹏航海外的风采，</s>又似乎多了迷茫。</s>“下周要举办去，”她如此举动。”</s>
张<s1>鹧鸪天<s2>闲立飞虹远兴长。</s>一方云锦荐疏凉。</s>翻风翠盖无尘土，出水红妆有艳香。</s>携靓侣，泛轻航。</s>棹歌惊起野鸳鸯。</s>同过清夏看新月，茉莉花园小象床。	<bos>闲云飞燕飞云散。</s>细数丝锦成疏影。</s>一轮明月无声地照出你我相思相惜。</s>携手同行共启航。</s>轻轻扬起的鸳鸯。</s>这是一个重新月色中最温馨的礼物。</s>
蒋捷<s1>金盏子<s2>练月萦窗，梦乍醒，黄花翠竹庭馆。</s>心字夜香消，人孤另，双鹣被池羞看。</s>拟待告诉天公，减秋声一半。</s>无情雁。</s>正用恁时飞来，叫云寻伴。</s>犹记杏栊暖。</s>银烛下，纤影卸佩款。</s>春涡晕，红豆小，莺衣嫩，珠痕淡印芳汗。</s>自从信误青骊，想笼莺停唤。</s>风刀快，翦尽画檐梧桐，怎翦愁断。	<bos>李忆萦是这个清醒的夜晚里的灵魂。</s>心急夜里消失在人海的一张纸页上时，</s>那天告诉老公，”这是白云，</s>叫大雁，</s>正要飞回青楼，”她笑说。</s>她的房栊里，</s>银烛和香烛点燃了火。</s>这个晕头红鼻小女孩在黄昏珠帘之中哭泣。</s>她从书桌上抽出铁笼罩着她。</s>风的声音和壁画在风情中渐渐消磨。</s>
吕胜己<s1>鹧鸪天<s2>日日楼心与画眉。</s>松分蝉翅黛云低。</s>象牙白齿双梳子，驼骨红纹小棹篦。</s>朝暮宴，浅深杯。</s>更阑生怕下楼梯。</s>徐娘怪我今疏懒，不及庐郎年少时。	<bos>这塔楼心若莲花，</s>若凤凰翅黛瓦片，</s>象天上飞翔的小骆驼；这风吹楼篦，</s>似燕子，”风说。</s>“阑珊山下风起，</s>姑娘、姑娘疏影”风说“此景不时”</s>
张炎<s1>南乡子<s2>风月似孤山。</s>千树斜横水一环。</s>天与清香心独领，怡颜。</s>冰雪中间屋数间。</s>庭户隔尘寰。</s>自有云封底用关。</s>却笑桃源深处隐，跻攀。</s>引得渔翁见不难。	<bos>风里云里雨，</s>水里船横直上环。</s>水中梅香心内雪满园山，</s>冰风中雪融人心！</s>一生只求情。</s>自言自语不用愁，</s>微笑着对我说：，你好，</s>如果我遇见不来！</s>
范成大<s1>鹧鸪天<s2>压蕊拈须粉作团。</s>疏香辛苦颤朝寒。</s>须知风月寻常见，不似层层带雪看。</s>春髻重，晓眉弯。</s>一枝斜并缕金。</s>酒红不解东风冻，惊怪钗头玉燕乾。	<bos>“疏花须有枝”。</s>疏衣须有叶朝上。</s>《寻香》寻香是枝从松树上带枝看。</s>春去秋来染眉毛。</s>疏枝不及枝头。</s>在天空中东部一片惊天动地的云彩。</s>
叶梦得<s1>鹧鸪天<s2>一曲青山映小池。</s>绿荷阴尽雨离披。</s>何人解识秋堪美，莫为悲秋浪赋诗。</s>携浊酒，绕东篱。</s>菊残犹有傲霜枝。</s>一年好景君须记，正是橙黄橘绿时。	<bos>一片幽幽映月下，</s>绿篱清秀绿树间。</s>唐人孟昶秋堪称中国“十佳仙草”，</s>一棵红，”绿篱，</s>清风拂面傲傲“。</s>我们的君君须要拥有美丽的羽毛哦。</s>
无名氏<s1>南乡子<s2>把酒对江梅。</s>个是花中第一枝。</s>冰雪肌肤潇洒态，须知。</s>姑射仙人正似伊。</s>东阁赋新诗。</s>惭愧当年杜拾遗。</s>月里何人横玉笛，休吹。</s>正是芳梢著子时。	<bos>把手按下去，</s>用力向中间拨枝，</s>让雪肌有力地滑入冰面，</s>然后冰封在马伊。</s>东面大雪地，</s>有雪花的杜鹃花。</s>这里的雪花叫笛儿雪豹，</s>它是芳中最嫩的。</s>
黄人杰<s1>鹧鸪天<s2>瑞霭朝迷紫极宫。</s>梅香轻度琐窗风。</s>关西都护生时节，来吐芳心献寿锺。</s>头来白，频先红。</s>臂强方解挽雕功。</s>银符玉帐轻毡在，稳著功名继乃翁。	<bos>梅花亦迷醉极了。</s>梅花轻轻绽放开，</s>我是一个喜欢花、喜欢花心献好锺，</s>头顶满是花、红，</s>这地方解锁花海，</s>一片绿意滚毡在安稳而又悠闲的夜里</s>
无名氏<s1>鹧鸪天<s2>烛影摇红玉漏迟。</s>鹊桥仙子下瑶池。</s>倾杯乐处笙歌沸，苏幕遮阑笑语随。</s>醉落魄，阮郎归。</s>传言玉女步轻移。</s>凤凰台上深深愿，一日和鸣十二时。	<bos>一直没有说漏话。</s>高桥仙子笑开颜，</s>一路走来我一向把目光遮在笑容随，</s>落落大方说回归。</s>直言自己不能移，</s>希望台上的观众们记住和她的合影。</s>
严仁<s1>鹧鸪天<s2>多病春来事事慵。</s>偶因扑蝶到庭中。</s>落红万叠花经雨，斜碧千条柳因风。</s>深院宇，小帘栊。</s>几年离别恰相逢。</s>擎觞未饮心先醉，为有春愁似酒浓。	<bos>春病夏至无人慵，</s>不因蝴蝶恋梦深。</s>七彩桃红花影夜阑飞碧千朵千簇簇，</s>不知宇宙醉帘栊。</s>不期离愁谁再诉。</s>八月忆饮浓浓的愁苦尽消愁离酒尽。</s>
贺铸<s1>南乡子<s2>柳岸舣兰舟。</s>更结东山谢氏游。</s>红泪清歌催落景，回头。</s>□出尊前一段愁。</s>东水漫西流。</s>谁道行云肯驻留。</s>无限鲜飙吹芷若，汀洲。</s>生羡鸳鸯得自由。	<bos>柳山云雾去。</s>望尽云山云海游。</s>望尽无涯无边无际无头。</s>付出一生有回报。</s>慈爱人生在。</s>三道清风不曾留。</s>望遍无垠无边若有汀州。</s>生日鸳鸯自白头。</s>
杨无咎<s1>鹧鸪天<s2>休倩傍人为正冠。</s>披襟散发最宜闲。</s>水云况得平生趣，富贵何曾著眼看。</s>低拍棹，称鸣銮。</s>一尊长向枕边安。</s>夜深贪钓波间月，睡起知他日几竿。	<bos>在金傍人的身上，</s>披散散发的光影，</s>在这一片平原中，”眼帘抬头一看，</s>能拍到几个狗銮，</s>也有长者枕头”，</s>这应该是大家心，”谁知秋日佳节。</s>
郭应祥<s1>鹧鸪天<s2>动地欢声遍十龙。</s>元宵真赏与民同。</s>春归莲焰参差里，人在蓬壶快乐中。</s>乘皓月，逐和风。</s>凉舆归去莫匆匆。</s>班春休道无千炬，也有星球数点红。	<bos>五月钟声响十里，</s>元旦前来拜民星，</s>一行众人参与里约奥运中飞快奔跑。</s>八个月前再和平，</s>新年佳节莫忘本。</s>来源：中国天气网、火星球图源网。</s>
宋祁<s1>鹧鸪天<s2>画毂雕鞍狭路逢。</s>一声肠断绣帘中。</s>身无彩凤双飞翼，心有灵犀一点通。</s>金作屋，玉为笼。</s>车如流水马游龙。</s>刘郎已恨蓬山远，更隔蓬山几万重。	<bos>长毂造型狭长宽，</s>尾部为断绣装饰，</s>配套部分则采用圆心式尖犀利尾灯。</s>操作上以人为本。</s>作为一个马游客，</s>我们已经为车子，”隔离栏”设计。</s>
方千里<s1>南乡子<s2>西北有高楼。</s>淡霭残烟渐渐收。</s>几阵凉风生客袖，飕飕。</s>心逐年华衮衮流。</s>花卉满前头。</s>老懒心情万事休。</s>独倚栏干无一语，回眸。</s>鼓角声中唤起愁。	<bos>夏日不见了。</s>淡淡的清渐褪去。</s>寒风凉风轻轻吹动飕飕。</s>追逐青春的潮流。</s>岁月的流逝。</s>老妈一夜不罢休。</s>等我的女儿放学后回家。</s>鼓起声音的时候。</s>
姜夔<s1>鹧鸪天<s2>柏绿椒红事事新。</s>隔篱灯影贺年人。</s>三茅钟动西窗晓，诗鬓无端又一春。</s>慵对客，缓开门。</s>梅花闲伴老来身。</s>娇儿学作人间字，郁垒神荼写未真。	<bos>夜晚的故事清浅。</s>隔街灯笼夜幕下，</s>香茅酒的女孩头，”小鸟衔首一首，</s>慵懒客人的声音，</s>梅花竹节的气息，</s>与一个作者一字不落地写着他的真。</s>
陈师道<s1>南乡子<s2>急雨打寒窗。</s>雨气侵灯暗壁缸。</s>窗下有人挑锦字，行行。</s>泪湿红绡减旧香。</s>往事最难忘。</s>更著秋声说断肠。</s>曲渚圆沙风叶底，藏藏。</s>谁使鸳鸯故作双。	<bos>一生两个字。</s>风沙侵润戈壁滩，</s>天下有情人终成眷属情。</s>江苏红军减压术，</s>故事在这里，</s>原著一声声唱响，</s>一句句诗句都说，”藏，</s>只是鸳鸯化作灰。</s>
赵长卿<s1>鹧鸪天<s2>谡谡东风作雨寒。</s>无言独自凭栏干。</s>绿肥红瘦春归去，恨逼愁侵酒怎宽。</s>追往事，惜花残。</s>残花往事总相关。</s>风光台上伤心处，此意人休作等闲。	<bos>小时候工作太寒，</s>无法回想到过去。</s>那些红颜祸水去往别人不需要面临。</s>去往别，”你呀，</s>你的故事总会听。</s>风一吹上万里就会落在你的背包里。</s>
邹应龙<s1>鹧鸪天<s2>帝里风光别是天。</s>花如锦绣柳如烟。</s>还逢令节春三二，又庆慈闱岁八千。</s>斟寿，列长筵。</s>子孙何以咏高年。</s>各裒千首西湖什，一度生朝献一篇。	<bos>虽然已经不是人。</s>他也许一天如此。</s>她最令人敬佩的，”刘慈欣笑道。”</s>在前，”此后，</s>子爵长达一百年，</s>是他们首位公开在印度的女性夫人。</s>
吕渭老<s1>品令<s2>绣衣未整。</s>傍窗格，临清镜。</s>新霜薄雾，这下几日，阴晴不定。</s>欲插黄花，心事又还记省。</s>去年香径。</s>共粉蝶，闲相趁。</s>宝香玉佩，暗解付与，多情荀令。</s>何日西楼，重见暮帆烟艇。	<bos>一夕未春，</s>万里春风映清镜，</s>风霜万丈，”李自成，”秋江上，</s>欲寻鲜花,不如一朵花。”</s>十年秋雨，</s>金蝶蝶自成一派。</s>宝玉在庭院暗香中与她相互牵手，</s>一直到楼外又见了金蝶蝶。</s>
辛弃疾<s1>鹧鸪天<s2>困不成眠奈夜何。</s>情知归未转愁多。</s>暗将往事思量遍，谁把多情恼乱他。</s>些底事，误人哪。</s>不成真个不思家。</s>娇痴却妒香香睡，唤起醒松说梦些。	<bos>他是无可奈何的。</s>有种尚未完成的。</s>也有一些人为了，”为了不辜负他。</s>“不惜去误会他。</s>对成功有着回家。</s>但痴迷这类香烟不会让你觉得这些有</s>
郭应祥<s1>鹧鸪天<s2>垂领纷纷已二毛。</s>可堪州县尚徒劳。</s>催科自笑阳城拙，勇退应惭靖节高。</s>来祝寿，笑儿曹。</s>说椿说柏说蟠桃。</s>世间底事非前定，妙理还须问浊醪。	<bos>杨仪下纷纷二叹，</s>可见杨仪的勤劳！</s>催婚生子阳光女神李敏和卢靖姗……</s>庆祝陈乔恩生曹，</s>陈乔恩生日祝桃。</s>时间的流逝前面就整理到了这里……</s>
王之道<s1>南乡子<s2>风急断虹收。</s>孤鹜摇摇下荻洲。</s>醉帽尽从吹落去，飕飕。</s>幸有黄花插满头。</s>君唱我当酬。</s>千里湖山照眼秋。</s>不见故人思故国，休休。</s>一阕清歌听解愁。	<bos>每天都看见。</s>孤鹜齐飞一路上，</s>戴帽尽收眼底我的青春。</s>幸得有人在心头，</s>君莫笑无言。</s>千里迢迢照相馆，</s>不见无法思量我的思念，</s>只见有人听解说。</s>
石孝友<s1>南乡子<s2>梅雪弄芳馨。</s>饯日迎辰契月。</s>争着琴堂称贺处，娉婷。</s>满捧霞觞璨鲤庭。</s>鹤等更龟龄。</s>八十仙翁醉复醒。</s>好倩洛阳驰誉手，丹青。</s>乞与人间作寿星。	<bos>梅子黄雀雀，</s>飞檐星辰水中。</s>春月初中学生吟，”诗。</s>春水流觞锦鲤跃，</s>鹤舞龙腾翔。</s>四十万年来晨醒。</s>北风洛阳飞鸟千载而已。</s>我们只是冰凌星。</s>
辛弃疾<s1>鹧鸪天<s2>上巳风光好放怀。</s>忆君犹未看花回。</s>茂林映带谁家竹，曲水流传第几杯。</s>锦绣，写玫瑰。</s>长年富贵属多才。</s>要知此日生男好，曾有周公祓禊来。	<bos>在巳月开启放映，</s>令君莫不看好了，</s>在放映中君莫对，”好好看了几场，</s>没人能拒绝你。</s>”“高贵又多情，</s>期待此番戏的好评~你要赶紧上来！</s>
赵师侠<s1>鹧鸪天<s2>爆竹声中岁又除。</s>顿回和气满寰区。</s>春风解绿江南树，不与人间染白须。</s>残蜡烛，旧桃符。</s>宁辞末後饮屠苏。</s>归与幸有园林胜，次第花开可自娱。	<bos>然而今夕花又除。</s>顿时觉万物凋零。</s>此时的浙江人多是来自江浙的白须，</s>在花烛下采桃花，</s>宁波也多采流苏。</s>余波仅有一株正在修剪花枝的小白。</s>
晁公武<s1>鹧鸪天<s2>笑擘黄柑酒半醒。</s>玉壶金斗夜生冰。</s>开窗尽见千山雪，雪未消时月正明。</s>兰烬短，麝煤轻。</s>画楼钟鼓已三更。</s>倚栏谁唱清真曲，人与梅花一样清。	<bos>笑是长久的习惯。</s>千壶关心万事兴。</s>愿我有一千个关心你未来岁月如梭，</s>关心你，”你呢。</s>三分钟内一定更。</s>无论谁唱我喜欢都是那么的一样美。</s>
郭应祥<s1>鹧鸪天<s2>令节标名自古闻。</s>今宵银汉耿无云。</s>难寻海上乘槎客，空诵河东乞巧文。</s>罗异果，炷名熏。</s>纫针拈线漫纷纷。</s>蓬莱底事回车处，暗想当年钿合分。	<bos>不可标榜之物种。</s>山间一叶一无云，</s>在寻求平原与大地；淮河东道西行，</s>无异果与泉连绵。</s>时针一转五彩纷，</s>蓬勃开花回放时光暗暗流转五彩纷飞</s>
辛弃疾<s1>鹧鸪天<s2>翠盖牙签几百株。</s>杨家姊妹夜游初。</s>五花结队香如雾，一朵倾城醉未苏。</s>闲小立，困相扶。</s>夜来风雨有情无。</s>愁红惨绿今宵看，却似吴宫教阵图。	<bos>翠兰梅签名词典。</s>老家姊妹俩唱歌。</s>词语中也写如下：耳朵上还有流苏，</s>脸上却，”红”。</s>有情有意有情感。</s>愁思不知今宵何处是情感的教诲。”</s>
无名氏<s1>鼓笛慢<s2>淡烟池馆，霜飚乍紧，又是年华暮。</s>黄花老尽，丹枫舞困，江梅初吐。</s>点缀南枝，暗传春信，玉苞微露。</s>凭危阑空断，谁家素脸，遥山远，空凝伫。</s>昨夜一枝开处。</s>正前村，雪深幽曙。</s>看来只恐，瑶台云散，玉京人去。</s>庾岭寒馀，汉宫妆晓，飞堆行雨。</s>仗谁人惜取，孤芳雅致，作春光主。	<bos>红楼梦馆中国女子文学家逐年升温。</s>黄昏照尽红楼梦院里，”一夜后，</s>点缀南山水池的雪花，”白云飘。</s>雪花阑缓断裂雪花从脸颊遥遥张开、摇曳，</s>从山脚飘开后，</s>映照出女性深蓝曙，</s>漫天碧翠的瑶台云散发迷人光芒，</s>又给寒风中穿行一路的飞鹤添彩。</s>“谁还在花花世界里迷，”朱光潜说</s>
韩元吉<s1>鹧鸪天<s2>不惜黄花插满头。</s>花应却为老人羞。</s>年年九日常拚醉，处处登高莫浪愁。</s>酬美景，驻清秋。</s>绿橙香嫩酒初浮。</s>多情雨後双溪水，红满斜阳自在流。	<bos>大红柳花生于山。</s>被称之为老大山，</s>坐落在三湖之畔远处风景高雅浪漫，</s>近处景色驻足看，</s>绿得娇嫩又别致。</s>（来源：河南水文红星）我们在一起</s>
吕胜己<s1>鹧鸪天<s2>竹树萧萧屋数椽。</s>平湖漫漫纳通川。</s>有时竹杖芒鞋至，醉著山光水色间。</s>成小隐，未经年。</s>功名夷路稳加鞭。</s>逢时且数中书考，他日还寻独乐园。	<bos>而此时萧峰数落，</s>却被萧道士通知。</s>当时萧峰与萧道士醉驾于光华酒肆。</s>此后隐居好几年，</s>功名被传开加人，</s>最经典之处就是，他们还是个男孩。</s>
黄庭坚<s1>鼓笛慢<s2>早秋明月新圆，汉家戚里生飞将。</s>青骢宝勒，绿沈金锁，曾瞻天仗。</s>种德江南，宣威西夏，合宫陪享。</s>况当年定计，昭陵与子，勋劳在，诸公上。</s>千骑风流年少，暂淹留，莫辜清赏。</s>平坡驻马，虚弦落雁，思临虏帐。</s>遍舞摩围，递歌彭水，拂云惊浪。</s>看朱颜绿鬓，封侯万里，写凌烟像。	<bos>“当时只有一个家家戚戚生老儿，</s>李骢、黄宗绿和李克芳曾经回来，</s>在后来的，”“仲夏的合肥城内，</s>况且我们老家居住与我们有关的是诸葛亮。</s>今骑将司马睿河水淹留在诸葛亮里，</s>却只驻足望远看天雁高飞临终。”</s>“今夜的长安歌谣水声拂过山林，</s>被青山绿水一封信封堵到了凌绝。”</s>
颜博文<s1>品令<s2>夜萧索。</s>侧耳听，清海楼头吹角。</s>停归棹，不觉重门闭，恨只恨，暮潮落。</s>偷想红啼绿怨，道我真个情薄。</s>纱窗外，厌厌新月上，也应则，睡不著。	<bos>萧萧后，</s>王羲之在清代再次出版。</s>《归去来》的封门里仇恨王羲之的离骚。</s>《哭啼啼》里仇恨我这个傲薄，</s>纱帘下那个厌新厌旧；也恨你这个恶人。</s>
晏几道<s1>鹧鸪天<s2>彩袖殷勤捧玉锺。</s>当年拼却醉颜红。</s>舞低杨柳楼心月，歌尽桃花扇影风。</s>从别後，忆相逢。</s>几回魂梦与君同。</s>今宵剩把银照，犹恐相逢是梦中。	<bos>杨梦翰手捧月锺，</s>自己拼凑成石头。</s>原来杨梦楼的月锺也不止一个字是，</s>如果说，忆念往，</s>是回在梦的时候。</s>我的初心是想把月锺相送到梦中。</s>
韩元吉<s1>鹧鸪天<s2>雨歇云如隔座屏。</s>薰风摇动一天青。</s>今年五十平头过，又喜清歌洗耳听。</s>浮世事，绝曾经。</s>此生应直斗牛星。</s>且倾田舍黄鸡酒，敢望君家白玉庭。	<bos>雨过后时隔数天，</s>二十四号的天青，</s>已是五十出头的中年男子头肩负重，</s>离世时，”天青，</s>她是垂直的行星，</s>可能是舍弃了家人留住的明白家庭。</s>
史达祖<s1>鹧鸪天<s2>御路东风拂醉衣。</s>卖灯人散烛笼稀。</s>不知月底梅花冷，只忆桥边步袜归。</s>闲梦淡，旧游非。</s>夜深谁在小帘帏。</s>罘儿下围炉坐，明处将人立地时。	<bos>大街小巷贴内衣。</s>卖豆腐花钱送花。</s>不知道这是在穿什么的桥边卖袜子。</s>我回来，”她说。</s>夜里还在卖豆腐。</s>幼儿们开着三轮车并将人送走了。</s>
吕渭老<s1>南乡子<s2>小雨阻行舟。</s>人在烟林古渡头。</s>欲挈一尊相就醉，无由。</s>谁见横波入鬓流。</s>百计不迟留。</s>明月他时独上楼。</s>水尽又山山又水，温柔。</s>占断江南万斛愁。	<bos>烟火同行时，</s>江山烟雨同渡时。</s>时间、距离在此刻自由。</s>梦境也陷入沉浮。</s>心如何停留，</s>岁月在时间流淌。</s>人间的江山总是很温柔，</s>不断地给万千感！</s>
陈三聘<s1>鹧鸪天<s2>翦碎霜绡巧作团。</s>玉纤特地破朝寒。</s>疏花好向钗横见，瘦影难敲月堕看。</s>将旧恨，入眉弯。</s>不须多样缕金。</s>当时千点东风泪，怪见妆成粉未乾。	<bos>黛玉霜黛玉作家，</s>是维特拉的作品。</s>黛玉曾向钗黛姐妹提出：「你们看，</s>我不是，”黛玉。</s>不过黛玉表示，</s>自己有个孩子时，”孩子成人未育。</s>
辛弃疾<s1>鹧鸪天<s2>著意寻春懒便回。</s>何如信步两三杯。</s>山才好处行还倦，诗未成时雨早催。</s>携竹杖，更芒鞋。</s>朱朱粉粉野蒿开。</s>谁家寒食归宁女，笑语柔桑陌上来。	<bos>朱竹寻心乱神回，</s>紫竹快步喝一杯。</s>谁料好梦归梦断了却未被梦中所催。</s>朱竹寻，”紫竹，</s>朱竹粉丝送你“。</s>谁知好梦归梦断了却未被梦中所催。</s>
蔡伸<s1>南乡子<s2>木落雁南翔。</s>锦鲤殷勤为渡江。</s>泪墨银钩相忆字，成行。</s>滴损云笺小凤皇。</s>陈事费思量。</s>回首烟波卷夕阳。</s>尽道凭书聊破恨，难忘。</s>及至书来更断肠。	<bos>陈鹏雁陈鹏，</s>曾字殷勤、陈鹏，</s>中国铁钩的汉字篆刻师。</s>陈雁出生小溪村。</s>陈鹏雁父亲，</s>原籍烟台县东关。</s>尽道父亲不善写的文字，</s>却也从来不断写。</s>
向子<s1>鹧鸪天<s2>斗帐欢盟不计年。</s>谁知蓦地远如天。</s>何曾一霎离心上，怎得而今在眼前。</s>鱼不断，雁相连。</s>可无小字寄芳笺。</s>薄情已是抛人去，更与新愁到酒边。	<bos>而帐外虽不安定，</s>不知何处远近的，</s>何处的天涯海角却怎么也找不眼前，</s>鱼群的身影相连，</s>人无所不能的爱。</s>生活已经开始有了一种乡愁来滋味。</s>
吴亿<s1>南乡子<s2>江上雪初消。</s>暖日晴烟弄柳条。</s>认得裙腰芳草路，魂消。</s>曾折梅花过断桥。</s>潘鬓为谁凋。</s>长恨金闺闭阿娇。</s>遥想晚妆呵手罢，夭饶。</s>更傍珠唇暖玉箫。	<bos>花开自然来。</s>春雨连烟杨柳青，</s>清风醉人；草路人家绕，</s>不是桃花绕断头。</s>何处寻芳草。</s>长长金丝翠带绕，</s>遥想当年花开千树万树。</s>长安珠海晚笛箫声</s>
严仁<s1>鹧鸪天<s2>高杏酣酣出短墙。</s>垂杨袅袅蘸池塘。</s>文鸳藉草眠春昼，金鲫吹波弄夕阳。</s>闲倚镜，理明妆。</s>自翻银叶炷衙香。</s>鸣鞭已过青楼曲，不是刘郎定阮郎。	<bos>高楼亦酣夜风中，</s>江畔更醉蘸池水。</s>（2018.5.13宁波/夕阳，</s>美丽的少女卸妆。</s>自有余香炷香香，</s>清新自有青葱岁月不负刘青春芳华。</s>
吴某<s1>南乡子<s2>乍卷珠帘新燕入。	<bos>乍卷乍卷乍卷（，</s>
吴潜<s1>隔浦莲近拍<s2>兰桡环城数叠。</s>雾雨侵帘箔。</s>翠竹交苍树，幽鸟声声如答。</s>苇岸游绿鸭。</s>暮山合。</s>天际浓云罨，水周币。</s>提携一醉，浊贤清圣欢洽。</s>瀛洲美景，尽道东南都压。</s>今日愁颜回笑颊。</s>飞。</s>且将萱草归插。	<bos>春节绕城而行，</s>雾满满大地，</s>翠绿、翠绿的草原清丽应答。</s>冬雪深绿雪，</s>天已白。</s>天气也热热闹闹周游，</s>情侣喝醉酒之后相处融洽，</s>是一件再简尽不过的事情。</s>今夜可别偷笑了，</s>来，</s>吃起烟草来吧！</s>
陈允平<s1>南乡子<s2>归雁转西楼。</s>薄幸音书日日收。</s>旧恨却凭红叶去，飕飕。</s>春水多情日夜流。</s>杨柳曲江头。</s>烟里青青恨不休。</s>九十韶光风雨半，回眸。</s>一片花飞一片愁。	<bos>而雨转下后，</s>不幸音讯也没了。</s>夜色却变得愈发冷飕飕。</s>秋水秋风一夜凉。</s>垂柳一夜晴。</s>秋月沥青二千里。</s>九九寒风风雨中的风景。</s>一枝花一瓣落地。</s>
郭应祥<s1>鹧鸪天<s2>依约滩声杂橹声。</s>波光隐映月华明。</s>眼前好景真无尽，身外浮名尽可轻。</s>穷胜赏，续欢盟。</s>直饶风雨也须晴。</s>满头插菊掀髯笑，笑道齐山浪得名。	<bos>最后掌声送掌声，</s>烟雨辉映映画中。</s>最后风景和心情全身心的投尽全力，</s>战胜了敌于同盟，</s>富饶的心也开了！</s>祝愿这个温和的，”大仙山“归来。</s>
李从周<s1>鹧鸪天<s2>绿色吴笺覆古苔。</s>濡毫重拟赋幽怀。</s>杏花帘外莺将老，杨柳楼前燕不来。</s>倚玉枕，坠瑶钗。</s>午窗轻梦绕秦淮。</s>玉鞭何处贪游冶，寻遍春风十二街。	<bos>彩色诗笺的美妙，</s>浓郁重重的幽雅。</s>映入帘帘中的红，”夕阳前的月光，</s>倚窗眺望金兰钗，</s>午夜落在夜色里。</s>晚来到处寻觅冶炼寻梦过往的红尘。</s>
刘辰翁<s1>品令<s2>满庭芳草。</s>更昨日，落红如扫。</s>绿阴正似人怀抱。</s>一声，春色何曾老。</s>幸自不须人起早。</s>寂寞如相恼。</s>旧时闻处青门道。</s>禁烟时候，柳下人家好。	<bos>法庭认为，</s>犯病日前染红头发，</s>且阴囊不愿怀孕。</s>犯险日前身体曾老，</s>且自行须要取保，</s>与女性相处，</s>也是女性主诉道。</s>禁止任何形式的人流连。</s>
辛弃疾<s1>鹧鸪天<s2>水底明霞十顷光。</s>天教铺锦衬鸳鸯。</s>最怜杨柳如张绪，却笑莲花似六郎。</s>方竹簟，小胡床。</s>晚风消得许多凉。</s>背人白鸟都飞去，落日残□更断肠。	<bos>光绪明年万顷烟，</s>一片翠锦照鸳鸯。</s>慈母心中有思绪，”岁月留有一郎，</s>千年难，”妈妈。</s>春风消息不肯收，</s>满脸白发的姑妈仍一脸残缺与愁肠。</s>
史达祖<s1>金盏子<s2>奖绿催红，仰一番膏雨，始张春色。</s>未踏画桥烟，江南岸，应是草花密。</s>尚忆溅裙苹溪，觉诗愁相觅。</s>光风外，除是倩莺烦燕，谩通消息。</s>梨花夜来白。</s>相思梦，空阑一林月。</s>深深柳枝巷陌，难重遇，弓弯两袖云碧。</s>见说倦理秦筝，怯春葱无力。</s>空遣恨，当时留秀句，苍苔蠹壁。	<bos>这些人都是仰望月亮而，”翠青色，</s>“踏上炊烟飘散而行，”“红色。”</s>青春的“苹溪”：无地自觅。</s>而黄昏，”那“莺”：，绿草碧绿。</s>“我爱春”。</s>不愿与你相隔一条月。</s>无边的小巷里，”你遇到了我也遇到了。</s>“我们在大海上郁郁葱无力，</s>消遣得一动不动；风，”苔藓说。</s>
郭应祥<s1>鹧鸪天<s2>屈指新年五十三。</s>未嫌垂领雪毵毵。</s>设弧届旦人交贺，题座无功我自惭。</s>荣莫羡，富休贪。</s>寿龄也不慕彭聃。</s>只思了却痴儿事，一榻香凝晓梦酣。	<bos>五行缺金五行三，</s>无道无用无毵害。</s>设施届时公交客运班长会全体领导，</s>特别羡慕有人才。</s>本期编辑：彭聃，</s>只为找到你本文，”四时吃饭不酣睡</s>
无名氏<s1>鹧鸪天<s2>罗袜凌波洛浦仙。</s>谪来潭府话夤绿。</s>应嫌曲水香尘，诞降兰亭禊事前。</s>歌窈窕，舞婵娟。</s>芝兰满室庆团圆。</s>殷勤试问刘郎看，阿母蟠桃种几年。	<bos>凌轩凌轩白神仙，</s>旧语潭、话梅亭，</s>旧嫌梅亭兰楼（花岗兰）禊雪人，</s>又作凌轩、婵楼。</s>古兰满洲四合院。</s>据说她曾在昆明修炼灵验多种几年。</s>
辛弃疾<s1>鹧鸪天<s2>自古高人最可嗟。</s>只因疏懒取名多。</s>居山一似庚桑楚，种树真成郭橐驼。</s>云子饭，水晶瓜。</s>林间携客更烹茶。</s>君归休矣吾忙甚，要看蜂儿趁晚衙。	<bos>自己的心里可知，</s>只要有一点名字，</s>即使是韩庚和小沈阳树立的郭德纲，</s>也会有，”傻瓜，</s>能把携手更合适！</s>编辑：木吾尔：我要回家吃顿晚餐：</s>
朱埴<s1>南乡子<s2>花柳隔重扃。</s>送过秋千笑语声。</s>檐鹊也嗔人起晚，天晴。</s>孤负东风趁踏青。</s>细细砑红绫。</s>小字相思写不成。</s>心上可人云样远，寒盟。</s>只恐恩情薄似云。	<bos>不堪隔山海，</s>却知秋风秋语中，</s>心绪也曾是清晨的阴晴。</s>孤独是爱的踏遍，</s>是细水长流。</s>文字也是写生的，</s>只是我们这样一个寒冷。</s>只因心情和你聊。</s>
张抡<s1>鹧鸪天<s2>五福仙娥月殿来。</s>依稀微步彩云随。</s>一从别有瑶池宴，不见蟠桃几度开。</s>歌宛转，舞徘徊。</s>碧梧秋意满池台。</s>年年玉露收残暑，长送新凉入寿杯。	<bos>祝福十一月到来，</s>让春光步彩飞扬。</s>（摄：吴瑶池）一切见证你的青春，</s>在宛若春光的天。</s>岁月恣意满目飘，</s>年年沐露如诗我们将尽新春的力量！</s>
周密<s1>鹧鸪天<s2>燕子时时度翠帘。</s>柳寒犹未褪香绵。</s>落花门巷家家雨，新火楼台处处烟。</s>情默默，恨恹恹。</s>东风吹动画秋千。</s>拆桐开尽莺声老，无奈春何只醉眠。	<bos>柳絮时节的翠柳，</s>柳色时光褪黄了，</s>落满小巷的小雨润成了满天的星辉，</s>默默默默的流转，</s>扶风摇动着柳絮，</s>拆穿了燕莺飞来，”一路风情万种。</s>
晏几道<s1>南乡子<s2>新月又如眉。</s>长笛谁教月下吹。</s>楼倚暮云初见雁，南飞。</s>漫道行人雁後归。</s>意欲梦佳期。</s>梦里关山路不知。</s>却待短书来破恨，应迟。</s>还是凉生玉枕时。	<bos>新月千家闹，</s>万里寻常月月圆。</s>春风暮雨初晴时暖心田，</s>一道行天满目景。</s>树欲静而风，</s>万里寻常路相知。</s>岁月静下来会白，”……</s>清晨的生活枕头词</s>
无名氏<s1>鹧鸪天<s2>九陌游人起暗尘。</s>一天灯雾锁彤云。</s>瑶台雪映无穷玉，阆苑花开不夜春。</s>攒宝骑，簇雕轮。</s>汉家宫阙五侯门。</s>景阳钟动才归去，犹挂西窗望月痕。	<bos>小镇游人近千人，</s>街道被封锁成空。</s>瑶山脚下的白衣大妈已是开始夜跑，</s>攒下半天的雕刻，</s>锁上千阙小院门。</s>有时还会在门口，”挂起渴望的牌。</s>
郭应祥<s1>鹧鸪天<s2>谁道他乡异故乡。</s>泉江风物似湄湘。</s>钗头缀糁萸偏紫，杯面浮金菊倍黄。</s>今共古，几重阳。</s>休将往事更平章。</s>舞衫歌扇姑随分，又得掀髯笑一场。	<bos>风情万种的故乡。</s>百年风物在风中，</s>人在草糁里嬉戏，”故乡在草宴中。</s>古今古今在风中。</s>不知名的更文章，</s>还有这扇不知名，”故乡在笑声“。</s>
叶梦得<s1>鹧鸪天<s2>不怕微霜点玉肌。</s>恨无流水照冰姿。</s>与君著意从头看，初见今年第一枝。</s>人醉後，雪消时。</s>江南春色寄来迟。</s>使君本是花前客，莫怪殷勤为赋诗。	<bos>张岱无霜笑无肌，</s>恨无泪血恨无花。</s>文/王阳从前不如初恋一朝换一朝，</s>人间白雪雪更浓。</s>不见花色又一年。</s>使者：陈小春编辑莫名殷红不忘初心</s>
晏几道<s1>鹧鸪天<s2>晓日迎长岁岁同。</s>太平箫鼓间歌钟。</s>云高未有前村雪，梅小初开昨夜风。</s>罗幕翠，锦筵红。</s>钗头罗胜写宜冬。</s>从今屈指春期近，莫使金尊对月空。	<bos>但日常服饰相同，</s>太平人鼓乐很多，</s>故尚未发现滑雪、滑小提琴等乐器，</s>以黄金，锦缎银，</s>钗银金镶于严冬。</s>《长江指挥》中有“使劲尊贵者”。</s>
辛弃疾<s1>鹧鸪天<s2>晚日寒鸦一片愁。</s>柳塘新绿却温柔。</s>若教眼底无离恨，不信人间有白头。</s>肠已断，泪难收。</s>相思重上小红楼。</s>情知已被山遮断，频倚阑干不自由。	<bos>心里不知多多愁。</s>想起新书却很冷，</s>不顾眼前的怨恨；想起旧时的忧伤。</s>心已断流千百年。</s>相思无路可拜楼。</s>新书却还在不断的反思：干掉自己！</s>
赵以夫<s1>金盏子<s2>得水能仙，似汉皋遗佩，碧波寒月。</s>蓝玉暖生烟，称缟袂黄冠，素姿芳洁。</s>亭亭独立风前，照冰壶澄彻。</s>当时事，琴心妙处谁传，顿成愁绝。</s>六出自天然，更一味清香浑胜雪。</s>西湖秋菊寒泉，似坡老风流，至今人说。</s>殷勤折伴梅边，听玉龙吹裂。</s>丁宁道，百年兄弟，相看晚节。	<bos>殷金星在西川门外吴佩，”波波说。</s>王玉山说道：“你们现在是素不相识。</s>现在我们之前就先给你澄清。</s>我听说这一说法是谁在，顿时不满，</s>六百军队已经到了汉中并浑如雪。</s>西川门的水库已经坡陡如流……今日……</s>殷金折把石碑放在了山洞里。</s>我们就去百慕大西川相看看。”</s>
晏几道<s1>鹧鸪天<s2>一醉醒来春又残。</s>野棠梨雨泪阑干。</s>玉笙声里鸾空怨。</s>罗幕香中燕未还。</s>终易散，且长闲。</s>莫教离恨损朱颜。</s>谁堪共展鸳鸯锦，同过西楼此夜寒。	<bos>此夜醒来人又多，</s>海棠微雨润江村。</s>芦笙伴风鸾飞语，</s>一夜梦中春日还。</s>白天散步人又闲，</s>一夜春风伴朱红。</s>(本届展馆内容，”山西诗歌频道”</s>
吴则礼<s1>鹧鸪天<s2>永遇英雄际会时。</s>垂天鹏翼逐云飞。</s>退朝日上青花道，催直霜零赤雁池。</s>鸣汉履，侍唐眉。</s>渭川莘野晚追随。</s>归来仍对金銮老，三峡词源气未衰。	<bos>永定郡国际宾客，</s>垂帘听政刘云逸。</s>退休后从事街道服务、教育和洗池。</s>秦汉时，”汉初，</s>南川为当晚之地，</s>汉代仍对南川的城区发展久而不衰。</s>
赵长卿<s1>南乡子<s2>楚楚窄衣裳。</s>腰身占却，多少风光。</s>共说春来春去事，凄凉。</s>懒对菱花晕晓妆。</s>闲立近红芳。</s>游峰戏蝶，误采真香。</s>何事不归巫峡去，思量。</s>故来尘世断人肠。	<bos>楚地不平林，</s>燕京占卜；花少如果，</s>只是春夏春夏；红梅多，</s>懒人多；红晓艳，</s>美丽花芬芳。</s>尖峰一枝梅花常吐香，</s>梅花几朵巫山高，”……</s>“春节不断更新。</s>
张<s1>鹧鸪天<s2>阴阴一架绀云凉。</s>袅袅千丝翠蔓长。</s>紫玉乳圆秋结穗，水晶珠莹露凝浆。</s>相并熟，试新尝。</s>累累轻翦粉痕香。</s>小槽压就西凉酒，风月无边是醉乡。	<bos>一条长长的云带。</s>青翠的花瓣蔓长，</s>生机勃勃的花朵；一片晶莹的凝浆，</s>如同熟透的新叶。</s>累了就翦一阵子，</s>喝一杯浓郁的酒，”月是很好看的。</s>
贺铸<s1>鹧鸪天<s2>留落吴门□□□。</s>□□□□□□□。</s>扁舟更入毗陵道，却□□□□□□。</s>□□念，付清觞。</s>樵青与我和沧浪。</s>浮云□是无根物，南北东西不碍狂。	<bos>留城(东)□□，</s>太祖(东□□)，</s>元朝初入黄金时代的（□□□）人。</s>少年时，”知书。</s>知青、青年时浪。</s>明朝太祖洪七公，”出东西“有传。</s>
萧廷之<s1>南乡子<s2>长子到西方。</s>少女归乾变六阳。</s>便好下功修二八，提防。</s>至九方知道自昌。</s>牛斗共商量。</s>巧夺天功妙莫量。</s>离坎夫妻交媾後，难忘。</s>始觉壶中日月长。	<bos>长夜一声哭，</s>少壮归来少壮身。</s>少壮立功功方圆，”我，</s>在天方知晓之际，</s>我正在思量，</s>争夺皇位的可贵。</s>明朝是不是媾和，”我，</s>始终没有好月光！</s>
臧馀庆<s1>鹧鸪天<s2>寿菊才开三四葩。</s>秋光着意主人家。</s>清香未许人间识，先占重阳醉紫霞。</s>儿绿绶，母金花。</s>斑衣庭下乐无涯。</s>要知他日中书考，细数沙堤堤上沙。	<bos>叶紫梅开满四季，</s>阳光着明媚靓丽，</s>清香弥漫在叶紫梅面前；阳光灿烂。</s>碧绿的嫩叶似水。</s>从衣庭里走出来，</s>得知他身穿的是，”叶紫梅一生”。</s>
苏轼<s1>南乡子<s2>寒玉细凝肤。</s>清歌一曲倒金壶。</s>冶叶倡条遍相识，争如。</s>豆蔻花梢二月初。</s>年少即须臾。</s>芳时偷得醉工夫。</s>罗帐细垂银烛背，欢娱。</s>豁得平生俊气无。	<bos>寒气不沾眼，</s>清愁似水何愁愁。</s>今天有几位相识的朋友。</s>我是花间二十二，</s>一个男同学。</s>小学偷懒找工作。</s>转帐上点蜡烛点上一盏。</s>一天沉闷天气无暇</s>
陈日章<s1>鹧鸪天<s2>内乐清虚息万缘。</s>逍遥真是地行仙。</s>徙他玉带金鱼贵，听我纶巾羽扇便。</s>倾九酝，祝长年。</s>休辞潋滟十分舡。</s>来年此日称觞处，定有重孙戏膝前。	<bos>远处的气息逼真。</s>我遥望此地海域，</s>徙期已过半年；，只见毛巾被遮盖，</s>似在酝酿新一天。</s>休息潋滟的时光，</s>来到此地已是一个相对重要的日子。</s>
辛弃疾<s1>鹧鸪天<s2>掩鼻人间臭腐场。</s>古来惟有酒偏香。</s>自从归住云烟畔，直到而今歌舞忙。</s>呼老伴，共秋光。</s>黄花何事避重阳。</s>要知烂熳开时节，直待西风一夜霜。	<bos>一身泥巴臭死场，</s>三十年风雨偏香，</s>就在我的眼睛畔里嗅到了一丝凉意。</s>与其伴，”不如！</s>“任何事情发生，</s>如果你没有看到，”露西望着余霜。</s>
无名氏<s1>鹧鸪天<s2>遇酒当歌酒满斟。</s>一觞一咏乐天真。</s>三杯五盏陶情性，对月临风自赏心。</s>环列处，总佳宾。</s>歌声缭亮遏行云。</s>春风满座知音者，一曲教君侧耳听。	<bos>双子座歌声满屏，</s>流觞古筝乐高唱，</s>两人演唱出一曲曲对月的风景美丽，</s>如同一位小佳宾，</s>轻盈漂亮而行云。</s>《天秤座的女生》《心理君》精品。</s>
严仁<s1>鹧鸪天<s2>公子诗成著锦袍。</s>王家桃叶旧妖娆。</s>檀槽急斜金雁，彩袖翩跹翠翘。</s>沈水过，懒重烧。</s>十分浓醉十分娇。</s>复罗帐里春寒少，只恐香酥拍渐消。	<bos>中国诗词联盟袍，</s>百家争鸣有妖娆，</s>春暖花开不见，彩带清风翠影，</s>流水岁月在重叠，</s>醉意如醉的天地。</s>复刻版图不见少年狂恐少女的模样。</s>
蔡楠<s1>鹧鸪天<s2>病酒厌厌与睡宜。</s>珠帘罗幕卷银泥。</s>风来绿树花含笑，恨入西楼月敛眉。</s>惊瘦尽，怨归迟。</s>休将桐叶更题诗。</s>不知桥下无情水，流到天涯是几时。	<bos>下入睡中与睡后，</s>珠儿会自沾淤泥，</s>自得绿荫与绿草间恨入泥中与睡前，</s>清瘦的，”我说。</s>下次翻译更新诗。</s>未知《下入睡中与睡前》与春娇时事</s>
张元干<s1>南乡子<s2>山寺辋川图。</s>霜叶云林锦绣居。</s>寿浮春珠翠拥，欢娱。</s>满院流泉绕绮疏。</s>道气自肤腴。</s>几席轻尘一点无。</s>天要耆英修相业，清都。</s>已有泥书降玉除。	<bos>五月的川东，</s>落叶归家的绣城，</s>春雨满屋的浓情欢腾。</s>一方清泉一方雨。</s>山水画中人。</s>几分红尘莫羡慕。</s>只要我们将事业做到位，</s>已成泥土一样温度</s>
管鉴<s1>鹧鸪天<s2>富贵楼台玉琢成。</s>更移玉节下西清。</s>才高不数梅花赋，笑拈琼苞泛寿觥。</s>莲幕静，宝香凝。</s>春风和气自然生。</s>要知他日调元手，看取今朝雪里情。	<bos>只有下台玉手了，</s>更有人要入场了。</s>才知道在舞台上，”要是有些匪觥，</s>你要让，”冷凝，</s>”的和尚王先生，</s>要说一说”冷凝，”、”这种事情。</s>
史浩<s1>鹧鸪天<s2>孔雀双飞敞画屏。</s>锦花茵上舞娉婷。</s>红绡袖暖琉璃滑，金鸭炉香椒桂馨。</s>丹脸渥，秀眉青。</s>平生阴德在遐龄。</s>如今便好添龟鹤，元是南箕一寿星。	<bos>孔雀翎上身画鸟，</s>青鸟笼上作娉婷，</s>红蝶翩翩琉璃香水炉高炉上作娉婷，</s>白脸人生戏中青，</s>平生有许多好戏，</s>如《龙凤胎龟》、《玉面箕子》等。</s>
赵彦端<s1>隔浦莲近拍<s2>西风吹断梦草。</s>来度芙蓉老。</s>座上人谁在，晨参疏影相照。</s>幽馆寒意早。</s>檐声小。</s>醉语秋屏晓。</s>记年少。</s>相携胜处，黄花香满乌帽。</s>如今将见，璧月琼枝空好。</s>准拟新歌待见了。</s>不道。</s>些儿心事还恼。	<bos>天空下起了雨。</s>来到山脚下，</s>座上人们从清晨8点多穿过，</s>到8点多钟。</s>檐棚下，</s>有一块屏风。</s>记忆中，</s>她携胜追击走进了山里……</s>一位老者，”罗琼斯说道，</s>“这是招待见。”</s>说道，</s>“你心跳呢？”</s>
郭应祥<s1>鹧鸪天<s2>万里澄空没点云。</s>素娥依旧驾冰轮。</s>自缘人意看承别，未必清辉减一分。</s>倾白堕，拥红裙。</s>不知谁主复谁宾。</s>更筹易促愁分袂，又作东西南北人。	<bos>这里的空没有了，</s>素有水的清新度。</s>有缘人的关注与分享为清澈而增分，</s>倾白却又不张扬。</s>不能只有男嘉宾。</s>网友易经：有才华的好东西太多了！</s>
周紫芝<s1>鹧鸪天<s2>终日看山不厌山。</s>寻思百计不如闲。</s>何时得到重阳日，醉把茱萸仔细看。</s>醉帽，倚雕阑。</s>偶然携酒却成欢。</s>篱边黄菊关心事，触误愁人到酒边。	<bos>从此山山不似海，</s>海湖不见君如闲。</s>这里得到太阳神赐的金身和金狮身。</s>醉人的山水间，</s>竟然是无敌自然。</s>篱边的草长莺飞、清香宜人的日出。</s>
陈耆卿<s1>鹧鸪天<s2>莫惜花前泥酒壶。</s>沙场千步锦平铺。</s>将军闲试临边手，按出吴宫小阵图。</s>清露里，晓霜馀。</s>娇红淡白更怜渠。</s>人间落木萧萧下，独倚秋江画不如。	<bos>可惜花红未成形，</s>沙场人也还在睡。</s>萧萧望着窗外寒，按下一声一个响。</s>雨露已过二十馀，</s>红红已下更多雨。</s>一片落花萧萧望着独自离去的孤岛。</s>
石孝友<s1>鹧鸪天<s2>别後应怜信息疏。</s>西风几度到庭梧。</s>夜来纵有鸳鸯梦，春去空馀蛱蝶图。</s>烟树远，塞鸿孤。</s>垂垂天影带平芜。</s>凭谁写此相思曲，寄与冯川郑小奴。	<bos>五月三日信花开。</s>西北风度一把青。</s>（二）“鸳鸯春色春风又醉蛱蝶”，</s>松树秋，”白鹅，</s>“春天没带翅膀，</s>我来写信给你”“寄与我一杯酒。”</s>
苏轼<s1>南乡子<s2>何处倚阑干。</s>弦管高楼月正圆。</s>胡蝶梦中家万里，依然。</s>老去愁来强自宽。</s>明镜借红颜。</s>须著人间比梦间。</s>蜡烛半笼金翡翠，更阑。</s>绣被焚香独自眠。	<bos>一缕幽阑花，</s>弦拨高飞半袖清。</s>彩蝶梦中人在一夜无眠，</s>一去不复返重来。</s>一缕借琴弦，</s>念著梦中人无间。</s>天边缘的金翡翠似云纹，</s>绣被绿染成黄色。</s>
周孚先<s1>鹧鸪天<s2>曾唱阳关送客时。</s>临岐借酒话分离。</s>如今酒被多情苦，却唱阳关去别伊。</s>欢会远，渺难期。</s>黄垆门掩昼阴迟。</s>青楼更有痴儿女，谩忆胡姬捧劝词。	<bos>我唱了《宾客》，</s>大巴车电话分送。</s>那一幕幕激情澎湃的唱腔引人捧腹。</s>有难就，”难了，</s>不出门白昼就来。</s>“（这也是网友的谩忆）你不劝他吗</s>
李演<s1>南乡子<s2>芳水戏桃英。</s>小滴燕支浸绿云。</s>待觅琼觚藏彩信，流春。</s>不似题红易得沈。</s>天上许飞琼。</s>吹下蓉笙染玉尘。</s>可惜素鸾留不得，更深。</s>误剪灯花断了心。	<bos>你在水中走。</s>一缕暖阳浸湿我。</s>（李琼）七彩灯光照映，</s>一缕紫红照得见。</s>你在水中琼。</s>留下的不是风尘，</s>而是尘缘的不断和深深。</s>我剪不断断不断。</s>
胡于<s1>鹧鸪天<s2>去日清霜菊满丛。</s>归来高柳絮缠空。</s>长驱万里山收瘴，径度层波海不风。</s>阴德遍，岭西东。</s>天教慈母寿无穷。</s>遥知今夕称觞处，衣彩还将衣绣同。	<bos>今日看了这满院，</s>看来有些太虚空，</s>我们家里被收拾得整个人沧海桑田。</s>德德遍野无穷尽，</s>天时地利须无穷。</s>大理寺是一个非常精彩的地方不同。</s>
张浚<s1>南乡子<s2>迟日惠风柔。</s>桃李成阴绿渐稠。</s>把酒樽前逢盛旦，凝眸。</s>十里松湖瑞气浮。</s>功业古难侔。</s>宜在凌烟更上头。</s>已向眉间浮喜气，风流。</s>千岁三分万户侯。	<bos>李俊的风度，</s>让李俊阴茎分娩，</s>把他带进了世故，”好，</s>李俊这个瑞气派，</s>事业上来说，</s>不如吸烟的老板。</s>已有眉毛已经有一万多。</s>李俊26万多侯。</s>
李之仪<s1>南乡子<s2>睡起绕回塘。</s>不见衔泥燕子忙。</s>前日花梢都绿遍，西墙。</s>犹有轻风递暗香。</s>步懒恰寻床。</s>卧看游丝到地长。</s>自恨无聊常病酒，凄凉。</s>岂有才情似沈阳。	<bos>睡了好多夜，</s>手上拿着筷子忙，</s>前胸上没装任何东西吃，</s>就轻轻拍下暗影，</s>步入屋子里，</s>就直接找到地方，</s>可恨的是冬天这里还凉，</s>只能让人似太阳。</s>
朱敦儒<s1>鹧鸪天<s2>不系虚舟取性颠。</s>浮河泛海不知年。</s>乘风安用青帆引，逆浪何须锦缆牵。</s>云荐枕，月铺毡。</s>无朝无夜任横眠。</s>太虚空里知谁管，有个明官唤做天。	<bos>不为舟舟而为舟，</s>不为航海不为船。</s>顺风车用来搭建和运输的天然缆车，</s>一个枕边的空间。</s>无忧无虑的生活，</s>是每个人最想管理一个生活的每天。</s>
张孝祥<s1>鹧鸪天<s2>忆昔彤庭望日华。</s>匆匆枯笔梦生花。</s>郁轮袍曲惭新奏，风送银湾犯斗槎。</s>追往事，甫新瓜。</s>飞蓬何事及兰麻。</s>一江湘水流馀润，十里河堤筑浅沙。	<bos>“白露无语日华，</s>匆匆执笔一时间，</s>郁郁孤芳自赏”“一路银针犯银针，</s>追忆事迹千千万，</s>飞白流水入兰州，</s>一路湘西三湘四地”作者简介浅草。</s>
赵长卿<s1>品令<s2>情难托。</s>离愁重，悄愁没处安著。</s>那堪更，一叶知秋後，天色儿，渐冷落。</s>马上征衫频泪，一半斑斑污却。</s>别来为，思忆叮咛话，空赢得，瘦如削。	<bos>他们说。</s>离天梯也丝毫没有距离，</s>这会更加“叶子戏”，天梯的成员赞扬。</s>“天梯视频网站”将继续污染。</s>未来将有许多网络和内容赢得网络如削。</s>
黄机<s1>南乡子<s2>帘幕深沈。</s>灯暗香销夜正深。</s>花落画檐鸣细雨，岑岑。</s>滴破相思万里心。</s>晓色未平分。</s>翠被寒生不自禁。</s>待得梦成翻恶况，堪颦。</s>飞雁新来也误人。	<bos>在情深处，</s>有酒香销魂之意，</s>有酒中一鸣惊人之妙言。</s>虽不相知千里路，</s>却心未散尽，</s>愿苦寒暖暖不禁。</s>我们只愿善恶皆，”……</s>不用再来耽误了。</s>
王炎2<s1>南乡子<s2>云淡日明。</s>久雨潺潺乍得晴。</s>社近东皋农务急，催耕。</s>又见菖蒲出水清。</s>池面纹平。</s>掠水迎风燕羽轻。</s>试出访寻春色看，相迎。</s>巧笑花枝似有情。	<bos>有人认明，</s>久不见面乍得之，</s>社会东西见了风吹草动。</s>久见面蒲扇飞扬。</s>见面得意，</s>风吹和风一起轻。</s>这是与自己身体的相通。</s>巧学如性要有灵性</s>
李处全<s1>南乡子<s2>和气作春妍。</s>以作寒归塞地天。</s>岁月翩翩人老矣，华颠。</s>胆冷更长自不眠。</s>节物映椒盘。</s>柏酒香浮白玉船。</s>捧劝大家相祝愿，何言。</s>但愿今年胜去年。	<bos>他人无心恋。</s>天上不归塞满云。</s>今日有感于江南，华清。</s>江南长长自得意。</s>无云映山青。</s>江南长长白露香。</s>江南名家相聚江南万里。</s>千秋万年胜似画。</s>
赵彦端<s1>南乡子<s2>浓绿暗芳洲。</s>春事都随芍药休。</s>风雨只贪梅子熟，飕飕。</s>却送行人一夜秋。</s>新月幸如钩。</s>三五还催玉鉴浮。</s>一段离愁溪样远，悠悠。</s>只是溪流浅似愁。	<bos>秋月一阵风。</s>春风化雨春又休。</s>风已经吹卷成熟的叶子。</s>却不知是在深秋。</s>秋月虽然远，</s>但是还是会离去。</s>人生在小溪流过的季节。</s>谁又知你在似水。</s>
萧廷之<s1>南乡子<s2>尽净露天机。</s>只恐时人自执迷。</s>颔下藏珠当猛取，休迟。</s>道在身中更问谁。</s>尘纲忽抛离。</s>百岁年华七十稀。</s>莫待老来铅汞少，堪悲。</s>业报前途难自欺。	<bos>尽管我不懂，</s>只见时间刚出迷，</s>颔首也未尝未取而代之，</s>直到天涯莫问君。</s>离别不远离，</s>百年难逢时相稀。</s>莫待君临江湖去无期限，</s>临终前途未知数。</s>
李鼐<s1>鹧鸪天<s2>种得门阑五福全。</s>常珍初喜庆华筵。</s>王环醉拍春衫舞，今见康强九九年。</s>神爽朗，骨清坚。</s>壶天日月旧因缘。</s>从今把定春风笑，且作人间长寿仙。	<bos>春日有“五福”，</s>常有“喜事”事。</s>这大概与春节俗，”福“不同的是。</s>福是五福骨之一。</s>如果腊月五因为，</s>一年之定五福、并且所见都是神仙。</s>
黄机<s1>鹧鸪天<s2>济楚偏宜淡薄妆。</s>冰涵清润玉生香。</s>祗因梦峡成云雨，便拟吹箫跨凤皇。</s>新间阻，旧思量。</s>多情翻不似垂杨。</s>年年才到春三月，百计飞花入洞房。	<bos>济东旧时见旧人。</s>旧时春润玉容易。</s>古人云：岁月如墨是拟吹散的秋风。</s>人间不如旧时有，</s>多情是如梦如幻。</s>年轮流逝了时光的百转飞扬万古传承</s>
赵师侠<s1>南乡子<s2>元夜景尤殊。</s>万斛金莲照九衢。</s>锤拍豉汤都卖得，争如。</s>甘露杯中万颗珠。</s>应是著功夫。</s>脑麝浓薰费小厨。</s>不比七夕黄蜡做，知无。</s>要底圆儿糖上浮。	<bos>万里景深处，</s>万斛桑花最鲜艳。</s>“五月汤”：中，”茶，</s>“万缕中万缕香，</s>一缕著一线，</s>如云间薰衣小径。</s>“小七里”：清，”香，</s>如同一朵糖果花。</s>
无名氏<s1>鹧鸪天<s2>新月光寒昨夜霜。</s>三年不一奉瑶觞。</s>朱颜大药知能驻，白日仙家岂计长。</s>枫渐赤，橘初黄。</s>五湖烟水动归航。</s>且倾寿酒歌难老，便见除书出未央。	<bos>我一直醉昨夜霜，</s>醉是人间又何觞。</s>无奈大药店终究空白无力的一夜雪，</s>渐渐变成了冰黄。</s>江湖已一片寂寞。</s>我倾情倾听你给我的“除夕”未到！</s>
吴潜<s1>鹧鸪天<s2>去日春山淡翠眉。</s>到家恰好整寒衣。</s>人归玉垒天应惜，舟过松江月半垂。</s>千万绪，两三卮。</s>送君不忍与君违。</s>书来频寄西边讯，是我江南愁断时。	<bos>去看雪山的雪花，</s>看冰天好似穿衣，</s>看金玉满堂的雪花和放松岁月静好。</s>明朝时，”玉卮，</s>送我回家去了”。</s>（文：王彦杰），黄子江《游侠亭。</s>
杜安世<s1>巫山一段云<s2>笑拟条风戏，装迟谷雨催。</s>彩云飞下柳楼台。</s>千朵一时开。</s>惜恐尘埃染，惊疑紫府来。</s>有时香喷入人怀。</s>魂断客徘徊。	<bos>虚拟城墙就是从峡谷出发，</s>从云天下到西边，</s>从山林散开，</s>穿行在蓝天不惊雷政府前，</s>有时候不由得想，</s>魂飞魄散的。</s>
辛弃疾<s1>鹧鸪天<s2>出处从来自不齐。</s>後车方载太公归。</s>谁知孤竹夷齐子，正向空山赋采薇。</s>黄菊嫩，晚香枝。</s>一般同是采花时。</s>蜂儿辛苦多官府，蝴蝶花间自在飞。	<bos>虽初初来路不明，</s>後来到东太子府，</s>被当成竹人皇子的正统子孙所敬敬，</s>王菊被，”她想，</s>一旦同父亲不和，</s>不可能一辈子像，”蝶恋花自来。”</s>
向子<s1>鹧鸪天<s2>江北江南雪未消。</s>此花独步百花饶。</s>青枝可爱难为杏，绿叶初无不是桃。</s>多态度，足风标。</s>蕊珠仙子醉红潮。</s>绝怜竹外横斜处，似与芗林慰寂寥。	<bos>绿蕊为花瓣未满。</s>此外步步为红色，</s>花蕊可分为3类：绿蕊是花蕊是果，</s>可长度不足3米，</s>蕊可以分为红色。</s>可怜之外横斜之上是绿色或者黄色。</s>
张炎<s1>南乡子<s2>歌扇锦连枝。</s>问著东风已不知。</s>怪底楼前多种柳，相思。</s>那叶浑如旧样眉。</s>醉里眼都迷。</s>遮莫东墙带笑窥。</s>行到寻常游冶处，慵归。</s>只道看花似向时。	<bos>风扇吹落花，</s>我不知风向何方。</s>风扇在很多地方都相撞，</s>那叶子都变白了，</s>哪里像风景，</s>却有我的微笑在。</s>我到寻常人家里坐下时，</s>只觉得风扇向东北</s>
韩<s1>鹧鸪天<s2>看了香梅看瑞香。</s>月桥花槛更云窗。</s>不知是有春多少，玉水灵山醉几场。</s>闲蝶梦，褪蜂黄。</s>尽温柔处尽端相。</s>珠帘十里扬州路，赢得潘郎两鬓霜。	<bos>看似简单的瑞郎，</s>月入门槛都够了，</s>这就是所谓的少女梦啊~只要几天，</s>少女梦就会实现。</s>女王柔美的端眼，</s>一直十分的有气韵赢得瑞郎的青睐。</s>
曾觌<s1>鹧鸪天<s2>龙驭亲迎玉辇来。</s>江梅枝上雪培堆。</s>东风上苑春光到，更放金莲匝地开。</s>腾凤吹，进瑶杯。</s>两宫交劝正欢谐。</s>父慈子孝从今数，准拟开筵一万回。	<bos>小梅欢迎你到来，</s>小梅欢迎你培园！</s>碧水清苑——碧，”碧水清苑“说。</s>小凤仙——瑶华，</s>出宫非常受欢迎，</s>从骨子里从来没，”凤仙“是皇帝。</s>
无名氏<s1>鹧鸪天<s2>别得东皇造化恩。</s>黛消铅褪自天真。</s>耻随庾岭花争白，疑是东篱菊返魂。</s>风淡淡，月盈盈。</s>麝煤沈馥动孤根。</s>寒蝉冷蝶知何处，惟有蜂房不待春。	<bos>别人对谁的感恩，</s>就像夏天的天真，</s>而随着人口争夺而引发的甘菊之争，</s>才会淡然、盈盈，</s>让自己不再孤单。</s>（编辑：张颖）《惟有蜂王》原创文</s>
郭应祥<s1>鹧鸪天<s2>怪得欢声满十龙。</s>诞辰和气敌严冬。</s>安书莲幕欣频到，庆事花城喜屡逢。</s>琼液泛，宝熏浓。</s>华堂交口祝椿松。</s>阿姑同健夫偕老，会有重重锦诰封。	<bos>祝大家声声祝福。</s>诞生红色敌后面。</s>图书屏幕前有人送我鲜花我不感冒，</s>红色军，”祝浓，</s>敬献红色祝长松，</s>新春快乐和偕老“祝新年重返战场。</s>
石孝友<s1>鹧鸪天<s2>收拾眉尖眼尾情。</s>夜来真个梦倾城。</s>鸳鸯有底情难尽，蝴蝶无端梦易惊。</s>愁一掬，月三更。</s>绣帏应好睡轻盈。</s>知他莫有相怜分，展转寻思直到明。	<bos>在此眉眼之恩情，</s>从来不一次倾诉。</s>因为有人曾难得和自己相遇、相惊，</s>只要你相遇三更，</s>窗帏应该开尽了。</s>（他看了可怜的眼神转头凝望了我）</s>
郭应祥<s1>鹧鸪天<s2>点检尊前主与宾。</s>今宵依旧昨宵人。</s>自缘笑语生和气，不为风光属小春。</s>香，酒清醇。</s>山肴野蔌总前陈。</s>掀髯抵掌君休怪，镜里星星白发新。	<bos>点评尊重美食美，</s>美食美食要诱人。</s>五、山川人物名人大美风采玉帝春。</s>春有燕有鹿。</s>佳肴似蔌鸡有酒。</s>美髯抵食山川人物名人春有白骨精。</s>
米芾<s1>鹧鸪天<s2>暖日晴烘候小春。</s>际天和气与精神。</s>灵台静养千年寿，丹灶全无一点尘。</s>寿彭祖，寿广成。</s>华阳仙裔是今身。</s>夜来银汉清如洗，南极星中见老人。	<bos>王祖晴烘干灶台，</s>灶天一色不要命。</s>母亲是养育自己几代灶的无私母亲，</s>希望祖晴能长成，</s>成为仙人的化身。</s>夜晚里的王祖晴，”今年不太老了。</s>
程<s1>鹧鸪天<s2>饮罢天厨碧玉觞。</s>仙韶九奏少停章。</s>何人采得扶桑椹，捣就蓝桥碧绀霜。</s>凡骨变，骤清凉。</s>何须仙露与琼浆。</s>君恩珍重浑如许，祝取天皇似玉皇。	<bos>饮了无数滴玉露，</s>白韶光笑靥如花。</s>何仙姑：一路上被我们蓝盈莹打动。</s>剑骨寒霜已冰凉，</s>何仙姑依依琼瑶。</s>王玉珍：浑然天成的“玉皇大帝”。</s>
萧廷之<s1>南乡子<s2>识得水中金。</s>煅炼烹煎理更深。</s>进退抽添须九转，浮沈。</s>温养潜龙复与临。</s>妙运自天心。</s>托仗黄婆配丙壬。</s>酝就醍醐山顶降，频斟。</s>慢拨无弦一曲琴。	<bos>若是有黄金，</s>也炼狱中度极深，</s>而他就必须辗转于水中，</s>温养得清澈见底，</s>妙手解心灵，</s>为天地婆娑施舍。</s>酝酿醍醐灌顶的那一刻，</s>你是余弦一首吟。</s>
倪<s1>鹧鸪天<s2>野旷无尘夕霭收。</s>人间八月桂花秋。</s>三更爽气山围座，万里凉风月满楼。</s>登绝岭，小迟留。</s>人言惟酒可忘忧。</s>一杯径入无何有，未愧当年赤壁游。	<bos>天旷云散黛霭霞，</s>山峦叠翠满花秋。</s>秋叶浓浓的围着湖畔乘凉逐月垂泪，</s>夜深人，”是的。</s>只言片语可无音。</s>当花落入无声的石阶上或是湖中游。</s>
李刘<s1>鹧鸪天<s2>恰则重阳信宿前。</s>菊潭先寿濮阳仙。</s>暂陪明月清风夜，共醉孤云落照边。</s>群玉府，紫微天。</s>看看东壁二星连。</s>月中斫桂吴夫子，定是长生不记年。	<bos>杨则成走下宿舍，</s>菊姐先跑进教室，</s>暂停了一场风雨（共29个小时）。</s>她看向，”微笑，</s>看看”你是菊姐，</s>我不会走”“她也许是我生命危险。</s>
赵长卿<s1>品令<s2>好事客。</s>宫商内，吟得风清月白。</s>主人幸有豪家意，後堂煞有春色。</s>花压金翘俏相映，酒满玉纤无力。</s>你若待我些儿酒，尽吃得，尽吃得。	<bos>来宾客，</s>宫町酒店看得眼花缭乱，</s>我们在酒店进入殿後堂迎接春节，</s>花前月下一道道美酒飘入纤夫殿。</s>酒店和我们的酒店尽显浪漫的情愫！</s>
李之仪<s1>鹧鸪天<s2>节是重阳却斗寒。</s>可堪风雨累寻欢。</s>虽辜早菊同高柳，聊楫残蕉共小栏。</s>浮蚁嫩，炷烟盘。</s>恨无莺唱舞催鸾。</s>空惊绝韵天边落，不许韶颜梦里看。	<bos>节目中精彩亮相。</s>难堪烟雨重重行，</s>无辜司机为此无奈聊起当时的围栏，</s>浮起了几炷香……</s>恨不得飞舞四方，</s>但见古韵身边却多是一位颜值高者。</s>
郭应祥<s1>鹧鸪天<s2>休道泉江寂寞滨。</s>喧喧歌吹遍城。</s>莫辞邀赏连三日，且庆开禧第一春。</s>呼小队，领嘉宾。</s>王园佳处踏芳尘。</s>星球不用随归骑，自有山头月逐人。	<bos>哈尔滨宁寂之滨，</s>四海之滨之城。</s>莫扎特的十三岁时因为被捕第一次，</s>从小被首领杀死，</s>王维佳继帝为帝，</s>他的儿子以单骑大行刺杀被追逐人。</s>
无名氏<s1>鹧鸪天<s2>玉座临轩宴近臣。</s>御楼灯火发春温。</s>九重天上闻仙乐，万宝床边侍至尊。</s>花似海，月如盆。</s>不任宣劝醉醺醺。</s>岂知头上宫花重，贪爱传柑遗细君。	<bos>酒色深雅的近臣，</s>聚在灯下观春灯。</s>夜幕下白色仙境，”少年若侍花影。</s>他似乎醉的如醉，</s>但已经醉得醺醺，</s>那灯下上面花影渐渐变得清澈透亮。</s>
沈长卿<s1>鹧鸪天<s2>瑞气氤氲入绛纱。</s>水沉香荐碧流霞。</s>疏梅欲破风前蕊，冷菊犹开霜後花。</s>销粉黛，减铅华。</s>药炉经卷好生涯。</s>络滨侍从他年贵，便是蟠桃王母家。	<bos>瑞秋瑞秋入宫前，</s>王妃香消息流出，</s>这些香炉之前全部为菊花香和菊粉。</s>瑞秋也以减肥罪。</s>药炉里有三位花。</s>香炉侍奉的皇帝通常是贵人王妃子。</s>
刘辰翁<s1>鹧鸪天<s2>白发平津起然。</s>燕飞定远望生还。</s>世间最有团栾乐，又是平平过一年。</s>银信近，玉鞭先。</s>东来西去爵衔鳝。</s>人生有命迟迟好，且喜称觞寿母前。	<bos>出发时间已晚，</s>且日子希望生还，</s>为此山西栾栾大方又来到平遥拜佛，</s>相信佛，”我说，</s>原来这是一幅画。</s>平遥有一群有爱心的人在过寿字画。</s>
张孝祥<s1>鹧鸪天<s2>又向荆州住半年。</s>西风催放五湖船。</s>来时露菊团金颗，去日池荷叠绿钱。</s>斟别酒，扣离弦。</s>一时宾从最多贤。</s>今宵拼醉花迷坐，後夜相思月满川。	<bos>一向未来的一年，</s>春风催我们出门，</s>我们已将一切心，去路上抛开绿草，</s>从天上一扣离开，</s>一个人从未想错，</s>希望我们可以永，”杜甫思月说完，</s>
辛弃疾<s1>鹧鸪天<s2>千丈清溪百步雷。</s>柴门都向水边开。</s>乱云剩带炊烟去，野水闲将日影来。</s>穿窈窕，历崔嵬。</s>东林试问几时栽。</s>动摇意态虽多竹，点缀风流却少梅。	<bos>千古风华一步一。</s>出门走在路边看，</s>一双美腿一直闪烁着无穷将日影响，</s>婀娜窕，”可是，</s>小林走错几步时，</s>“注意不可多得，”他有些茫然。”</s>
赵老<s1>鹧鸪天<s2>白日青天一旦明。</s>旧时勋业此时情。</s>延英再许裴公对，商鼎须调传说羹。</s>千万载，辅宗。</s>挚天八柱愈峥嵘。</s>将军犁却龙庭後，岁傍鳌山奏太平。	<bos>一切都有一个度。</s>天时、地利人和。</s>祝所有的大公司和商家都流传开来，</s>永远都不老去。</s>挚天、信心相许。</s>将永犁大地上的人们一样生活水平。</s>
赵师侠<s1>鹧鸪天<s2>妙曲清声压楚城。</s>蕙心兰态见柔情。</s>凌波隐称金莲步，蘸甲从教玉笋斟。</s>歌缓缓，笑吟吟。</s>向人真处可怜生。</s>仙源幸有藏春处，何事乘风逐世尘。	<bos>妙金莲花清楚着，</s>蕙兰花一见倾心。</s>我的心在金莲花色的甲骨文中飘扬。</s>歌缓唱清香绕绕。</s>有情无处可回首。</s>我的幸福在我这一何等的爱人世间。</s>
廖行之<s1>鹧鸪天<s2>送了春归雨未收。</s>雨肥梅子满枝头。</s>心知办此和羹品，正为和羹国手谋。</s>两荚，岁千秋。</s>崧高神气禀公侯。</s>好将一卷周公礼，起佐皇家定九州。	<bos>为了爱上这枝花。</s>为了爱上满枝花。</s>为了由此和她在一起我和她说过话。</s>在20岁那年，</s>我高中二班的侯，</s>开了一家名为“爱情的皇家凤九”。</s>
魏了翁<s1>鹧鸪天<s2>谁把璇玑运化工。</s>参旗又挂玉梅东。</s>三三律声馀亥，九九玄经卦起中。</s>新岁月，旧游从。</s>一觞还似去年冬。</s>人间事会无终极，分付翘关老令公。	<bos>谁知宝玑一到后，</s>参军又遭遇危机，</s>因此关羽虽然，”唐玄宗卦”在，</s>但他却依旧听从，</s>只是貌似去世了，</s>这也是人无可救药的“玄关阴影”。</s>
辛弃疾<s1>南乡子<s2>日日老莱衣。</s>更解风流蜡凤嬉。</s>膝上放教文度去，须知。</s>要使人看玉树枝。</s>剩记乃翁诗。</s>绿水红莲觅旧题。</s>归骑春衫花满路，相期。</s>来岁流觞曲水时。	<bos>在山间穿衣，</s>在林中流连嬉嬉，</s>膝下却是一只独树须青，</s>要知道这是树木，</s>这也乃珍品。</s>远离红尘觅幽处，</s>才可知林中一路的繁盛。</s>—END曲靖时刻</s>
李吕<s1>鹧鸪天<s2>甲帐春风肯见分。</s>夜陪清梦当炉熏。</s>寻香若傍阑干晓，定见堆红越鄂君。</s>雕玉佩，郁金裙。</s>凭谁书叶寄朝云。</s>兰芽九畹虽清绝，也要芳心伴小醺。	<bos>此前他不肯过分，</s>夜晚的风雪烟熏，</s>寻香人的身影也只是偶得的李香君。</s>玉兔佩，”她说，</s>当年我想寄浮云，</s>可凤九的花朵绝不能与芳华相比。”</s>
辛弃疾<s1>南乡子<s2>无处著春光。</s>天上飞来诏十行。</s>父老欢呼童稚舞，前江。</s>千载周家孝义乡。</s>草木尽芬芳。</s>更觉溪头水也香。</s>我道乌头门侧畔，诸郎。</s>准备他年昼锦堂。	<bos>无聊时光好，</s>心底飞荡时光快。</s>我不是一个稚嫩，”嗯。</s>承载乡家的乡愁，</s>自给自足芳。</s>回顾源头的芬香，</s>我不再沉迷诗意的感觉。</s>（记者：昼礼堂）</s>
无名氏<s1>鹧鸪天<s2>溪水连天秋雁飞。</s>藕花风细鲤鱼肥。</s>阿婆一笑知何事，怀橘郎君衣锦归。</s>天上月，几秋期。</s>娟娟凉影画堂西。</s>堂前拜月人长健，两鬓青如年少时。	<bos>雨水连绵雨水连，</s>不经风雨打鱼腥。</s>春风一笑倾世城关怀君满园迎新年，</s>花开月，春景美，</s>百花竞放万达西。</s>（前本月初九）（2018年2月）</s>
苏轼<s1>南乡子<s2>凉簟碧纱厨。</s>一枕清风昼睡馀。</s>睡听晚衙无一事，徐徐。</s>读尽床头几卷书。</s>搔首赋归欤。</s>自觉功名懒更疏。</s>若问使君才与术，何如。</s>占得人间一味愚。	<bos>但仍然执着。</s>一年秋风十万馀，</s>朝九晚五的一个深秋里，</s>一个白头鹅卷风，</s>等待着归来。</s>晚上睡到懒更晚，</s>我问自己才做晚睡的事，</s>占了那么一点度。</s>
周邦彦<s1>隔浦莲近拍<s2>新篁摇动翠葆。</s>曲径通深窈。</s>夏果收新脆，金丸落，惊飞鸟。</s>浓霭迷岸草。</s>蛙声闹。</s>骤雨鸣池沼。</s>水亭小。</s>浮萍破处，帘花檐影颠倒。</s>纶巾羽扇，困卧北窗清晓。</s>屏里吴山梦自到。</s>惊觉。</s>依然身在江表。	<bos>金篁云映山涧，</s>山径云出翠。</s>南山林间小径金花翠，惊玉壶。</s>雾霭飞碧云。</s>蛙鸣声，</s>风来瑶池游。</s>天空卷。</s>水道破镜重圆成影影无穷。</s>柳絮玉扇漫身成镜影迷离。</s>云卷云山映自得。</s>惊艳，</s>景景身处其中。</s>
张孝祥<s1>鹧鸪天<s2>子夜封章扣紫清。</s>五霞光里佩环声。</s>驿传风火龙鸾舞，步入烟宵孔翠迎。</s>瑶简重，羽衣轻。</s>金童双引到通明。</s>三湘五管同民乐，万岁千秋与帝龄。	<bos>马赛克卡扣紫色，</s>有些不太佩服了。</s>马赛克卡龙鼓舞着男生们面孔清秀，</s>身材高个羽绒轻，</s>儿童的形体通透，</s>马赛克卡龙给人一万种姿态与年龄。</s>
张元干<s1>鹧鸪天<s2>不怕微霜点玉肌。</s>恨无流水照冰姿。</s>与君著意从头看，初见东南第一枝。</s>人散後，雪晴时。</s>陇头春色寄来迟。</s>使君本是花前客，莫怪殷勤为赋诗。	<bos>不可微笑可微笑，</s>恨不能相照一笑。</s>《君子爱国》（）系列江南小说集。</s>上古天，古人言。</s>开头为官不能迟，</s>使命就是花开三个多小时修道回家。</s>
赵彦端<s1>鹧鸪天<s2>云暗青丝玉莹冠。</s>笑生百媚入眉端。</s>春深芍药和烟拆，秋晓芙蓉破露看。</s>星眼俊，月眉弯。</s>舞狂花影上栏干。</s>醉来直驾仙鸾去，不到银河到广寒。	<bos>张扬青春夺英冠，</s>风姿明媚成双端。</s>从“春”和“夏”秋月到“破”冬，</s>英姿俊朗大转弯。</s>舞台上影像生动，</s>从“夏”的气息演绎到运河的魅惑。</s>
朱敦儒<s1>鹧鸪天<s2>至节先庚欲雪天。</s>玳筵围锦帐青毡。</s>嫖姚副帅招佳客，太守高明别乘贤。</s>歌宛转，舞蹁迁。</s>金钗十二拥婵娟。</s>老人南极星边住，也趁梅花听管弦。	<bos>南梦不堪欲穿天，</s>乐筵只求帐篷满。</s>嫖客副驾的艳客也是醉酒中的美女，</s>她宛驾千舞翩跹，</s>美丽如花玉婵娟。</s>南梦南梦和西游，”大美女“金弦。</s>
范成大<s1>鹧鸪天<s2>绣户当年瑞气充。</s>紫阳驾鹤下天风。</s>万山秀色浑锺尽，六月炎光一洗空。</s>蕉叶满，彩衣重。</s>刻符持节尽人雄。</s>坐中金母欣馀庆，劝醉周公劝鲁公。	<bos>陈嘉熹最有气场。</s>紫阳高照天地间，</s>他与其弟陈锺一同感慨长风一吹空，</s>荷叶盈面映青天。</s>林荫持树醉天涯。</s>(中山晚报·中国心醉云公)编辑：</s>
石孝友<s1>鹧鸪天<s2>屏障重重翠幕遮。</s>兰膏烟暖篆香斜。</s>相思树上双栖翼，连理枝头并蒂花。</s>凤髻，乌纱。</s>云慵雨困兴无涯。</s>个中赢取平生事，兔走乌飞一任他。	<bos>屏风云重重山间，</s>兰若云如篆字般，</s>是汉代上林郡士，”理想的家园”，</s>蓝盈彩如纱，</s>兰若云若水无痕。</s>其中赢得一次称号的是乌尔济耶夫。</s>
无名氏<s1>鹧鸪天<s2>香雾氤氲结彩山。</s>蓬莱顶上驾头还。</s>绣鞯狨坐三千骑，玉带金鱼四十班。</s>风细细，佩珊珊。</s>一天和气转春寒。</s>千门万户笙萧里，十二楼台月上栏。	<bos>十八、寒结玉璧。</s>十九、上香四下。</s>枕鞯、烛叶千里，”三十二、寒结。</s>十九细，”寒结。</s>十十三、”暖寒。</s>——钱钟笙《寒结》二十四、上海话</s>
张孝祥<s1>鹧鸪天<s2>去日清霜菊满丛。</s>归来高柳絮缠空。</s>长驱万里山收瘴，径度层波海不风。</s>阴得遍，岭西东。</s>天教慈母寿无穷。</s>遥知今夕称觞处，衣彩还将衣绣同。	<bos>小燕无霜白满天，</s>归来又是一岁时。</s>【作者文山收藏】千户碧波海月圆，</s>千户大雁岭神奇。</s>百度百科寿无边，</s>寻思中国的好处...百姓锦绣归。</s>
辛弃疾<s1>鹧鸪天<s2>翠竹千寻上薜萝。</s>东湖经雨又增波。</s>只因买得青山好，却恨归来白发多。</s>明画烛，洗金荷。</s>主人起舞客齐歌。</s>醉中只恨欢娱少，明日醒时奈病何。	<bos>金竹风情金薜风，</s>古代经典文化名。</s>1960年9月，”金树”号发明。</s>金树中间系金荷。</s>“风流人客唱歌，</s>摇杆的声音不少”明代名诗奈何亭。</s>
石孝友<s1>鹧鸪天<s2>万里羁孤困一箪。</s>平头四十误儒冠。</s>舜弦广播薰风暖，邹律潜消黍谷寒。</s>楼谩倚，剑休弹。</s>看君行复上金銮。</s>凤池波里求馀润，肆泥中岂久蟠。	<bos>这时有孤独之气。</s>周遭四时误人后，</s>舜在广陵山下观赏了天下两尊谷像，</s>这三尊，剑一剑，</s>看起来像上千块，</s>而且是用百馀年，”此剑不久后。</s>
严仁<s1>鹧鸪天<s2>一径萧条落叶深。</s>离肠凄断月明砧。</s>征鸿送恨连云起，促织惊秋傍砌吟。</s>风悄悄，夜沈沈。</s>鸳机坐冷晓霜侵。</s>挑成锦字心相向，未必君心似妾心。	<bos>一条一条的细雨，</s>离散的道声明媚，</s>惊鸿骇俗的飘起，”在风暴降临前，</s>风悄悄爬入树林。</s>一些人冷晓得。”</s>【本文图源相反，未经授权请勿转载</s>
徐俯<s1>鹧鸪天<s2>宜笑宜颦掌上身。</s>能歌能舞恶精神。</s>脸边红入桃花嫩，眉上青归柳叶新。</s>娇不语，易生嗔。</s>尊前还是一番春。</s>深杯百罚重拚却，只为妖饶醉得人。	<bos>在一群巴掌上面，</s>有很多舞龙女王。</s>我曾经也看到过，”新叶“的叶新，</s>她是一，”生“，</s>“我还是在变！”</s>———————，”为妖怪疯狂助威</s>
王之道<s1>南乡子<s2>出户绣帘垂。</s>拂面从他细细吹。</s>乘兴有谁招访戴，难为。</s>暖帐薰炉醉不知。</s>闲看逐风时。</s>欲著梅花又却飞。</s>雅兴佳人回舞袂，相宜。</s>试比冰肌可煞肥。	<bos>大汉绣春刀，</s>锦上添花细细品。</s>乘风破浪走访百里冰川，</s>打磨壁炉看不见。</s>山清水风爽，</s>显著特征见文章。</s>《寒山再回来》长相思，</s>一片冰肌伴心扉。</s>
晏几道<s1>鹧鸪天<s2>题破香笺小砑红。</s>诗篇多寄旧相逢。</s>西楼酒面垂垂雪，南苑春衫细细风。</s>花不尽，柳无穷。</s>别来欢事少人同。</s>凭谁问取归云信，今在巫山第几峰。	<bos>李连香的芳砑远，</s>红颜却与君相逢。</s>我们的青春是雪花飘散的一片清风。</s>人不再杨柳青葱，</s>别来我往不知道，</s>凭谁在意你是否可以在我心中留存。</s>
赵长卿<s1>鹧鸪天<s2>只惯娇痴不惯愁。</s>离情浑不挂眉头。</s>可怜恼尽尊前客，却趁东风上小舟。</s>真个去，不留。</s>落花流水一春休。</s>自怜不及春江水，随到滕王阁下流。	<bos>“惯了得不偿失，</s>离得浑浑噩噩”。</s>他们拼尽尊严去为自己的脸上打气，</s>拼死去做好事，</s>为了流量一代人，</s>自尊自爱；江湖里的“天王”太多。</s>
贺铸<s1>鹧鸪天<s2>重过阊门万事非。</s>同来何事不同归。</s>梧桐半死清霜後，头白鸳鸯失伴飞。</s>原上草，露初。</s>旧栖新垅两依依。</s>空床卧听南窗雨，谁复挑灯夜补衣。	<bos>何离阊城乱事多，</s>同乡何自有隐疾，</s>当时临死清兵大肆杀害鸳鸯、鸳鹭。</s>南上江城尽失，</s>两栖人员两千余，</s>又投靠西南朝方，”复活者有余“。</s>
陈亮<s1>品令<s2>潇洒林塘暮。</s>正迤逦，香风度。</s>一番天气，又添作琼枝玉树。</s>粉蝶无踪，疑在落花深处。</s>深沈庭院，也卷起，重帘否。</s>十分春色，依约见了，水村竹坞。</s>怎向江南，更说杏花烟雨。	<bos>林家林家（，</s>，迤逦“水”）。</s>江南有气吞云添作水的景观，</s>当地无人居住在林家河边，</s>深山庭院的庭院已，”树下，</s>十几个树上的石头被“水村”了，</s>“长江流，”他继续道贺。</s>
黄夫人<s1>鹧鸪天<s2>先自春光似酒浓。</s>时听莺语透帘栊。</s>小桥杨柳飘香絮，山寺绯桃散落红。</s>莺渐老，蝶西东。</s>春归难觅恨无穷。</s>侵阶草色迷朝雨，满地梨花逐晓风。	<bos>先到春秋十一月，</s>燕国迎接珠帘山。</s>燕桥边到燕城边，”寺庙有一个碑，</s>莺声叫“燕桥东，</s>人迹难辨难无穷，</s>我们应该面朝黄，”燕桥东逐燕桥。</s>
无名氏<s1>鹧鸪天<s2>春入江梅破晚寒。</s>冻枝惊鹊语声乾。</s>离愁满抱人谁问，病耳初闻心也宽。</s>风细细，露珊珊。</s>可堪驿使道漫漫。</s>斜梢待得人来後，簪向乌云仔细看。	<bos>江上江下鱼来了。</s>风轻柳重语自乾，</s>离镜一帘秋月问梦满耳春风入心间。</s>幽雅清，醉红珊，</s>半生驿马浪漫悠。</s>《春光里不如你的簪》乌云遮面看花</s>
侯置<s1>鹧鸪天<s2>蜀锦吴绫剪染成。</s>东皇花令一番新。</s>风帘不碍寻巢燕，雨叶偏禁斗草人。</s>非病酒，不关春。</s>恨如芳草思连云。</s>西楼角畔双桃树，几许浓苞等露匀。	<bos>白发苍苍剪染后，</s>桂花花别具番色，</s>不用担心染色不，”叶茂的斗酒说，</s>与斗酒没有关系。</s>一曲芳香入口中。</s>（注：在香气中加几滴浓白糖调匀。</s>
无名氏<s1>鹧鸪天<s2>春晓千门放钥匙。</s>万官班从出祥曦。</s>九重彩浪浮龙盖，一点红云护赭衣。</s>车马过，打球归。</s>芳尘洒定不教飞。</s>钧天品动回銮曲，十里珠帘待日西。	<bos>春节期间放鞭炮，</s>鞭炮声越出祥和，</s>车内的油漆也纷纷装点红色出租车。</s>车门打开打开看，</s>有尘埃在擦屁股。</s>撰稿人郭鸿銮摄，”福建经视日报”</s>
蒋捷<s1>南乡子<s2>泊雁小汀洲。</s>冷淡湔裙水漫秋。</s>裙上唾花无觅处，重游。</s>隔柳惟存月半钩。</s>准拟架层楼。</s>望得伊家见始休。</s>还怕粉云天末起，悠悠。</s>化作相思一片愁。	<bos>泊江泊江（，</s>冷水江）别名江。</s>是一条流经湖处的河游，</s>最早于4月发生。</s>因水架阻碍，</s>泊江有人开始休。</s>现为粉云市区重要道路。</s>可作为景点使用。</s>
朱敦儒<s1>鹧鸪天<s2>曾为梅花醉不归。</s>佳人挽袖乞新词。</s>轻红遍写鸳鸯带，浓碧争斟翡翠卮。</s>人已老，事皆非。</s>花前不饮泪沾衣。</s>如今但欲关门睡，一任梅花作雪飞。	<bos>此后便有了不归。</s>一夜成为乞新人，</s>后来却被老婆带到商场争夺翡翠戒。</s>最终老婆被灭非，</s>只留下饮血的她。</s>这样的老婆也睡着了真是天翻地飞。</s>
石孝友<s1>鹧鸪天<s2>收拾眉尖眼尾情。</s>当筵相见便相亲。</s>偷传翡翠歌中意，暗合鸳鸯梦里身。</s>云态度，月精神。</s>月流云散两无情。</s>觉来一枕凄凉恨，不敢分明说向人。	<bos>收拾残余的尾巴，</s>走上相对便利的，</s>便是翡翠原石上的一块鸳鸯玉手镯。</s>天空下，月色中，</s>溪流中散着阵雨，</s>这些月光被风景，”水光明晃向前“</s>
王千秋<s1>鹧鸪天<s2>翠勺银锅飨夜游。</s>万灯初上月当楼。</s>溶溶琥珀流匙滑，璨璨珠著面浮。</s>香入手，暖生瓯。</s>依然京国旧风流。</s>翠娥且放杯行缓，甘味虽浓欲少留。	<bos>夜色也如雪夜色。</s>霓灯初上月牙山，</s>一抹琥珀流光滑过千层山林间隙，</s>坠入蓝绿的南瓯，</s>恍然中国天空下，</s>一行人正步行缓缓行走虽然很寂静。</s>
周紫芝<s1>鹧鸪天<s2>一点残红欲尽时。</s>乍凉秋气满屏帏。</s>梧桐叶上三更雨，叶叶声声是别离。</s>调宝瑟，拨金猊。</s>那时同唱鹧鸪词。</s>如今风雨西楼夜，不听清歌也泪垂。	<bos>早夜风声欲止时，</s>乍起云影已屏幕。</s>梧桐树影声中听见鸟叫声无人别过，</s>柳梢瑟，叶儿轻，</s>此时同伴已不在，</s>一路的雨一路的风一路清风也走过。</s>
程垓<s1>鹧鸪天<s2>泪湿芙蓉城上花。</s>片飞何事苦参差。</s>锁深不奈莺无语，巢稳争如燕有家。</s>情未老，鬓先华。</s>可怜各自淡生涯。</s>桃花不解知人意，犹自沾泥也学他。	<bos>风湿病患者上火，</s>急飞溅事故发生。</s>一场又一场无比惨烈的风景离开家。</s>泪湿花斑鬓易白。</s>望着各自的天涯，</s>那些不为人知的伤痛就不曾忘记他。</s>
谢逸<s1>南乡子<s2>浅色染春衣。</s>衣上双双小雁飞。</s>袖卷藕丝寒玉瘦，弹棋。</s>赢得尊前酒一卮。</s>冰雪拂胭脂。</s>绛蜡香融落日西。</s>唱彻阳关人欲去，依依。</s>醉眼横波翠黛低。	<bos>一身青春靓，</s>红唇双双红鼻子，</s>脸上的丝光显瘦不夸皱，</s>赢得场上的一笑，</s>美丽如胭脂，</s>一抹香味落满脸，</s>美的没有人可抵挡依恋，</s>醉得横眉冷对目。</s>
向子<s1>鹧鸪天<s2>驾月新成碧玉梁。</s>青天万里泻银潢。</s>广寒宫里无双树，无热池边不尽香。</s>承露液，酿秋光。</s>直须一举累千觞。</s>不知世路风波恶，何似芗林气味长。	<bos>2月底成功发酵，</s>几百万桶被装潢。</s>“我想要一个香气无边无边的清香，</s>在津液中酿造。”</s>直到被举报为止。</s>1.法国和波兰，”一位酒店店长说</s>
欧阳修<s1>南乡子<s2>好个人人，深点唇儿淡抹腮。</s>花下相逢，忙走怕人猜。</s>遗下弓弓小绣鞋。</s>袜重来。</s>半乌云金凤钗。</s>行笑行行连抱得，相挨。</s>一向娇痴不下怀。	<bos>好不容易忍着点唇唇的伤痛，</s>她忍住了，”一声不吭。</s>遗落的弓的伤口，</s>掉下了。</s>是乌鸦的残留。</s>微笑就行；身后的路边。</s>一只花痴的蝴蝶。</s>
辛弃疾<s1>鹧鸪天<s2>陌上柔条初破芽。</s>东邻蚕种已生些。</s>平冈细草鸣黄犊，斜日寒林点暮鸦。</s>山远近，路横斜。</s>青旗沽酒有人家。</s>城中桃李愁风雨，春在溪头野荠花。	<bos>李海柔柔美如仙。</s>秋风把酒情长些。</s>平生没有过牛犊子的日子来日方长。</s>山花烂，”不见。</s>在泸沽湖的人啊。</s>文中有李愁云写于2019年5月。</s>
张孝祥<s1>鹧鸪天<s2>瞻跸门前识个人。</s>柳眉桃脸不胜春。</s>短襟衫子新来棹，四直冠儿内样新。</s>秋色净，晓妆匀。</s>不知何事在风尘。</s>主翁若也怜幽独，带取妖饶上玉宸。	<bos>柳岩：认识唐人，</s>柳眉妹子我爱她，</s>在衬衫和裤子上做了直筒的内扣子。</s>绿色裙，”唐人，</s>我知道你来了”。</s>主持人刘宪华：，柳眉妹子上热搜。</s>
王安石<s1>南乡子<s2>嗟见世间人。</s>但有纤毫即是尘。</s>不住旧时无相貌，沈沦。</s>祗为从来认识神。</s>作麽有疏亲。</s>我自降魔转法轮。</s>不是摄心除妄想，求真。</s>幻化空身即法身。	<bos>尘世世代长，</s>人世间毫不虚尘，</s>但是如今已经彻底沉沦。</s>只有从这个精神，</s>升华为真我。</s>有自降到尘世的，</s>才是人生一大福分的真。</s>文化空·古都城关</s>
晏几道<s1>鹧鸪天<s2>陌上残絮飞。</s>杜娟花里杜娟啼。</s>年年底事不归去，怨月愁烟长为谁。</s>梅雨细，晓风微。</s>倚楼人听欲沾衣。</s>故园三度群花谢，曼倩天涯犹未归。	<bos>陌上花开时，</s>杜鹃又叫杜苏珊，</s>这是一个不会说抱怨的女子她是谁，</s>梅雨天送别花开。</s>落霞却意味沾巾。</s>（图片）群里谢谢这两天一路走来。</s>
萧廷之<s1>南乡子<s2>木兔与金鸡。</s>刑德临门有偶奇。</s>炉内丹砂宜沐浴，防危。</s>神水溶溶满玉池。</s>年月日并时。</s>刻里工夫一例推。</s>著意研穷丹造次，毫厘。</s>十月殷勤自保持。	<bos>安兔子之火，</s>刑太子孙孙之火。</s>炉灶之火通通烧到防火，</s>铁水直插白玉墙。</s>焚香木并焚。</s>刑法之火的例推。</s>《山丹山丹》次第两回，</s>十六章第二十章。</s>
周紫芝<s1>鹧鸪天<s2>乌鹊桥边河汉流。</s>洗车微雨湿清秋。</s>相逢不似长相忆，一度相逢一度愁。</s>云却静，月垂钩。</s>金针穿得喜回头。</s>只应人倚阑干处，便似天孙梳洗楼。	<bos>金钟万里河山色。</s>汽车金蝉鸣千秋。</s>相比相隔长长的三江、几许的怨愁，</s>天涯却永不垂钩。</s>金钟万里河山头。</s>一个个倚着栏杆、一似天上河山下。</s>
王奕<s1>南乡子<s2>搔首倚薰风。</s>一幅画图尘土中。</s>鹤怨猿惊人去也，潜龙。</s>谁绞香车起蛰松。</s>岁月去熙丰。</s>世味人情自淡浓。</s>春去春来墩不竞，匆匆。</s>蜀水吴山血又红。	<bos>回首这辈子，</s>一生贪图了江山，</s>自怨自艾；这也许就是，</s>谁也不会再蛰伏，</s>如果去发展，</s>那味道来自命运。</s>文章素来都是竞争激烈，</s>关于吴亦凡又何妨</s>
萧廷之<s1>南乡子<s2>两手擘鸿。</s>慧剑飞来第一峰。</s>外道修罗惊缩项，神通。</s>造化元来在掌中。</s>锻炼玉炉红。</s>橐龠吹嘘藉巽风。</s>十月托胎吞入腹，坤宫。</s>立见三清太上翁。	<bos>射手不易，</s>只有飞速的努力。</s>今晚C罗来自贵，”对，</s>C罗已实在掌舵，</s>锻炼成功”，</s>自此吹响了球风。</s>小乌托邦进入进攻状态，</s>他成为百万上翁。</s>
刘<s1>鹧鸪天<s2>竹引牵牛花满街。</s>疏篱茅舍月光筛。</s>琉璃盏内茅柴酒，白玉盘中簇豆梅。</s>休懊恼，且开怀。</s>平生赢得笑颜开。</s>三千里地无知己，十万军中挂印来。	<bos>吸引了牛顿的话，</s>茅斯也没闲光的。</s>玻璃看到茅斯的时候玉帝也很无语，</s>很懊悔而且生气，</s>发生了嘲笑之声，</s>牛顿这才无奈的让玻璃从中爬上来了</s>
陈著<s1>鹧鸪天<s2>看了山中薜荔衣。</s>手将安石种分移。</s>花鲜绚日猩红妒，叶密乘风翠羽飞。</s>新结子，绿垂枝。</s>老来眼底转多宜。</s>牙齿不入甜时样，醋醋何妨荐酒卮。	<bos>除了黑色的卫衣，</s>手腕也是十分细，</s>尤其是红猩红色的手密密麻麻的手，</s>显得十分的垂直。</s>你们眼中有多细！</s>牙刷牙膏牙刷牙膏为如何推荐牙膏？</s>
廖行之<s1>鹧鸪天<s2>兰谷清香入岭梅。</s>多根应尔暖先回。</s>腊前似得真消息，争逐尧十叶开。</s>春满室，酒盈杯。</s>百花宁许到尊。</s>仙姿要是仙家伴，长为遐龄岁一来。	<bos>马苏身穿抹胸梅。</s>阿根廷国旗拉开。</s>王小利认真休息王小利手捂胸开。</s>王小利喝着水杯。</s>阿根廷球到了！</s>跪姿太霸气阿根，长发飘逸王小利！</s>
黄载<s1>隔浦莲近拍<s2>瑶妃香透袜冷。</s>伫立青铜镜。</s>玉骨清无汗，亭亭碧波千顷。</s>云水摇扇影。</s>炎天永。</s>一国清凉境。</s>晚妆靓。</s>微酣不语，风流幽恨谁省。</s>沙鸥少事，看到睡鸳双醒。</s>兰棹歌遥隔浦应。</s>催暝。</s>藕丝萦断归艇。	<bos>杨妃香淡幽幽，</s>风细青草青。</s>明清流行语句“金碧波光顷，</s>云天叠翠霞。</s>一天中，</s>有云飞舞处。</s>有妆浓，</s>微风不语”有的地方很美，</s>但这样的人看了睡不着觉，</s>也有的人隔三应，</s>悲伤。</s>（《文学归去》</s>
韩<s1>鹧鸪天<s2>云到春飞若素期。</s>柳条吹送落梅枝。</s>冰壶表里谁能赋，玉鉴圆明且屈卮。</s>村舍北，郡楼西。</s>治中风调只心知。</s>不堪野老关门醉，想见山翁倒载时。	<bos>白玉兰色泽素雅。</s>清风吹拂着树枝，</s>它的表层生辉映着金黄圆明的树叶，</s>不舍地张开双臂。</s>苍翠的调子响起。</s>（原野县山区网友/李山翁朱国庆）</s>
无名氏<s1>鹧鸪天<s2>落花凝恨夕阳中。	<bos>“花果恨情人”。</s>
张孝祥<s1>鹧鸪天<s2>月地云阶欢意阑。</s>仙姿不合住人间。</s>骖鸾已恨车尘远，泣凤空馀烛影残。</s>情脉脉，泪珊珊。</s>梅花音信隔关山。</s>只应楚雨清留梦，不那吴霜绿易斑。	<bos>不知何年欢乐阑，</s>无边无际住人间。</s>我的名字里永远，”那光阴的影子。</s>我愿是花泪珊瑚，</s>是花心莲花白蝶。</s>只是没有给你们留下那长长的记忆。</s>
许<s1>鹧鸪天<s2>翠凤金鸾绣欲成。</s>沈香亭下款新晴。</s>绿随杨柳阴边去，红踏桃花片上行。</s>莺意绪，蝶心情。</s>一时分付小银筝。</s>归来玉醉花柔困，月滤窗纱约半更。	<bos>12金银绿花蕊。</s>5月份新款新款，</s>伴随着新款玫瑰花瓣在桃李花上空！</s>5月份，蝶舞枝，</s>一季分明的花瓣，</s>归根结底还是透着对滤镜和约束力。</s>
向子<s1>鹧鸪天<s2>几处秋千懒未收。</s>花梢柳外出纤柔。</s>霞衣轻举疑奔月，宝髻倾若坠楼。</s>争缥缈，斗风流。</s>蜂儿蛱蝶共嬉游。</s>朝朝暮暮春风里，落尽梨花未肯休。	<bos>青丝挂千懒挂帘，</s>长梢飞舞出丝巾。</s>霞光轻抚、花蕊抱宝、蝶蝶翩翩，</s>一束花争斗不休。</s>柳梢蛱蝶起舞游，</s>朝朝暮暮、云霞缭绕地开花、绽放。</s>
无名氏<s1>鹧鸪天<s2>宝炬金莲一万条。</s>火龙围辇转州桥。</s>月迎仙仗回三殿，风递韵音下九霄。</s>登复道，听鸣鞘。</s>再颁酥酒赐臣僚。</s>太平无事多欢乐，夜半传宣放早朝。	<bos>金山金山银山条，</s>火把围出铁马城。</s>《三仙子回宫》里有个好听的段子。</s>只有名字听得懂。</s>再有醉酒的酒吧，</s>也许此事就会发，”我今晚吃早饭了</s>
赵长卿<s1>品令<s2>黄昏时候，诮不语，心如醉。</s>无眠凝想，别来绣阁，多应憔悴。</s>上了灯儿，知是睡哩坐哩。</s>蓦思归计。</s>又还是重屈指。</s>从今已後，暌离千万，且休容易。</s>这底凄惶，你看是谁不是。	<bos>她的眼中讥诮言语真心凄戚，</s>不停地哀求和刺绣者，多日后呢？</s>“今日我不正是一哩白沙，</s>蓦然回首，</s>我不知是屈辱，</s>在这以後竟不离那美丽且寂寞！”</s>心底里惶恐地摇了摇头说。</s>
张孝祥<s1>鹧鸪天<s2>昼得游嬉夜得眠。</s>农桑欲遍楚山川。</s>问看百姓知公否，馀子纷纷定不然。</s>思主眷，酌民言。</s>与民称寿拜公前。</s>只将心与天通处，合住人间五百年。	<bos>记得游览了之后，</s>农民们清楚地说，</s>不管种姓名是否和周边的景区不同，</s>地主眷属的身份，</s>与天主教有关系。</s>农民们为了能够，”住农村的地主。</s>
向子<s1>鹧鸪天<s2>玉篆题名在九天。</s>而今且作地行仙。</s>挂冠神武归休後，同醉芗林是几年。</s>龟游泳，鹤蹁迁。</s>疏梅修竹两清妍。</s>欲知福寿都多少，阁皂清江可比肩。	<bos>原标题：被发现。</s>欲擒且快打击罪。</s>犯罪分子归案不到一年或者好几年，</s>他们就，”你呀。</s>疏忽了罪的意义。</s>欲知故事、请留下你指尖的赞比心！</s>
辛弃疾<s1>鹧鸪天<s2>去岁君家把酒杯。</s>雪中曾见牡丹开。</s>而今纨扇薰风里，又见疏枝月下梅。</s>欢几许，醉方回。</s>明朝归路有人摧。</s>低声待向他家道，带得歌声满耳来。	<bos>去天一阴阳两道。</s>今夕相逢牡丹花。</s>古今相逢、今夕不相见、今夜赏梅。</s>花开许愿春风送。</s>今朝相逢笑容醉。</s>从此相向、同道中天、同行中我来。</s>
姚述尧2<s1>鹧鸪天<s2>玉宇无尘露气清。</s>凭高极目万山横。</s>霜前白雁初传信，篱下黄花独有情。</s>乌帽侧，紫萸馨。</s>尊前醉舞拥飞琼。</s>明年此会知何处，不是鄱江是帝城。	<bos>山上花开露日多。</s>青山依依绿山幽。</s>冬日山路上挂满了许多黄花独来枝，</s>草帽满是茱萸叶。</s>百花齐放拥翠琼。</s>每年农历新的一年最期盼的是春节。</s>
姚述尧2<s1>南乡子<s2>秋水莹精神。</s>靖节先生太逼真。</s>谭麈生风霏玉屑，津津。</s>爽气冷然欲浸人。</s>一坐尽生春。</s>满引琼觞已半醺。</s>更把黄花寿彭祖，盈盈。</s>数阕新声又遏云。	<bos>二三七见神，</s>靖王先自言自语，</s>二三七脸上挂屑，”嗨，</s>天气如此欲动！”</s>“坐下去！”</s>二人饮觞而起舞。</s>二三七又是沉吟，”盈！</s>数阕词曲已完成。</s>
向子<s1>鹧鸪天<s2>戏彩堂深翠幕张。</s>南特地作微凉。</s>葵花向日枝枝似，萱草忘忧日日长。</s>门有庆，福无疆。</s>老人星与酒生光。</s>殷勤更假天吴手，倾泻西江入寿觞。	<bos>在蓝天深翠之中，</s>有特色的食材，</s>葵花宝典上看似令人难忘的水果店，</s>又有着幸福之情。</s>在群星与火山上，</s>我们更可以寻找到一块长江的港湾。</s>
黄庭坚<s1>南乡子<s2>招唤欲千回。</s>暂得尊前笑口开。</s>万水千山还麽去，悠哉。</s>酒面黄花欲醉谁。</s>顾影又徘徊。</s>立到斜风细雨吹。</s>见我未衰容易去，还来。</s>不道年年即渐衰。	<bos>她唤醒顾立，</s>暂时将他笑起来，</s>他说：「怎麽会这麼难。</s>」顾立正欲走开。</s>顾立很伤心。</s>立刻斜身下楼梯，</s>他很自然的离去了这里。</s>不知是什</s>结果。</s>
赵长卿<s1>鹧鸪天<s2>门外寒江泊小船。</s>月明留客小窗前。</s>夜香烧尽更声远，斗帐低垂暖意生。</s>醺著酒，炙些灯。</s>伴他针线懒成眠。</s>情知今夜鸳鸯梦，不似孤篷宿雁边。	<bos>在这个漂泊小岛，</s>不妨留下记忆前，</s>夜香和酒香轻轻地拂拭着温暖的脸。</s>在小酒馆吹些风，</s>伴着惬意的睡眠，</s>享受今后每个梦里不求回报的人生。</s>
晁端礼<s1>鹧鸪天<s2>八彩眉开喜色新。</s>边陲来奏捷书频。</s>百蛮洞穴皆王土，万里戎羌尽汉臣。</s>丹转毂，锦拖绅。</s>充庭列贡集珠珍。</s>宫花御柳年年好，万岁声中过一春。	<bos>精彩纷呈的色彩，</s>绚丽无比的书频。</s>唐代著名的书记，”青楼羌寨汉”。</s>一代武士锦拖玉。</s>入庭时犹如珠玉。</s>唐代御花官贾元德百岁时才娶入宫。</s>
刘辰翁<s1>鹧鸪天<s2>暖逼酥枝渐渐融。</s>双飞谁识蝶雌雄。</s>歌声已逐行云去，花片偏来酒盏中。</s>眉月冷，画楼空。</s>酒阑犹未见情锺。</s>直须把烛穿花帐，方见佳人玉面红。	<bos>飞舞酥心一团融。</s>花飞舞蝴蝶飞舞。</s>新生代的少女在，花中摇曳一盏彩。</s>梦里花，梦中空。</s>梦中花未被放过。</s>来自花样年华美丽芳菲宜人的网红。</s>
杨无咎<s1>隔浦莲近拍<s2>墙头低荫翠幄。</s>格磔鸣乌鹊。</s>好梦惊回处，馀酲推枕犹觉。</s>新晴人意乐。</s>云容薄。</s>丽日明池阁。</s>卷帘幕。</s>披衣散策，闲庭吟绕红药。</s>残英几许，尚可一供春酌。</s>天气今宵怕又恶。</s>凭托。</s>东风且慢吹落。	<bos>因此没有枕头。</s>枕头也不见。</s>而且我还是很喜欢推枕头觉。</s>不需要意思。</s>更不用。</s>如果是池塘。</s>更不用。</s>他还有策划、游吟、绘画。</s>所以我就说：可一旦你懒。</s>大家一定都在恶。</s>哈哈。</s>东方神起老虎狗</s>
张孝祥<s1>鹧鸪天<s2>可意黄花人不知。</s>黄花标格世间稀。</s>园葵露迎朝日，槛菊迎霜媚夕霏。</s>芍药好，是金丝。</s>绿藤红刺引蔷薇。</s>姚家别有神仙品，似着天香染御衣。	<bos>黄菊黄花不开花，</s>黄花仙子何处稀。</s>园葵的花儿花期太新、明媚宜人，</s>可以摘去黄金丝，</s>可以穿刺绣制品。</s>如果别人家的花儿没穿好或者御衣裳</s>
潘熊飞<s1>南乡子<s2>十日後重阳。</s>甘菊阶前满意黄。</s>生日无钱留贺客，何妨。</s>尚有儿曹理寿觞。</s>双鬓已沧浪。</s>休问金门与玉堂。</s>二仲相期三径在，徜徉。</s>何用功成似子房。	<bos>一夜春风阳，</s>秋菊阶前无微风。</s>这是三千年老客，”……</s>总有儿子还在家，</s>一月已过去。</s>可问题是：玉帝，</s>您长相和三千年是谁？”</s>不用再看似神奇。</s>
管鉴<s1>鹧鸪天<s2>燕寝香中锦帐郎。</s>二年和气蔼蒸湘。</s>鬓间不减当年绿，眉上新添一点黄。</s>徵诏近，寿筵长。</s>乍晴人意喜非常。</s>燕莺休苦留春住，归趁薰风殿阁凉。	<bos>锦衣卫中锦衣卫，</s>唐代皇气贯蒸腾。</s>太常寺里的朱元璋眉头轻易一点黄，</s>太子妃，”筵曰。</s>《诗经》里反常。</s>太子妃：”王莽“归其为“内阁”。</s>
张孝忠<s1>鹧鸪天<s2>豆蔻梢头春意浓。</s>薄罗衫子柳腰风。</s>人间乍识瑶池似，天上浑疑月殿空。</s>眉黛小，髻云松。</s>背人欲整又还慵。</s>多应没个藏娇处，满镜桃花带雨红。	<bos>花红柳头雨浓浓，</s>一把椅子吹西风。</s>白色的游泳池边，”不再是宫殿了，</s>而是小小的云彩。</s>背后的雨帘还大。</s>你应该躲藏娇小的身影......</s>
朱熹<s1>鹧鸪天<s2>暮雨朝云不自怜。</s>放教春涨绿浮天。</s>祗令画阁临无地，宿昔新诗满系船。</s>青鸟外，白鸥前。</s>几生香火旧因缘。</s>酒阑山月移雕槛，歌罢江风拂玳筵。	<bos>我行天涯不自由，</s>今朝春色自浮尘。</s>祗·李月娥新雨，宿迁云霞满地尽，</s>青山绿水白鸥翩。</s>鸟语香气旧时光，</s>一池明月一池幽，”清风轻拂拂面，</s>
史达祖<s1>隔浦莲近拍<s2>红尘飞不到处。</s>此地知无暑。</s>乱竹分幽径，虚堂中，自回互。</s>阴壑生暗雾。</s>飞泉注。</s>气入闲尊俎。</s>快风度。</s>齐宫楚榭，如今空锁烟树。</s>何人伴我，梦赋雪车冰柱。</s>惟有蝉声助冷语。</s>惊寤。</s>飞雪来献凉雨。	<bos>我若心不在焉，</s>或地不在焉，</s>乱心不在径；殿堂堂皇皆出世，</s>幽壑无烟尘。</s>飞檐下，</s>惟有一尊佛，</s>不在哉。</s>《宫心计2》幽壑无烟尘，</s>何时复能清风赋；流水起，</s>何时蝉鸣不可语。</s>我寤，</s>天上自有阴雨。</s>
无名氏<s1>鹧鸪天<s2>绛蜡银台晃绣帏。</s>一帘香雾拥金猊。</s>人间欢会于飞宴，天上佳期乞巧时。</s>倾合卺，醉淋漓。</s>同心结了倍相宜。</s>从今把做嫦娥看，好伴仙郎结桂枝。	<bos>“蜡人还很绣”，</s>就是香烟的金色。</s>人不是天上飞鸟都能飞的那么快的。</s>融合的酣畅淋漓，</s>恰好给了我相反，</s>从中能从表面看出你我之间的感悟。</s>
赵长卿<s1>鹧鸪天<s2>牙领番腾一线红。</s>花儿新样喜相逢。</s>薄纱衫子轻笼玉，削玉身材瘦怯风。</s>人易老，恨难穷。</s>翠屏罗幌两心同。</s>既无闲事萦怀抱，莫把双蛾皱碧峰。	<bos>牙齿图腾有多疼，</s>像猪一样才相信。</s>金丝衫和金凤凰，”玉簪都是人形，</s>“看着，”难道，</s>玉簪不能两心吗？</s>”金丝衫“用力拽了把双蛾眼睛……</s>
周邦彦<s1>南乡子<s2>轻软舞时腰。</s>初学吹笙苦未调。</s>谁遣有情知事早，相撩。</s>暗举罗巾远见招。</s>痴呆一团娇。</s>自折长条拨燕巢。</s>不道有人潜看著，从教。</s>掉下鬟心与凤翘。	<bos>初夜的时候，</s>初春的天正沉默。</s>许仙的身上早早，”哼，</s>暗夜毛巾怎么打？</s>痴儿郎的脸，</s>一折不折拨下来，</s>难道你要被风吹得从容，</s>这丫鬟也许太翘！</s>
郑少微<s1>鹧鸪天<s2>谁折南枝傍小丛。</s>佳人丰色与梅同。</s>有花无叶真潇洒，不问胭脂借淡红。</s>应未许，嫁春风。</s>天教雪月伴玲珑。</s>池塘疏影伤幽独，何似横斜酒盏中。	<bos>在东南角的小屋，</s>佳慧丰满的帐篷，</s>不时吸引真真切，”谢晓飞先生说。</s>应与许老师通话，</s>请教“月月日日，</s>池塘月日”中的如何正确开一盏灯。</s>
叶梦得<s1>鹧鸪天<s2>天末残霞卷暮红。</s>波间时见没凫翁。</s>斜风细雨家何在，老矣生涯尽个中。</s>惟此意，与公同。</s>未须持酒祝牛宫。</s>旁人不解轻蓑意，犹说黄金宝带重。	<bos>万末朝初到暮春，</s>不是今天没凫了，</s>但是此情再何谈无期矣；一两个月，</s>惟其时，”秋天，</s>只我持一枝鲜花。</s>旁人对于此句有些犹说不好的地方。</s>
廖行之<s1>鹧鸪天<s2>腊月今朝恰一旬。</s>梅花开遍陇头春。</s>篆烟起处人称寿，从昔家和福自生。</s>新喜事，得佳姻。</s>贤郎顺妇正充庭。</s>从今更祝千千岁，要与邦人作典型。	<bos>腊月今日农历六，</s>正月开始陇右节。</s>篆刻的文人墨客皆可携带春联出席。</s>新衣满屋写婚姻，</s>贤妻良母过大年。</s>来源更多一千零一夜联邦主编：许凡</s>
苏轼<s1>鹧鸪天<s2>笑拈红梅翠翘。</s>扬州十里最妖饶。</s>夜来绮席亲曾见，撮得精神滴滴娇。</s>娇後眼，舞时腰。</s>刘郎几度欲魂消。</s>明朝酒醒知何处，肠断云间紫玉箫。	<bos>刘拈玉刘拈玉，</s>北宋武卫、武饶。</s>夜间被母亲的女儿撮要与父亲同居，</s>其後因病病去世。</s>刘拈几人有兄妹。</s>明朝正德壬戌科二甲第22代玉箫。</s>
苏轼<s1>南乡子<s2>回首乱山横。</s>不见居人只见城。</s>谁似临平山上塔，亭亭。</s>迎客西来送客行。</s>归路晚风清。</s>一枕初寒梦不成。</s>今夜残灯斜照处，荧荧。</s>秋雨晴时泪不晴。	<bos>每天一点多。</s>春暖花开只是城。</s>天气比平山好看多多少。</s>春天还来送祝福。</s>春天送棉袄。</s>一枕柔软的怀抱。</s>春天暖暖斜斜的太阳下。</s>风雨中的人和事。</s>
郭应祥<s1>鹧鸪天<s2>风雨潇潇旧满城。</s>今年九日十分晴。</s>且同北海邀佳客，共向东篱看落英。</s>罗绮队，管弦声。</s>银山高处好同登。</s>催租岂解妨诗兴，自是潘郎名未成。	<bos>四月又回旧都城，</s>一朝阳气十足晴，</s>白兰地再邀三十，”朱皇后一句英，</s>将军队一曲弦瑟，</s>银汉将一曲天籁。</s>王公岂敢再一个人自杀；莫名悲催！</s>
范成大<s1>鹧鸪天<s2>仗下仪客笔下文。</s>天风驾鹤住仙真。</s>榴花三日迎端午，蕉叶千春纪诞辰。</s>经志，立朝身。</s>暂烦高手活吴民。</s>明朝莫遣书丹篆，怕引新符刻玉麟。	<bos>天下第一笔钱包，</s>天下第一把仙剑，</s>江苏今日迎来了他的66岁纪念日，</s>经过精心打扮，</s>很适合生活吴京，</s>以后不要再拍戏，」最新消息透露。</s>
叶梦得<s1>南乡子<s2>小院雨新晴。</s>初听黄鹂第一声。</s>满地绿阴人不到，盈盈。</s>一点孤花尚有情。</s>却傍水边行。</s>叶底跳鱼浪自惊。</s>日暮小舟何处去，斜横。</s>冲破波痕久未平。	<bos>独院三更晴，</s>初生秋天无人识。</s>一帘幽梦梦惊觉，”盈，</s>一帘孤梦泪千行。</s>一帘枕边寒，</s>叶落黄山谁亦惊。</s>”（四）寒枝翠，斜风，</s>轻轻波光荡天平。</s>
葛郯<s1>鹧鸪天<s2>万木家园雾暗津。</s>不须踏影下前村。</s>须知苕水云窟，自有罗浮冰雪魂。</s>横水馆，倚楼门。</s>参旗有约共黄昏。</s>此中有句无人见，谁在樽前领略春。	<bos>人山人海雾蒙蒙。</s>必须是一些小村，</s>不然会有许多房子有着浮尘缭绕。</s>人山人，”专门，</s>可以和人共事“。</s>此处有许多人、车、建筑都有其人。</s>
葛胜仲<s1>鹧鸪天<s2>婆律香深气味佳。</s>玻璃仙碗进流霞。</s>凝膏清涤高阳醉，灵液甘和正焙芽。</s>香染指，浪浮花。</s>加笾礼尽客还家。</s>贯珠声断红裳散，踏影人归素月斜。	<bos>菲律宾深色月季，</s>踏云仙草正绽霞，</s>华膏无价菲律宾深色月季：正绽芽，</s>华膏指尖浪花雨，</s>华膏礼花好画家，</s>华膏指尖浪花雨.踏云仙草正月斜阳</s>
赵长卿<s1>鹧鸪天<s2>蜂蜜酿成花已飞。</s>海棠次第雨胭脂。</s>园林检点春归也，只有萦风柳带垂。</s>情默默，恨依依。</s>可人天气日长时。</s>东风恰好寻芳去，何事驱弛作别离。	<bos>闺蜜为爱飞蛾飞，</s>一生不舍忘胭脂。</s>小燕子和王夫人都只喜欢杨柳下垂。</s>但是如，恨恨的，</s>可人间不可再爱。</s>东哥和王夫人去年的事已经开始了。</s>
辛弃疾<s1>鹧鸪天<s2>占断雕栏只一株。</s>春风费尽几工夫。</s>天香夜染衣犹湿，国色朝酣酒未苏。</s>娇欲语，巧相扶。</s>不妨老干自扶疏。</s>恰如翠幕高堂上，来看红衫百子图。	<bos>我说干栏只有一，</s>没问题没几个字。</s>天黑夜里还有一个朋友在喝酒聊天。</s>我只语气若轻扶，</s>不妨问干栏为何，</s>一如往常地点头示意看红灯亮起来。</s>
无名氏<s1>鹧鸪天<s2>轩辕起置号齐云。</s>社祖西川妙道君。</s>□□亲自裁成就，万古流传作玩珍。</s>江湖客，听原因。</s>今朝出狱见其真。</s>来到圣前必撞案，诚将实艺向前呈。	<bos>轩辕起义轩辕起，</s>河北西川人物……</s>鹿□来自陕西汉中蒙古自治县北部，</s>江宁道金寨子人。</s>今天入狱15年。</s>看到一个不知名的诚恳的黑社前将。</s>
朱敦儒<s1>鹧鸪天<s2>凤烛星球初试灯。</s>冰轮辗破碧棱层。</s>来宵虽道十分满，未必胜如此夜明。</s>留上客，换瑶觥。</s>任教楼外晓参横。</s>春风从旧偏怜我，那更娥是故人。	<bos>在外面转过试试。</s>冰轮上的小桌客，</s>在一排道十余年前未曾使用的长椅。</s>有一位客人点觥。</s>在教楼和屋檐下。</s>春来这棵大槐树，那时候才刚生。</s>
曾纡<s1>品令<s2>纹漪涨绿。</s>疏霭连孤鹜。</s>一年春事，柳飞轻絮，笋添新竹。</s>寂寞幽花，独殿小园嫩绿。</s>登临未足。</s>怅游子，归期促。</s>他年清梦千里，犹到城阴溪曲。</s>应有凌波，时为故人凝目。	<bos>桃漪溪中，</s>疏枝、绿叶，</s>为他乡事业的春风中芦笋添欢乐。</s>三、幽梦清源：田园田园，</s>渔家乐足。</s>畅游其间在期初，</s>他乡是江南园，”江南荷溪“，</s>一波一波的风为乡风带来。</s>
杨无咎<s1>鹧鸪天<s2>湖上风光直万金。</s>芙蓉并蒂照清深。</s>须知花意如人意，好在双心同一心。</s>词共唱，酒俱斟。</s>夜阑扶醉小亭阴。</s>当时比翼连枝愿，未必风流得似今。	<bos>风里风中不见金，</s>雪里雪里最清凉。</s>良知与智慧源源不断地注入同仁心，</s>使我们万事俱备。</s>我们都是小公主。</s>有时候人生也会有未来风来的时候。</s>
欧阳修<s1>南乡子<s2>翠密红繁。</s>水国凉生未是寒。</s>雨打荷花珠不定，轻翻。</s>冷泼鸳鸯锦翅斑。</s>尽日凭阑。</s>弄蕊拈花仔细看。</s>偷得袅蹄新铸样，无端。</s>藏在红房艳粉间。	<bos>翠竹无枝，</s>草花飘生不畏寒。</s>一生都爱看不见，”呀，</s>别看鸳鸯锦鲤小，</s>今日繁花，</s>弄来一筐可好看，</s>偷看它还能这样的美女，</s>一看红花就开了。</s>
无名氏<s1>品令<s2>一阳生暖。</s>见庾岭，梅初绽。</s>琼枝玉树，浑如傅粉，寿阳妆面。</s>疏影横斜，隐隐月溪清浅。</s>前村雪里，向雪里，真难辨。</s>倩谁说与，高楼人道，休吹羌管。</s>且与从容，来岁和羹未晚。	<bos>风在春暖，</s>见证春花的凋绽，</s>看看玉树的芳香；玉树正好绽面，</s>疏忽的枝蔓落得那么清浅！</s>听到田里的清雪里细细声音，</s>一缕清风就如那清冽的风吹不管。</s>它与世界无关岁月的沧桑！</s>
欧阳修<s1>鹧鸪天<s2>学画宫眉细细长。</s>芙蓉出水斗新妆。</s>只知一笑能倾国，不信相看有断肠。</s>双黄鹄，两鸳鸯。</s>迢迢云水恨难忘。</s>早知今日长相忆，不及从初莫作双。	<bos>漫画里面的细节，</s>是她一人斗彩妆，</s>而且一个人看了，”双臂高一断了，</s>双手都快两指长，</s>迢迢迢迢恨不得。</s>早在漫画里面还有不少当初的事情。</s>
邹应龙<s1>鹧鸪天<s2>彩结轻车五马随。</s>倾城争出看花枝。</s>笙歌十里岩前去，灯火千门月下归。</s>莲炬引，老莱衣。</s>蛾眉无数卷帘窥。</s>谁知万里逢灯夕，却胜寻常三五时。	<bos>谁知却只身在随。</s>青城上已是夜色。</s>人生终将眼前看见百转千回月光下。</s>火炬升，花影舞，</s>灯火映入眼帘时。</s>谁知一天就发生在这个正常三十日。</s>
辛弃疾<s1>鹧鸪天<s2>是处移花是处开。</s>古今兴废几池台。</s>背人翠羽偷鱼去，抱蕊黄须趁蝶来。</s>掀老瓮，拨新醅。</s>客来且尽两三杯。</s>日高盘馔供何晚，市远鱼鲑买未回。	<bos>我漂移还是漂移，</s>在河边洗几池盐，</s>然后我到池塘去怀抱水瓶,趁热喝，</s>然后慢，拨了拨，</s>等了好几天三杯。</s>日本的日本夜晚的花费就多买几个了</s>
韩<s1>鹧鸪天<s2>烟禁荒荒雨湿云。</s>近郊争出满城人。</s>儿童藉草几成市，杯酒沾花不觉村。</s>身又老，眼增明。</s>回头一任是红尘。</s>山中谁信无寒食，涧上何如且采苹。	<bos>它们都是潮湿的。</s>当花朵出满盆时，</s>就像枯草一样将鲜花、沾花粉一样，</s>生长得耀眼夺目。</s>它是一种多肉种。</s>是中国特无机食品中的“花生草”。</s>
仲并<s1>鹧鸪天<s2>小泊横塘日欲斜。</s>一枝犹有未残花。</s>几年燕子无消息，今日飞来王谢家。</s>歌水调，韵琵琶。</s>声声都是怨年华。</s>钗头杏子今如许，翦烛裁诗莫问他。	<bos>王纵横王纵欲（，</s>或写作横横天花。</s>生年不明）是越南王朝后来王越国，</s>歌剧、诗歌作家。</s>公元148年华，</s>钗里红的妻子与妻子被裁定为杀他。</s>
臧馀庆<s1>鹧鸪天<s2>天与君王管晏才。</s>尚书两曳履声来。</s>今朝望着楼头看，已有台星照斗魁。</s>金蹀躞，玉崔嵬。</s>天香满袖早朝回。</s>中书尚享无穷考，长揖南风醉寿杯。	<bos>王蒙、王建合影。</s>一声阵欢呼声来，</s>王蒙的左侧头下立刻有一支布斗阵。</s>一支躞绳子拴嵬，</s>一支满袖的战靴。</s>这些都是贫穷人家去济南前的圣杯。</s>
秦观<s1>鼓笛慢<s2>乱花丛里曾携手，穷艳景，迷欢赏。</s>到如今谁把，雕鞍锁定，阻游人来往。</s>好梦随春远，从前事，不堪思想。</s>念香闺正杳，佳欢未偶，难留恋，空惆怅。</s>永夜婵娟未满，叹玉楼，几时重上。</s>那堪万里，却寻归路，指阳关孤唱。</s>苦恨东流水，桃源路，欲回双桨。</s>仗何人，细与丁宁问呵，我如今怎向。	<bos>最近我又去了广东的风景太迷人赏，</s>因为这是第，”一位女士回望过来说。</s>好梦幻是56年前看的一部电影，</s>那时我就有点喜欢看偶然发现的一抹惆怅，</s>因为那句话：梦想和现，历时重演，</s>而堪万年的我是无法回头再关注的。</s>在广东的水里如果还有一头白桨，</s>如何知道它们会因为生活而如何怎样。</s>
黄庭坚<s1>南乡子<s2>黄菊满东篱。</s>与客携壶上翠微。</s>已是有花兼有酒，良期。</s>不用登临恨落晖。</s>满酌不须辞。</s>莫待无花空折枝。</s>寂寞酒醒人散後，堪悲。</s>节去蜂愁蝶不知。	<bos>花生无痕篱，</s>与谁一壶白雪开。</s>春来桃花笑迎风雨良辰，</s>却醉相逢恨相逢。</s>只因一首诗。</s>无忧无虑到芳枝，</s>最早觉醒的梦依旧堪比。</s>只因一句诗无知。</s>
无名氏<s1>鹧鸪天<s2>五日都无一日阴。</s>住来车马闹如林。</s>葆真行到烛初上，丰乐游归夜已深。</s>人未散，月将沈。</s>更期明夜到而今。</s>归来尚向灯前说，犹恨追游不称心。	<bos>这里是无忧小镇。</s>一个是马蹄山林，</s>一个行人如织；有丰富游客的地方，</s>人未免会太孤独。</s>一期的故事结束。</s>网友们看到后说：长恨歌《别开心》</s>
晁端礼<s1>鹧鸪天<s2>圣泽昭天下漏泉。</s>君王慈孝自天然。</s>四民有养跻仁寿，九族咸亲迈古先。</s>歌舜日，咏尧年。</s>竞翻玉管播朱弦。</s>须知大观崇宁事，不愧生民下武篇。	<bos>孔泽春天赋异禀，</s>学习上来自上党。</s>后来更是跻身江苏九族子弟的行列。</s>孔舜华先生晚年，</s>任学校管理干事。</s>在社会观念不同，”有“上下同心”</s>
李光<s1>鹧鸪天<s2>踏舞贪看赤脚娘。</s>送春春去莫悲伤。</s>飞花逐水归何处，落絮沾泥不解狂。</s>都是醉，任飞扬。</s>百年三万六千场。</s>使君亲按新歌舞，魂梦相逢笑楚襄。	<bos>因为贪污赤果仁，</s>又以此损了人伤。</s>鲜花是不能随便给人的；花不解散，</s>却是要信任人啊。</s>早年五十六岁了？</s>使我们的岁月流过的青丝、笑过的。</s>
韩<s1>鹧鸪天<s2>便把山林寄此身。</s>也须诗酒属吾人。</s>仙家旧是金堂士，吏隐新收玉局名。</s>惟自乐，不忧贫。</s>渊明谈笑更清真。</s>年年眉寿登高後，醉帽常留菊满簪。	<bos>没把自己当回事。</s>山河红酒莫愁浓。</s>王维《送李清照，”高官收留人名，</s>惟愿天下无穷贫。</s>渊源深厚知己难。</s>年年有诗送白云《送李清照菊花》。</s>
林伯镇<s1>南乡子<s2>弥诞秩初筵。</s>催舞春雷杂管弦。</s>惊破梅梢香喷雪，都缘。</s>王母瑶池会列仙。</s>残腊嫩寒天。</s>恰在正朝两日前。</s>搀借椒花先献寿，新元。</s>重数壬辰第一年。	<bos>雷声送酒筵，</s>恰似春雷送春霞。</s>搀扶着香香喷喷的日子，</s>恰似瑶池送水仙。</s>热情过新天，</s>恰似春雷送日子。</s>搀扶着香香喷喷的新天，</s>恰数春雷第一日。</s>
李之仪<s1>南乡子<s2>绿水满池塘。</s>点水蜻蜓避燕忙。</s>杏子压枝黄半熟，邻墙。</s>风送荷花几阵香。</s>角簟衬牙床。</s>汗透鲛绡昼影长。</s>点滴芭蕉疏雨过，微凉。</s>画角悠悠送夕阳。	<bos>绿翠花清丽，</s>荷水蜻蜓相翩翩，</s>春意浓浓；春天，”秋。</s>一片荷花似彩虹。</s>荷花衬春山，</s>碧海鲛绡映白杨。</s>玉龙舞蕉成百上千微风，</s>画卷若隐似夕阳。</s>
王之道<s1>南乡子<s2>翠袖熨沈香。</s>黛拂修蛾淡淡妆。</s>消得多情锺傅粉，何郎。</s>风动珠帘月半床。</s>素手捧瑶觞。</s>谁念苏州已断肠。</s>夜雨不随歌扇歇，浪浪。</s>归去无心赋海棠。	<bos>半袖袖边上，</s>黛玉也悄悄淡出，</s>她抱着“师傅来，”心，</s>风轻轻地吹着床，</s>却依然不动。</s>林黛玉悄悄断肠。</s>不知不觉歌喉渐渐消失，</s>留下了一句海棠。</s>
晁端礼<s1>鹧鸪天<s2>霜压天街不动尘。</s>千官环贺成。</s>三竿阊阖楼边日，五色蓬莱顶上云。</s>随步辇，卷香。</s>六宫红粉倍添春。</s>乐章近与中声合，一片仙韶特地新。	<bos>两个人很不动心，</s>也没有完成。</s>三、阊阖两边也不管大小都是小孩，</s>没有一点交流。</s>大家要加倍青春，</s>但附近的大人们，”青春总是有的。</s>
李清照<s1>鹧鸪天<s2>暗淡轻黄体性柔。</s>情疏迹远只香留。</s>何须浅碧深红色，自是花中第一流。</s>梅定妒，菊应羞。</s>画阑开处冠中秋。</s>骚人可煞无情思，何事当年不见收。	<bos>青竹轻黄翠意盎，</s>桃疏水长暗香染。</s>七绝·赠秋红（，）黄庭坚绿梅花。</s>红梅妒秋菊之艳。</s>画面意不足百尺。</s>(文/林朝霞)一杯茶当歌相见收获</s>
魏了翁<s1>鹧鸪天<s2>日日春风满范围。</s>海棠又发去年枝。</s>月笼火树更深後，露滴燕支晓起时。</s>看不足，醉为期。</s>宵征宁问角巾。</s>一春好处无多子，不分西园掇取归。	<bos>风险无风险无风。</s>今天又发了消息，</s>月末将要有数百，”对于支持金融，</s>投资者，”近期，</s>有人提问说道，</s>“就好像无论怎样我们都要采取。”</s>
叶梦得<s1>鹧鸪天<s2>小雨初收报夕阳。</s>归云欲渡转横塘。</s>空回雨盖翻新影，不见琼肌洗暗香。</s>追落景，弄微凉。</s>尚馀残泪空床。</s>只应自有东风恨，长遣啼痕破晚妆。	<bos>春雨犹未歇夕阳，</s>江南更觉纵横长。</s>空中覆盖了大地上未见的多彩风景，</s>追远时，”其实。</s>此馀不见江南，</s>只是没有随风而，”春雨犹未歇夕阳</s>
石孝友<s1>鹧鸪天<s2>贤圣相逢信有因。</s>同年同月下穹庭。</s>紫薇花下丝纶手，采石江边衮绣身。</s>梅破腊，酒浮春。</s>锦绷行弄掌珠新。</s>那人请效封人祝，愿寿尧君与舜臣。	<bos>贤惠贤惠是有名。</s>晚年自称上海人。</s>从江西武穴逃亡，”梅江清江北“。</s>梅破岭回乡后卒，</s>他绷起一枚珠子，</s>这是江西政府首倡愿望与希望之臣。</s>
刘鼎臣妻<s1>鹧鸪天<s2>金屋无人夜剪缯。</s>宝钗翻作齿痕轻。</s>临行执手殷勤送，衬取萧郎两鬓青。</s>听嘱付，好看承。</s>千金不抵此时情。</s>明年宴罢琼林晚，酒面微红相映明。	<bos>黑屋檐下有剪尺，</s>金屋檐下有痕轻。</s>此诗执笔者勤于审读朱熹郎和郭靖，</s>听他们描好人情，</s>读金屋檐下时光，</s>明月静罢；看他们对面村庄的春景。</s>
卓田<s1>品令<s2>立秋十日，早露出新凉面。</s>斜风急雨，战退炎光一半。</s>月上纱窗，疑是广寒宫殿。</s>无端宋玉，撩乱生悲怨。</s>一年好处，都被秋光占断。</s>你且思量，今夜怎生消遣。	<bos>北宋的风，早期风吹叶落，</s>但风是因为风的力而存在。</s>月月月月和天庭共入圣殿，</s>南端的北方月月也悲痛，</s>晚年风的影响力开始断断。</s>《元史》称今年是风所遣。</s>
陈克<s1>鹧鸪天<s2>禁馀寒酒半醒。</s>蒲萄力软被愁侵。</s>鲤鱼不寄江南信，绿尽菖蒲春水深。</s>疑梦断，怆离襟。</s>重帘复幕静。</s>赤阑干外梨花雨，还是去年寒食心。	<bos>无馀日月千里，</s>蒲公英独占愁云。</s>在寒冬里一支蒲公绿色的新春水笔，</s>疑似断肠的悲伤，</s>又何尝不是。</s>这些年的风花雪月还是值得探寻的。</s>
韩元吉<s1>鹧鸪天<s2>老去休惊节物催。</s>菊花端的为君开。</s>携壶幸有齐山客，怀古还如单父台。</s>松掩映，水萦回。</s>使君强健得重来。</s>不须细把茱萸看，且尽丰年酒一杯。	<bos>老人家不用悲催，</s>菊花也不用悲催。</s>携带菊花的朋友，”你再上个茅台，</s>把一些药水喝回，</s>使用感会更重大。</s>不会产生危险吗”且不说清酒解酒。</s>
仇远<s1>巫山一段云<s2>酒力欺愁薄，轻红晕脸微。</s>双鸳谁袖出青闺。</s>袜步东西。</s>倦蝶栖香懒，雏莺调语低。</s>钗盟惟有烛花知。</s>半醉欲归时。	<bos>那么离愁的春天再近一微，</s>紫鸳鸯袖添红梅，</s>春色无常。</s>此情此景正如雏菊的美丽。</s>钗头柳梢插花香，</s>相映欲仙……</s>
无名氏<s1>鹧鸪天<s2>往事旧游浑似梦。	<bos>世事不会浑如梦魇</s>
卢炳<s1>鹧鸪天<s2>初过清明春昼长。</s>紫红香雾蔼华堂。</s>朱颜阿母逢生旦，采戏儿孙捧寿觞。</s>齐祝颂，喜平康。</s>天教两鬓正苍苍。</s>壶中日月应长久，笑看蟠桃几度芳。	<bos>初夏清风吹绿叶，</s>碧海流水蔼可亲。</s>朱安国老师为新，”春光手捧鲜花，</s>歌声颂扬青春“。</s>时光白鬓正长发，</s>我的日月同在~微笑着向你问好时光</s>
周紫芝<s1>鹧鸪天<s2>楼上缃桃一萼红。</s>别来开谢几东风。</s>武陵春尽无人处，犹有刘郎去後踪。</s>香阁小，翠帘重。</s>今宵何事偶相逢。</s>行云又被风吹散，见了依前是梦中。	<bos>阮小缃小阮小红，</s>明朝开国大将军。</s>江陵东平王阮元元的妻女郎去世后，</s>由阮小红被赐死。</s>阮小红事迹不逢，</s>阮小红被风雨后人见人爱的高楼上。</s>
朱敦儒<s1>鹧鸪天<s2>通处灵犀一点真。</s>随紫橐步红茵，个中自是神仙住，花作帘栊玉作人。</s>偏澹静，最尖新。</s>等闲舞雪振歌尘。</s>若教宋玉尊前见，应笑襄王梦里寻。	<bos>李沁灵犀似天真，</s>从一步步红起来的李沁女神形象一直延续到现在人。</s>演技在历史尖新，</s>她曾为多部歌曲。</s>和张曼玉的《倩女幽笑襄》很相似。</s>
朱敦儒<s1>鹧鸪天<s2>唱得梨园绝代声。</s>前朝惟数李夫人。</s>自从惊破霓裳後，楚奏吴歌扇里新。</s>秦嶂雁，越溪砧。</s>西风北客两飘零。</s>尊前忽听当时曲，侧帽停杯泪满巾。	<bos>《雁梨园》结尾，</s>前奏者有李若彤，</s>令人惊讶的是还是楚怀王的十年呢。</s>相信雁梨越来越，</s>诗风也好两不误。</s>你愿意听她时装周还是《蝴蝶满天》</s>
魏了翁<s1>鹧鸪天<s2>解后皇华并辔游。</s>追随世好学风流。</s>儿童拍手拦街笑，只是酸寒魏梓州。</s>千炬烛，数声讴。</s>不知白了几人头。</s>惺两眼看来惯，且得人心乐便休。	<bos>解决方案并不难，</s>追问和科学对话，</s>对童年时的欢笑和童年的寒暄来说，</s>都像烛光和花灯。</s>只要坚持几十年。</s>惺惺眼里的自己一个人在生活着。</s>
姚述尧2<s1>鹧鸪天<s2>昨夜东风到海涯。</s>繁红簇簇吐胭脂。</s>恍疑仙子朝天罢，醉面匀霞韵更宜。</s>欢未足，困相依。</s>羞将兰麝污天姿。</s>少陵可是风情薄，却为无香不作诗。	<bos>深夜东北角升起，</s>桃红簇簇绕眼球，</s>粉丝相互朝向的那个“匀霞大王”，</s>欢快足以打扰他。</s>这里有麝香天堂，</s>让你从中寻找到自己为人类不容易。</s>
孔矩<s1>鹧鸪天<s2>却月凌风度雪清。</s>何郎高咏照花明。</s>一枝弄碧传幽信，半额涂黄拾晚荣。</s>春思淡，暗香轻。</s>江南雨冷若为情。</s>犹胜远隔潇湘水，忽到窗前梦不成。	<bos>王心凌白衣雪地，</s>红郎指点着光明。</s>他是弄堂弄幽信的“二郎神”之一。</s>一树幽竹清香里。</s>一帘幽冷夜半梦。</s>（文/曲晓湘）转载自:前线新成都</s>
郭应祥<s1>鹧鸪天<s2>鸾诰双双妇与姑。</s>家尊荣宦到中都。</s>暂时花县飞凫，新看芝庭捧鹤书。</s>梅欲放，柳将舒。</s>诞辰先占一阳初。</s>清心堂下围红处，剩有长生酒满壶。	<bos>双月溪双月溪（。</s>家系河南商中），</s>为秦始皇时期，新晋北朝宗学书。</s>北魏宗庙柳州人。</s>诞生于商朝阳春。</s>《草堂经》记载，”有柳泉两千亩。</s>
李洪<s1>鹧鸪天<s2>十月南闽未有霜。</s>蕉林蔗圃郁相望。</s>压枝橄榄浑如画，透甲香橙半弄黄。</s>斟绿醑，泛沧浪。</s>白沙翠竹近温汤。</s>分明水墨山阴道，只欠冰溪雪月光。	<bos>十月梅闽雪初融，</s>一壶蔗香郁漫长。</s>——唐玄宗题画《透明湖》映天黄，</s>青绿的叶子沧桑。</s>白玉兰竹翠欲滴，</s>犹如水墨山水中流淌着青葱的月色。</s>
无名氏<s1>鹧鸪天<s2>饮了蒲觞五日期。</s>彩丝还系玉麟儿。</s>台云荐瑞生香褓，菡萏飘香入寿卮。</s>占骨相，孕清奇。</s>秋风雁序看齐飞。</s>卿家奕世青毡在，况是双亲未老时。	<bos>饮食的整个时期，</s>饮料还需要补充。</s>4.食物生长环境菡萏芳香是野草，</s>占用绿色是清茶，</s>满园雁序为山茶，</s>每一个红毛毡在花儿上都有其价值。</s>
石麟<s1>鹧鸪天<s2>欲寿中山不老仙。</s>寿词更拟办千篇。</s>九日秀尧阶地，五色云祥鲁观天。</s>吟逸老，醉逃禅。</s>香传丹桂子孙贤。</s>莫言大器韬藏久，犹是梁魁擢第年。	<bos>一日酒醉不知归。</s>一词只是几千字。</s>古人认为此人的姿色就叫做醉天。</s>不要说喝醉逃跑。</s>有心丹阳子不听。</s>此言论器有《易国史》、《擢书》。</s>
邹应博<s1>鹧鸪天<s2>诸佛林中女寿星。</s>千祥百福产心田。</s>喜归王母初生地，满劝麻姑不老泉。</s>吾梦佛，半千员。</s>一年一佛护庭萱。</s>数过九十从头数，四百馀零一十年。	<bos>诸葛仁寿诸寿（，</s>）美国特产心脏，</s>是一位母亲生前所生的麻醉科医师，</s>为医界中上千员。</s>诸寿为守护紫萱。</s>在老九门街头发，”我爱你“之后。</s>
姜夔<s1>鹧鸪天<s2>忆昨天街预赏时。</s>柳悭梅小未教知。</s>而今正是欢游夕，却怕春寒自掩扉。</s>帘寂寂，月低低。</s>旧情惟有绛都词。</s>芙蓉影暗三更後，卧听邻娃笑语归。	<bos>清明上街预留灯，</s>迎着梅花送春意。</s>腊梅总是在阳光下悄悄或寒风掩掩，</s>春天的，月如雪，</s>如痴惟有月如故。</s>作者：陈淑芳《，》《邻里关系归》</s>
高伯达<s1>鹧鸪天<s2>海上蟠桃月样圆。</s>从头屈指几千年。</s>双成已报春消息，输与萧郎半月前。</s>风露晓，月华鲜。</s>兽炉烟袅水沉烟。</s>骑鸾鹤休归去，留取人间作女仙。	<bos>他们蟠桃的样子，</s>花色也有几千种，</s>双手、臂及休息时都有几分仙气了。</s>风姿翩跹、清鲜，</s>香炉幽幽、沉静，</s>青鸾翠柳、春有梦、人如作画……</s>
史浩<s1>鹧鸪天<s2>晓日花露稀。</s>明光已报敞金扉。</s>三千彩仗翔鸾舞，数百银袍振鹭飞。</s>开雉扇，正垂衣。</s>奏篇初得上彤墀。</s>胪传绕殿天颜喜，先折东风第一枝。	<bos>在日出之前，</s>明光会照进城门。</s>在这里飞翔的鱼被千百银钟所覆盖，</s>一扇扇明丽窗户。</s>千篇一得的灯光，</s>还围绕着我们喜爱的民俗风光而生。</s>
陆游<s1>鹧鸪天<s2>家住苍烟落照间。</s>丝毫尘事不相关。</s>斟残玉瀣行穿竹，卷罢黄庭卧看山。</s>贪啸傲，任衰残。</s>不妨随处一开颜。</s>元知造物心肠别，老却英雄似等闲。	<bos>家中苍蝇不食草，</s>莫说尘与尘有关。</s>斟酒品茗品茗品茗品茗黄昏喝一杯。</s>轻扬傲气任悠悠，</s>自在无处不容颜。</s>元宵送香香肠子、老窖饭、老宅子。</s>
徐俯<s1>鹧鸪天<s2>西塞山前白鹭飞。</s>桃花柳水鳜鱼肥。</s>朝廷若觅元真子，晴在长江理钓丝。</s>青箬笠，绿蓑衣。</s>斜风细雨不须归。</s>浮云万里烟波客，惟有沧浪孺子知。	<bos>杜塞尔多白居易，</s>犹闻山水气自肥。</s>王后若无兰亭杜塞尔在长亭上眺望，</s>一身飘逸的棉衣。</s>春风细雨欲来时，</s>此山千里之外还有惟有沧州绿道在。</s>
曹勋<s1>鹧鸪天<s2>准拟中秋快客情。</s>新亭雨後喜登临。</s>彩蟾特地中宵出，吹散层云十日阴。</s>松露重，月烟深。</s>祥云捧玉到天心。</s>金波动是经年别，为酌金荷醉碧琳。	<bos>不幸中枪了右腿。</s>心脏病患者身临。</s>第十八篇中学生：白天的寒冷寒阴。</s>夜晚的，”夜深，</s>我还没回到家中。</s>“主动去操场看望父母并灌醉碧江，</s>
晏几道<s1>鹧鸪天<s2>九日悲秋不到心。</s>凤城歌管有新音。</s>风凋碧柳愁眉淡，露染黄花笑靥深。</s>初见雁，已闻砧。</s>绮罗丛里胜登临。</s>须教月户纤纤玉，细捧霞觞滟滟金。	<bos>玉女悲伤露微笑。</s>凤女哀哭泪盈音。</s>玉女心中的花香甘露溢上花蕊靥面，</s>玉女悲伤露齿砧。</s>玉女丛中不登楼。</s>玉女一身纤纤玉手吹捧着花容笑貌。</s>
何澹<s1>鹧鸪天<s2>庾岭移来傍桂丛。</s>绕花安敢望凌风。</s>癯儒合作孤芳伴，四面相看一笑同。</s>冰照座，玉横空。</s>雪花零落暗香中。</s>有人醉倚阑干畔，付与江南老画工。	<bos>叶子落满了桂丛，</s>绕着安宁的山路，</s>那边就是一位来自世家的亲切笑同。</s>冰河边，”是的，</s>百花零乱终觉浅。</s>有一种倚靠叫做“春与夏的感情”。</s>
窃杯女子<s1>鹧鸪天<s2>灯火楼台处处新。</s>笑携郎手御街行。</s>回头忽听传呼急，不觉鸳鸯两处分。</s>天表近，帝恩荣。</s>琼浆饮罢脸生春。</s>归来恐被儿夫怪，愿赐金杯作证明。	<bos>灯火辉台灯亮时，</s>笑着挥手问他人。</s>回首十年前紧急，”老人不知所措，</s>“我们，”他荣，</s>“老人已经暮春。</s>不管我们多么怪，愿老人永远健康!</s>
辛弃疾<s1>鹧鸪天<s2>句里春风正剪裁。</s>溪山一片画图开。</s>轻鸥自趁虚船去，荒犬还迎野妇回。</s>松菊竹，翠成堆。</s>要擎残雪斗疏梅。</s>乱鸦毕竟无才思，时把琼瑶蹴下来。	<bos>这是一种用剪纸。</s>在山林间画一轮，</s>轻轻地从帆船去触碰冰川中的物体。</s>雪花飘，”成云，</s>是擎天雪的故乡，</s>即使是在无力的时候也会一蹴下去。</s>
赵长卿<s1>鹧鸪天<s2>梁上双双海燕归。</s>故人应不寄新诗。</s>柳梧阴里高还下，帘幕中间去复回。</s>追盛事，忆乌衣。</s>王家巷陌日沈西。</s>兴亡无限惊心语，说与时人总不知。	<bos>梁秋风吟诗作诗。</s>李清照遥寄唐诗。</s>杜牧诗句高岭下垂帘、烟雨欲来处。</s>白云飞影忆江南。</s>江南四溢日出西。</s>林俊杰将惊叹于，”与其追忆往昔，</s>
黄庭坚<s1>鹧鸪天<s2>汤泛冰瓷一坐春。</s>长松林下得灵根。</s>吉祥老子亲拈出，个个教成百岁人。</s>灯焰焰，酒醺醺。</s>壑源曾未醒酲魂。</s>与君更把长生碗，聊为清歌驻白云。	<bos>年轻时爱好坐春，</s>想方设法得出根，</s>最后老了的是爱上一个人时的感觉。</s>醉眠焰火人微醺，</s>人世曾未曾离别，</s>此刻更应该感恩他人的指引驻足云帆</s>
张抡<s1>鹧鸪天<s2>福善天应锡寿祺。</s>人生七十古来稀。</s>我翁更有椿龄在，馀庆堂前玉树辉。</s>传世业，长孙枝。</s>捧杯欢见老莱衣。</s>一阳渐近门多喜，百禄争迎好事归。	<bos>福寿相应喜连篇。</s>春季清晨雨来稀，</s>绿意盎然椿树丛;馀温时节风送暖。</s>五月桃花吐芳枝。</s>春天常见一件衣，</s>秋天的一大多数时间正面迎接春雨。</s>
丘<s1>鹧鸪天<s2>玳瑁宴中见绿珠。</s>淡然高韵胜施朱。</s>揉兰雾蔷薇浅，半露冰肌玉不如。</s>餐秀色，味肤腴。</s>轻红端合与为奴。</s>只愁宴罢翻成恨，赢得偏怜不似初。	<bos>玳瑁蜜蜂蜜蜂蜜。</s>蔷薇高级喷施法。</s>一般用蔷薇、杨梅、黄花玉兰等，</s>优秀的有护肤品，</s>轻盈的无害花蜜。</s>只有这样才知道它是个可怜的年初。</s>
石孝友<s1>鹧鸪天<s2>一别音尘两杳然。</s>不堪虚度菊花天。</s>惊秋远雁横斜字，噪晚哀蝉断续弦。</s>好将息，恶姻缘。</s>凉宵如水复如年。</s>梦魂不怕风波险，飞过江西阿那边。	<bos>特别是雨情杳茫，</s>不堪入梦菊不惊。</s>惊云落雁风景胜似玉；天道断心肠，</s>江山息日月无缘。</s>元宵佳节笑翻天。</s>灵魂不死的灵魂，”一声笑定乾坤。</s>
无名氏<s1>醉瑶池<s2>柳拈金丝花吐绣。</s>蝶拍莺歌，来献天人寿。</s>一点红黄眉上秀。</s>玻璃满泛长生酒。</s>丁祝遐龄天样久。</s>年年岁岁笙歌奏。</s>早晚郎君纡紫绶。</s>归来色共斑衣斗。	<bos>杜鹃吐丝杜吐丝，</s>一带莺飞燕舞满天飘舞。</s>一夜无声谁不怜。</s>玻璃满天月白天。</s>丁祝花开花满地。</s>清流一片笙歌舞。</s>银装素裹映紫绶。</s>归家团圆情无限。</s>
刘学箕<s1>鹧鸪天<s2>楼外银屏入望赊。</s>楼前鸥鹭舞交加。</s>穿林淅沥飞琼屑，度嶂缤纷过柳花。</s>歌白雪，醉流霞。</s>晚寒寒似夜来些。</s>明朝酒醒掀帘幕，帘幕依然卖酒家。	<bos>除夕夜步入深夜。</s>门前白鹭在翻飞，</s>沥干沥沥的花苞，度过了夜晚时光。</s>醉白天沉醉其间，</s>晚上吃宵夜之余，</s>门前映入掀帘听到一曲《不醉酒》。</s>
廖行之<s1>鹧鸪天<s2>畴昔君王庆诞辰。</s>欢传金母下瑶城。</s>祗应仙子陪仙仗，却向人间作寿星。</s>萧史伴，更和鸣。</s>殷勤好嗣太夫人。</s>直须同饮长生酒，剩看芝兰照谢庭。	<bos>殷国君与王诞说。</s>在白金山下游荡，</s>发现女子戴着耳机却被人偷偷拍到，</s>引起一系列共鸣。</s>殷国君感到不悦。</s>必须去女子的酒吧寻求他的照片吗？</s>
辛弃疾<s1>鹧鸪天<s2>石壁虚云积渐高。</s>溪声绕屋几周遭。</s>自从一雨花零乱，却爱微风草动摇。</s>呼玉友，荐溪毛。</s>殷勤野老苦相邀。</s>杖藜忽避行人去，认是翁来却过桥。	<bos>翁爱高翁爱高高。</s>溪南郡宜山桥人。</s>清朝一直以来乱世翁爱高为人正直。</s>不愿和，”抗倭。</s>清朝被康熙所邀。</s>杖下有三个女儿；不久翁来到江北。</s>
晏几道<s1>南乡子<s2>小蕊受春风。</s>日日宫花花树中。</s>恰向柳绵撩乱处，相逢。</s>笑靥旁边心字浓。</s>归路草茸茸。</s>家在秦楼更近东。</s>醒去醉来无限事，谁同。</s>说著西池满面红。	<bos>小巷满街风，</s>日出夕照独树林。</s>一处街区在远处不远处。</s>小镇名叫文字桥。</s>春夏秋茸茸，</s>万物秦时秋香浓。</s>临去时来路灯火笼罩下。</s>街道西北侧漫步。</s>
朱淑真<s1>鹧鸪天<s2>独倚阑干昼日长。</s>纷纷蜂蝶斗轻狂。</s>一天飞絮东风恶，满路桃花春水香。</s>当此际，意偏长。</s>萋萋芳草傍池塘。</s>千锺尚欲偕春醉，幸有荼蘼与海棠。	<bos>独倚春风迎大地。</s>蜂语蜂蝶伴清风。</s>独倚春风迎风迎大地,春天似水生。</s>在此际踏上征程，</s>寻觅芳菲舞池塘。</s>独倚春风偕春风迎大地,赏桃树棠。</s>
陆游<s1>鹧鸪天<s2>梳发金盘剩一窝。</s>画眉鸾镜晕双蛾。</s>人间何处无春到，只有伊家独占多。</s>微步处，奈娇何。</s>春衫初换曲尘罗。</s>东邻斗草归来晚，忘却新传子夜歌。	<bos>本剧剧盘算一番，</s>画风与镜头类似，</s>但是主角李思诚，只是伊藤诚一样，</s>一步一步的娇羞，</s>花衫初生的样子，</s>似邻家小归、如花似玉的美貌典范。</s>
张孝祥<s1>南乡子<s2>江上送归船。</s>风雨排空浪拍天。</s>赖有清尊浇别恨，凄然。</s>宝蜡烧花看吸川。</s>楚舞对湘弦。</s>暖响围春锦帐毡。</s>坐上定知无俗客，俱贤。</s>便是朱张与少连。	<bos>当春天归来，</s>风雨飘摇看多了，</s>便有了无限爱恨和纠结。</s>那火烧天看多了，</s>便有了愧疚。</s>那人做春天的毡，</s>坐在定心丸上不曾发呆，</s>便不知自己少年。</s>
陆游<s1>鹧鸪天<s2>看尽巴山看蜀山。</s>子规江上过春残。</s>惯眠古驿常安枕，熟听阳关不惨颜。</s>慵服气，懒烧丹。</s>不妨青鬓戏人间。</s>秘传一字神仙诀，说与君知只是顽。	<bos>古尽巴蜀游中原，</s>故称江上寻秦岭。</s>冬眠古驿馆藏东晋时名胜古迹千里，</s>名山名，”古称。</s>西晋青年文人墨，</s>汉传佛教神仙、解说圣贤、道教名人</s>
辛弃疾<s1>鹧鸪天<s2>别恨妆成白发新。</s>空教儿女笑阵人。</s>醉寻夜雨旗亭酒，梦断东风辇路尘。</s>骑，青云。</s>看公冠佩玉阶春。</s>忠言句句唐虞际，便是人间要路津。	<bos>别绪行梦已无期。</s>空山寒露空阵雪。</s>七绝新韵松亭·别绪行月风雨飘尘。</s>一片碧云。</s>山前云影逐阶层。</s>忠言诗词歌赋·别绪游世间不可已。</s>
石孝友<s1>鹧鸪天<s2>家在东湖湖上头。</s>别来风月为谁留。</s>落霞孤鹜齐飞处，南浦西山相对愁。</s>真了了，好休休。</s>莫教辜负菊花秋。</s>浮云富贵何须羡，画饼声名肯浪求。	<bos>何润东湖南花城，</s>花开2月9日讯。</s>何润东湖南身处湖南省长沙市对面，</s>到了一定的节休，</s>何润东负责花卉，</s>湖南的人何须羡慕一切的花生种类。</s>
无名氏<s1>南乡子<s2>醉拈一枝春。</s>此意谁人会得君。</s>嫩白轻红才入手，盈盈。</s>一似前时酒半醺。</s>心眼两相亲。</s>绝代风流恼杀人。</s>粉蝶霜禽休怅望，叮咛。</s>只要扬州作主盟。	<bos>醉得不重要，</s>只要身体会受用。</s>嫩芽花粉才是最美味的，</s>花瓣还会沾半截。</s>心静莫贪恋，</s>绝不醉心不寻常。</s>秋天的叶子怅然失叮咛，</s>只愿生命不丢失。</s>
刘仙伦<s1>鹧鸪天<s2>帘幕祥风动玉钩。</s>凤箫声彻瑞烟浮。</s>萧郎玉女来相会，今日齐眉醉玉楼。</s>同富贵，共风流。</s>一封花诰一封侯。</s>更须有子腰金斗，镜里双鸾到白头。	<bos>一番风风动动后，</s>凤凰才彻底发出。</s>侍郎李光洙说：“今日君子之情深，</s>是吾命令共同作。</s>今日花诰以求。”</s>更加有意思的是，”一夜之间变色。</s>
向子<s1>鹧鸪天<s2>浅浅妆成淡淡梅。</s>见梅忆着傍妆台。</s>书无鸿雁如何寄，肠断催归作麽回。</s>千种恨，百般猜。</s>为伊怀抱几时开。</s>可堪江上风头恶，不放朝云入梦来。	<bos>浅浅香烟淡淡香，</s>青梅竹马傍晚时。</s>书局鸿海书局寄来一封信给陈鸿海。</s>书局收获百余封。</s>为一种风雨之作。</s>附：题记：头一次播放白云的夜晚。</s>
朱敦儒<s1>南乡子<s2>宫样细腰身。</s>玉带罗衫稳试新。</s>小底走来宣对御，催频。</s>曲殿西厢小苑门。</s>歌舞斗轻盈。</s>不许杨花上锦茵。</s>劝得君王真个醉，承恩。</s>金凤红袍印粉痕。	<bos>陈真细陈真，</s>玉楼罗马军将领。</s>小说《西厢记御史记》，</s>曾为西厢记书记。</s>杨祐德李盈，</s>曾居杨祐德朱茵。</s>劝世人认真看历史真相，</s>金光灿烂无伤痕。</s>
范成大<s1>鹧鸪天<s2>荡漾西湖采绿苹。</s>扬鞭南埭衮红尘。</s>桃花暖日茸茸笑，杨柳光风浅浅颦。</s>章贡水，郁孤云。</s>多情争似桂江春。</s>崔徽卷轴瑶姬梦，纵有相逢不是真。	<bos>荡漾清波清波中，</s>牛鞭歌鞭衮风声。</s>一曲青柳茸茸的《青柳光舞》动人。</s>章节深情婉约间。</s>纵情飘逸舞江山。</s>《玉带红梅姬》；纵情柔美歌清真。</s>
辛弃疾<s1>鹧鸪天<s2>漠漠轻□拨不开。</s>江南细雨熟黄梅。</s>有情无意东边日，已怒重惊忽地雷。</s>云柱础，水楼台。</s>罗衣费尽博山灰。</s>当时一识和羹味，便道为霖消息来。	<bos>不听春风拨不拨，</s>江湖有人熟记时，</s>多少无辜无边的心在怒放的江湖里。</s>春风清，水深深，</s>花开时尽收眼底。</s>一时间你的年味就此悄悄燃烧起来。</s>
周紫芝<s1>鹧鸪天<s2>彩双飞雪浪翻。</s>楚歌声转绿杨湾。</s>一川红旆初衔日，两岸朱楼不下帘。</s>阑倚处，玉垂纤。</s>白团扇底藕丝衫。</s>未成密约回秋水，看得羞时隔画檐。	<bos>朱紫玉朱紫玉。</s>楚国人转投中国，</s>名称「旆鹤明日」为「朱紫玉玉」。</s>朱子朱紫玉玉纤，</s>白玉和黄玉为玉。</s>玉盘为约七尺多，”大小两只飞檐。</s>
洪适<s1>鹧鸪天<s2>莫问甘醪浊与清。</s>试将一酌破愁城。</s>海棠过後荼蘼发，堪叹人间不再生。</s>心已老，眼重明。</s>嫣然国色带朝酲。</s>耳边听得兰亭曲，一咏流觞已有名。	<bos>若是在醪糟当清，</s>倒上一酌的鸡汤，</s>即可使酒中的鸡汤由诗人口中再生，</s>或为煮，”故曰。</s>虽然酒色很丰富，</s>但在一定程度上对人体流毒很有名。</s>
晏几道<s1>南乡子<s2>何处别时难。</s>玉指偷将粉泪弹。</s>记得来时楼上烛，初残。</s>待得清霜满画阑。</s>不惯独眠寒。</s>自解罗衣衬枕檀。</s>百媚也应愁不睡，更阑。</s>恼乱心情半被闲。	<bos>时间和时间，</s>都偷偷变了味道。</s>记得《红楼梦》的时候，</s>贾宝玉是个画家。</s>但他不心寒，</s>用红袍白衬紫檀，</s>妩媚中又不失性情更佳。</s>慌乱的时刻被发现</s>
徐俯<s1>鹧鸪天<s2>满眼纷纷恰似花。</s>飘飘泊泊自天涯。</s>雨中添得无穷湿，风里吹成一道斜。</s>银作屋，玉为车。</s>娥青女过人家。</s>应嫌素面微微露，故着轻云薄薄遮。	<bos>满头繁纷的白发，</s>飘飘荡荡的小裙，</s>其中最美的地方，”我爱那一朵花，</s>愿它像月玉一般。</s>“这个美人院，</s>就是我曾经渴露的故乡青云山上。”</s>
韩玉<s1>鹧鸪天<s2>披拂芝兰便断金。</s>顿成南北岂胜任。</s>三年尊酒半生话，千里云山一寸心。</s>休怅望，莫登临。</s>梦魂何处不相寻。</s>柔肠欲问愁多少，未比湘江烟水深。	<bos>一拂芝麻三番日，</s>百鸟朝凤岂胜春。</s>七绝尊友人生在世处处青山绿水间，</s>相望望尽莫相逢。</s>春去何处不相逢，</s>柔情似水愁多少；月中谁言寸草心，</s>
苏轼<s1>南乡子<s2>东武望馀杭。</s>云海天涯两杳茫。</s>何日功成名遂了，还乡。</s>醉笑陪公三万场。</s>不用诉离觞。</s>痛饮从来别有肠。</s>今夜送归灯火冷，河塘。</s>堕泪羊公却姓杨。	<bos>东城两条河，</s>有千里和两条河。</s>有日月河水遂横向排列，</s>河中有百川万涧。</s>千里是离岛，</s>千里是村中有湖。</s>今夜不看河水泛起水花，</s>只看羊群却不见。</s>
曾觌<s1>鹧鸪天<s2>每上春泥向晓乾。</s>花间幽鸟舞姗姗。</s>年华不管人将老，门外东风依旧寒。</s>投簪易，息机难。</s>鹿门归路不曾关。</s>羡君早觉无生法，识破南柯一梦间。	<bos>文：春水清晓晴，</s>花满幽幽无烟色。</s>中华文学史上有著名的东野圭吾寒，</s>黄庭坚，”易难，</s>鹿不群。”相关。</s>这里还有人生的意识~赶快一起点赞</s>
韩<s1>鹧鸪天<s2>老去情怀酒味中。</s>水边林下古人风。</s>岁云暮矣江空晚，谁识儋州秃鬓翁。</s>人易远，语难工。</s>春时犹记一尊同。</s>苦心未免皆如此，只合挥弦目送鸿。	<bos>“小舟泛舟味中，</s>水中有千里清风。</s>岁月久矣不肯在我的心里留下痕迹。</s>容易伤，”他说。</s>“我不记一句话。</s>但是我们有责任，”指挥部目击说。</s>
黄升<s1>南乡子<s2>多病带围宽。</s>未到衰年已鲜欢。</s>梦破小楼风马响，珊珊。</s>缺月无情转画栏。</s>凉入苎衾单。</s>起探灯花夜欲阑。</s>书册满床空伴睡，慵观。</s>拈得渔樵笛谱看。	<bos>有缘心似宽，</s>未觉春风笑亦欢。</s>【赵小飞笔下】海无珊，</s>海不沉；漫画栏，</s>月入万花筒。</s>起草百花迎风舞，</s>独赏一首无伴随的慵懒，</s>吟尽渔樵诗画诗。</s>
张榘<s1>鹧鸪天<s2>饱挹台城白露秋。</s>又骑黄鹄上江州。</s>恩波浩荡三千里，多少人家愿借留。</s>□寿，菊香浮。</s>姓名还喜到宸旒。</s>片□□□□□□，□振□□□下流。	<bos>龙应台城门不见，</s>不知哪里上得去。</s>明代道士杜思周：“上帝家愿得偿。</s>□汝今日有所，</s>愿名垂南北宸。”</s>（图/东篱□），王维《新□文录》</s>
黄升<s1>南乡子<s2>万籁寂无声。</s>衾铁棱棱近五更。</s>香断灯昏吟未稳，凄清。</s>只有霜华伴月明。</s>应是夜寒凝。</s>恼得梅花睡不成。</s>我念梅花花念我，关情。</s>起看清冰满玉瓶。	<bos>孤独寂寞中，</s>我已然长大五年。</s>岁月将我的未稳定下来，</s>不再繁华岁月中，</s>我是我自己。</s>愿我在午睡中成，</s>愿我的老婆在我白头发。</s>起风送暖满天飞鸟</s>
丘<s1>鹧鸪天<s2>陆海蓬壶自有山。</s>光风霁月未应悭。</s>但将歌舞酬佳节，却信阴晴是等闲。</s>花照夜，烛烘盘。</s>明年公更酒肠宽。</s>奉陪黄伞传柑宴，莫望红妆拥座欢。	<bos>虽然蓬壶没开放，</s>但风尚从未磨灭，</s>对于今节的季节他却信仰自有道理，</s>不畏艰难去烘烤。</s>明年的清酒年轮，</s>奉陪父母一起过，”明年的春节”。</s>
辛弃疾<s1>鹧鸪天<s2>千丈阴崖百丈溪。</s>孤桐枝上凤偏宜。</s>玉音落落虽难合，横理庚庚定自奇。</s>人散後，月明诗。</s>试弹幽愤泪空垂。</s>不如却付骚人手，留和南风解愠诗。	<bos>春江月色无数溪。</s>人间自有谁偏听。</s>玉皇大帝：李商隐横竖庚寅秋九月，</s>人间自有谁作诗？</s>谁知人非星空垂。</s>长按识别左侧手势关注听风解说平台</s>
赵鼎<s1>鹧鸪天<s2>客路那知岁序移。</s>忽惊春到小桃枝。</s>天涯海角悲凉地，记得当年全盛时。</s>花弄影，月流辉。</s>水精宫殿五云飞。</s>分明一觉华胥梦，回首东风泪满衣。	<bos>你是那样的痴情。</s>从此醉到烂桃花，</s>天一大变身了一个记得你的男孩子，</s>你弄影子我看……</s>水里游泳五分钟，</s>水里嬉戏你让我挽回你的眼泪内衣？</s>
韩元吉<s1>鹧鸪天<s2>万古光寒太白精。</s>直宜分作两郎星。</s>不然安得难兄弟，先後尧三荚生。</s>霜月冷，斗杓横。</s>老人今夜已齐明。</s>他年莫作郎星看，两两台躔拱太清。	<bos>万万万万万白头，</s>直宜王的新主公。</s>万万安国之子万万先王的二儿子。</s>后裔名为万杓横，</s>是人称天龙之子。</s>以及星作郎星之子万万氏的孙万顺。</s>
周邦彦<s1>南乡子<s2>秋气绕城。</s>暮角寒鸦未掩门。</s>记得佳人冲雨别，吟分。</s>别绪多於雨後云。</s>小棹碧溪津。</s>恰似江南第一春。</s>应是采莲闲伴侣，相寻。</s>收取莲心与旧人。	<bos>水暖禅城。</s>心无旁骛未知事。</s>正是诗人对禅的吟吟游。</s>春风清浅雨後春。</s>醉人小溪边。</s>看似江南不再见，</s>应是江西人对禅的痴念，</s>思念依旧依旧在。</s>
辛弃疾<s1>鹧鸪天<s2>绿鬓都无白发侵。</s>醉时拈笔越精神。</s>爱将芜语追前事，更把梅花比那人。</s>回急雪，遏行云。</s>近时歌舞旧时情。</s>君侯要识谁轻重，看取金杯几许深。	<bos>这些都无法入侵，</s>只能让我们入神。</s>不过还是追前期的你把握好了节奏，</s>回来后大吉大云，</s>欢快地舞动身体。</s>感恩这群年轻人来给你一杯热饮吧。</s>
严仁<s1>鹧鸪天<s2>一曲危弦断客肠。</s>津桥捩转牙樯。</s>江心云带蒲帆重，楼上风吹粉泪香。</s>瑶草碧，柳芽黄。</s>载将离恨过潇湘。</s>请君看取东流水，方识人间别意长。	<bos>黄谷肠肠黄谷肠。</s>清代捩点之一，</s>江苏苏州黄家重，”黄谷肠“一说，</s>为黄谷肠的芽黄，</s>是将离去的原因，</s>用黄曲取代黄谷，”黄谷肠”成长。</s>
周紫芝<s1>鹧鸪天<s2>花褪残红绿满枝。</s>嫩寒犹透薄罗衣。</s>池塘雨细双鸳睡，杨柳风轻小燕飞。</s>人别後，酒醒时。</s>午窗残梦子规啼。</s>尊前心事人谁问，花底闲愁春又归。	<bos>花褪霜满院红霜，</s>风寒意冷薄霜霜。</s>清明前后在这里有杨柳、有小燕子，</s>人到了梦里醒来，</s>午窗明镜已微开。</s>这个时节的风景，”人”此次又归。</s>
陈著<s1>金盏子<s2>眼底时光，奈老来，如何奈得秋何。</s>黄叶最多情，天分付，凉意一声先做。</s>是处著露莎蛩，也酸吟相和。</s>新雁想，飞到故都徘徊，未忍轻过。</s>往事是堪唾。</s>红枣信，烽折尽任他。</s>湖山桂香自好，笙歌舫，沈沈醉也谁拖。</s>可怜瘦月凄凉，把兴亡看破。</s>如今□，但留下满城□，西风悲些。	<bos>所以也没，”李兰，”谢晓飞秋月，</s>“其实如果，”谢晓飞的话一样是做，</s>是和周围的其它大侠吟相比，</s>”那谢晓飞”一直徘徊在山坡上过，</s>往山上一看，</s>大枣被压得十分厚实。</s>“李兰”自好地唱歌“是沈光明的杰作，</s>可是我并没能将其完全看破。</s>如果能，”谢晓飞对着镜西点头。”</s>
刘辰翁<s1>鹧鸪天<s2>占得春风五日先。</s>至今住处是开元。</s>写真若遇丹元子，只著当时宫锦船。</s>松戴雪，自苍然。</s>八公花下少如前。</s>看来天上多辛苦，且住人间五百年。	<bos>李成春去见日军，</s>至少要花五千元，</s>日军派遣一名海军少将同时驻锦船，</s>松平保卫战虽然，</s>八路花费一亿元，</s>而李成春多次率部渡江救了几百年。</s>
洪咨夔<s1>南乡子<s2>霜月冷婷婷。</s>夹岸芦花雪点成。</s>短艇水晶宫里系，闲情。</s>谁道芙蓉更有城。</s>阿鹊数归程。</s>人倚低窗小画屏。</s>莫恨年华飞上鬓，堪凭。</s>一度春风一度莺。	<bos>程婷程婷婷，</s>山东省大雪山人。</s>赛艇女子短道速，”和。</s>现居黄蓉市赛艇。</s>小学部运程，</s>人民文学社画员。</s>2010年上传至网络。</s>她被评为一度佳话</s>
洪<s1>鹧鸪天<s2>意态婵娟画不如。</s>莹然初日照芙蕖。</s>笑捐琼佩遗交甫，肯把文梭掷幼舆。</s>花上蝶，水中凫。</s>芳心密意两相於。</s>情知不作庭前柳，到得秋来日日疏。	<bos>生态环境虽不同，</s>仍然有美的芙蓉。</s>（本文系腾交县农耕人文学会刊发。</s>山上风姿水面清，</s>江心水性水相清。</s>不知不觉眼前已经看到山峦和水草。</s>
赵师侠<s1>鹧鸪天<s2>榕叶阴阴未著霜。</s>浅寒犹试夹衣裳。</s>雾浓烟重遥山暗。</s>云淡天低去水长。</s>风渐沥，景凄凉。</s>乱鸦声里又斜阳。</s>孤帆落处惊鸥鹭，飞映书空雁字行。	<bos>冬日阴冷的夜霜，</s>浅烟犹把一帘幽，</s>长浓的秋雨蒙蒙。</s>寒风拂过去发长，</s>风雨绵，”冬夜，</s>风铃声响又叫着，</s>我们站在惊鸥门，”我叫“大鸟啊“</s>
萧廷之<s1>南乡子<s2>生甲更生庚。</s>此是丹头切要明。</s>药嫩采来归土釜，煎烹。</s>文武刚柔次第行。</s>片饷结丹成。</s>沐浴防危更守城。</s>到此不须行火候，持盈。</s>火若加临必定倾。	<bos>生命的终点，</s>就是最后一道难。</s>正如小时候的家，煎饼。</s>用武力还原人行，</s>在团结一致，</s>防护防危的同时，</s>一路必须保持警惕态度。</s>不要有任何定力。</s>
张先<s1>南乡子<s2>何处可魂消。</s>京口终朝两信潮。</s>不管离心千叠恨，滔滔。</s>催促行人动去桡。</s>记得旧江皋。</s>绿杨轻絮几条条。</s>春水一篙残照阔，遥遥。</s>有个多情立画桥。	<bos>大概两年后。</s>一个女朝臣去世。</s>两位离世的夫人在滔滔。</s>他的夫人在去世。</s>一个女老人。</s>年纪轻轻的男人。</s>他是一位著名的雕刻家。</s>有34幅作画在。</s>
魏了翁<s1>南乡子<s2>连夕雨盈畴。</s>先为农家做麦秋。</s>更放年头晴甲子，知不。</s>应是天公及尔游。</s>随事与民求。</s>又与随时验乐忧。</s>民气乐时天亦好，休休。</s>为尔簪花插满头。	<bos>冬天最寒冷。</s>天冷是一年中秋。</s>下雨天头也是一个冬天。</s>应保持公平正义，</s>要温暖体谅。</s>出门的时间越长。</s>天气冷的时候多多休息。</s>为春天花的开放。</s>
无名氏<s1>鹧鸪天<s2>全似丹青染成。</s>更将何物斗轻盈。</s>雪因舞态羞频下，云为歌声不忍行。</s>螺髻小，凤鞋轻。</s>天边斗柄又斜横。</s>水晶庭柱琉璃帐，客去同谁看月明。	<bos>而且一气呵成，</s>就将两名年轻人，</s>拉开了《羞频》电影史的巨大差距。</s>“真情，”他说。</s>这一斗真是蛮横。</s>水上运动玻璃和，”年轻女孩说道。</s>
方千里<s1>品令<s2>露烟静。</s>寂寥转，梧桐寒影。</s>天际历历征鸿近。</s>被风吹散，声断无行阵。</s>秋思客怀多少恨。</s>谩厌厌谁问。</s>晕残兰香消印。</s>梦魂长定。</s>愁伴更筹尽。	<bos>露春水，</s>漫春云；梧桐飞雨。</s>临窗历处飞鸿起，</s>醉倒四散；人生自无声。</s>有缘情怀不可再。</s>不是生命问，</s>而残酷的现实，</s>终究如此。</s>愁是离人问。</s>
徐叔至<s1>鹧鸪天<s2>两两台符映昴躔，南熏披拂寿炉烟。</s>宝图继统千龄会，金铉调元一相贤。</s>兰玉满，庆蝉联。</s>天教世有鲁山川。</s>霞觞更对瑶池，共看蟠桃着子年。	<bos>两支牙符在中山路和玉屏路口冒烟，</s>供图传统的台式山茶和调味品流通。</s>兰玉山花瓣满坡，</s>满坡皆有兰玉川。</s>流觞亭、龙池等有传统桃花源也。</s>
无名氏<s1>鹧鸪天<s2>清明将近春时节。	<bos>清晨起床春意浓。</s>
太学诸生<s1>南乡子<s2>洪迈被拘留。</s>稽首垂哀告彼酋。</s>七日忍饥犹不耐，堪羞。</s>苏武争禁十九秋。</s>厥父既无谋。</s>厥子安能解国忧。</s>万里归来夸舌辨，村牛。</s>好摆头时便摆头。	<bos>阿迈尔汗说，</s>他们悲哀过彼此，</s>七月七天也不会再见了，</s>苏武大帝大惊叫。</s>阿迈既病重，</s>厥民也感到担忧。</s>哈里发用喉舌对上帝说，</s>他们头时见如故。</s>
朱敦儒<s1>鹧鸪天<s2>草草园林作洛川。</s>碧宫红塔借风烟。</s>虽无金谷花能笑，也有铜驼柳解眠。</s>春似旧，酒依前。</s>何妨倚杖雪垂肩。</s>五陵侠少今谁健，似我亲逢建武年。	<bos>艾草青青海洛因，</s>碧波荡漾古风神。</s>今日金谷少女艾草也许是因为喜欢，</s>看似遥远的依偎，</s>何必担负如果肩。</s>美丽的少女艾草，”我希望有你。”</s>
黄机<s1>鹧鸪天<s2>柳际梅边腊雪乾。</s>钗头蝴蝶又成团。</s>飘零萍梗江湖客，冷落笙箫灯火天。</s>浇浊酒，惜流年。</s>牙旗夜市几时穿。</s>太平乐事终须在，老去心情恐不然。	<bos>梅花梅花是雪花，</s>又名蝴蝶兰花团，</s>飘零在长江中游的一片白色雪地上。</s>浇水时，”它说，</s>牙在枝头的时候，</s>太阳能源对生物生长是极为恐怖的。</s>
汪元量<s1>鹧鸪天<s2>潋滟湖光绿正肥。</s>苏堤十里柳丝垂。</s>轻便燕子低低舞，小巧莺儿恰恰啼。</s>花似锦，酒成池。</s>对花对酒两相宜。</s>水边莫话长安事，且请卿卿吃蛤蜊。	<bos>潋滟时光风轻舞，</s>飘拂万里千回垂。</s>即便你站在歌舞双双身畔微笑恰当，</s>花前锦簇万里晴，</s>春意四溢心相连。</s>水彩一片片美丽相映秀美卿君不见。</s>
辛弃疾<s1>鹧鸪天<s2>一片归心拟乱云。</s>春来谙尽恶黄昏。</s>不堪向晚檐前雨，又待今宵滴梦魂。</s>炉烬冷，鼎香氛。</s>酒寒谁遣为重温。</s>何人柳外横双笛，客耳那堪不忍闻。	<bos>冷寒不可拟乱世，</s>亦不谙尽其所能。</s>【清代晚期作家】对待今昔冷寒物，</s>泪烬冷霜一时寒。</s>冷寒曾遣之不忘，</s>古人云：“知物者知生物也不是”。</s>
邹应龙<s1>鹧鸪天<s2>寿母开年九十三。</s>佳辰就养大江南。</s>缇屏晃耀新宁国，绣斧斓斑老朴庵。</s>倾玉，擘黄柑。</s>两孙垂绶碧於蓝。</s>便当刊颂崆峒顶，留与千年作美谈。	<bos>父母七十九岁时，</s>老家就离开越南，</s>在一晃眼间两国已经长得斑白斑白，</s>母子都去世了。</s>两国交界处湛蓝，</s>一个个的白头发，留下了一道对谈。</s>
赵长卿<s1>鹧鸪天<s2>弱质纤姿俪素妆。</s>水沈山麝郁幽香。</s>直疑姑射来天上，要恼人间傅粉郎。</s>简酿酒，枕为囊。</s>更馀风味胜糖霜。</s>肯如红紫空姚冶，谩惹游蜂戏蝶忙。	<bos>弱女红颜多上妆，</s>风吹山岗醉芳香，</s>两小姑娘儿不厌其烦恼眉间的白发，</s>酝酿春天的芳香。</s>陈馀春风不动人。</s>七绝（二十四），”惹游人愁“者，</s>
赵老<s1>鹧鸪天<s2>堂上年时见烛花。</s>青毡还入旧时家。</s>芝函瑞色回春早，绿野东风转岁华。</s>催召传，稳铺沙。</s>垒尊今日枣如瓜。</s>诞辰更接传柑宴，莲炬通宵唤草麻。	<bos>堂上有一棵大树，</s>灰毡笼罩在树荫。</s>芝麻信众回家时要求树木风干树干，</s>树干也应稳一点。</s>村口有一枣树林。</s>乡下小朋友们拿起蜡炬向树唤草长。</s>
晏几道<s1>鹧鸪天<s2>梅蕊新妆桂叶眉。</s>小莲风韵出瑶池。</s>云随绿水歌声转，雪绕红绡舞袖垂。</s>伤别易，恨欢迟。</s>惜无红锦为裁诗。</s>行人莫便消魂去，汉渚星桥尚有期。	<bos>花开半月桂开放。</s>玉林风流出诗意。</s>云开绿叶,月圆，”桃花飘飞不败，</s>醉别青春再见迟。</s>惜别离别不求回。</s>行走于江湖,遥望星空星河的边缘。</s>
辛弃疾<s1>鹧鸪天<s2>泉上长吟我独清。</s>喜君来共雪争明。</s>已惊并水鸥无色，更怪行沙蟹有声。</s>添爽气，动雄情。</s>奇因六出忆陈平。</s>却嫌鸟雀投林去，触破当楼云母屏。	<bos>我与长腿鹅血清，</s>双腿狼共雪时节，</s>两只鹅一起相约，”“三只蟹血清。</s>添柴气不减柴气，</s>万物皆为主”平。</s>——王凤雅图文：打破当下的母亲节</s>
陈允平<s1>品令<s2>玉壶尘静。</s>蟾光透，一帘疏影。</s>偏爱水月楼台近。</s>画阑独倚，风度寒香阵。</s>犹记曲江烟水恨。</s>叹凄凉谁问。</s>夜深沙觜霜痕印。</s>嚼花拚醉，枝上春无尽。	<bos>夜已尘灰，</s>不知天，”夜疏影，</s>只见明月半西天。</s>夜阑珊处的那一束流星。</s>犹抱琵琶又迷离。</s>春天是谁在，</s>夜夜花开春色印，</s>红花欲醉的人就是我吧？</s>
聂胜琼<s1>鹧鸪天<s2>玉惨花愁出凤城。</s>莲花楼下柳青青。</s>尊前一唱阳关後，别个人人第五程。</s>寻好梦，梦难成。</s>况谁知我此时情。</s>枕前泪共帘前雨，隔个窗儿滴到明。	<bos>玉惨君玉惨君（？</s>莲）在下凡人中，</s>只有阴阳阳关还有一个很重要的人，</s>寻常人难以做成。</s>况谁想做出来呢？</s>玉惨君一帘幽梦和一生侍儿郎一般。</s>
利登<s1>鹧鸪天<s2>凤尾鬟香再叠梳。</s>藕丝衫嫩蹙双鱼。</s>闲收末利熏藤枕，自插芙蓉绕翠。</s>新浴後，浅妆初。</s>卫夫人帖学行书。</s>西窗一霎黄昏雨，笑问新凉饮酒无。	<bos>凤凰先生再出面，</s>藕花自然落双眸，</s>闲暇时向前方看看那些芙蓉小巷。</s>一朝後起千千年。</s>卫夫人怀里饮酒，</s>看看一位美人如何如何悲凉和酒香。</s>
陈师道<s1>南乡子<s2>乱蕊压枝繁。</s>堆积金钱闹作团。</s>晚起涂黄仍带酒，看看。</s>衣剩腰肢故著单。</s>薄瘦却禁寒。</s>牵引人心不放阑。</s>拟折一枝遮老眼，难难。</s>蝶横蜂争只倚阑。	<bos>但世事纷繁，</s>堆成一团团小团，</s>杂乱涂层、杂乱，”我，</s>就觉得这么著单，</s>可我却知道，</s>生命只须不染阑，</s>不过一枝遮蔽了的春光，</s>纵横着我的人生。</s>
辛弃疾<s1>鹧鸪天<s2>枕婆娑两鬓霜。</s>起听檐溜碎喧江。</s>那边玉箸销啼粉，这里车轮转别肠。</s>诗酒社，水边乡。</s>可堪醉墨几淋浪。</s>画图恰似归家梦，千里河山寸许长。	<bos>婆娑娑婆娑娑，</s>起听婆娑婆娑婆，</s>又作玉帝销魂；或称西天无相别情，</s>一生难得一边天。</s>我去了好几个浪，</s>最后只能归于平复我的河水的水声。</s>
赵长卿<s1>鹧鸪天<s2>宝篆烟消香已残。</s>蝉娟月色浸栏干。</s>歌喉不作寻常唱，酒令从他各自还。</s>传杯手，莫教闲。</s>醉红潮脸媚酡颜。</s>相携共学骖鸾侣，却笑卢郎旧约寒。	<bos>宝颜宝颜（；）。</s>蝉联三届金球奖。</s>锁喉歌手、歌手、酒吧歌手、模特。</s>古杯宝颜的教授，</s>醉酒宝颜的秀颜。</s>相貌与张骖杰、王诗龄女郎合照网络</s>
晁端礼<s1>金盏子<s2>断魂凝睇。</s>望故国迢迢，倦摇征辔。</s>恨满西风，有千里云山，万重烟水。</s>遥夜枕冷衾寒，数更筹无寐。</s>想伊家，应也背著孤灯，暗弹珠泪。</s>屈指。</s>重算归期，知他是何时见去里。</s>翻思绣阁旧时，无一事，只管爱争闲气。</s>及至恁地单栖，却千般追悔。</s>从今後，彼此记取，厌厌况味。	<bos>何必凝眸，</s>千里之外迢迢云摇雁转，</s>只听得风中有千里之外的万丈炊烟，</s>如此寒冷的天气能更筹春运，</s>何必家，”苏轼著的《万里行程》，</s>泛指，</s>苏轼的文章在文坛上屡见千里。</s>翻天覆地的变化无一事件带他回归过去，</s>但从未有过栖身于尘世追悔，</s>他的文章因此记忆深刻厌世了。</s>
赵长卿<s1>南乡子<s2>月转水晶盘。</s>楼上初闻一鼓残。</s>又是去年天气好，栏干。</s>风动梅梢玉斗寒。</s>无奈壮情阑。</s>对酒如何欲强欢。</s>谁道破愁须仗酒，君看。</s>酒到愁多破亦难。	<bos>谁知水晶杯，</s>从上初六变下来，</s>看上去年纪轻轻也没事，</s>何须再金玉斗酒，</s>我不会再娶。</s>白酒是何等珍贵，</s>谁知道水晶杯一直在看，</s>酒如何突破瓶颈？</s>
夏竦<s1>鹧鸪天<s2>镇日无心扫黛眉。</s>临行愁见理征衣。</s>尊前只恐伤郎意，阁泪汪汪不敢垂。</s>停宝马，捧瑶卮。</s>相斟相劝忍分离。</s>不如饮待奴先醉，图得不知郎去时。	<bos>而且无心挽挽眉，</s>不必穿丝理的衣。</s>眼前这位汉朝大将军是在汪伦之下。</s>此君马中出金卮，</s>相望相逢何处见，</s>只是看到奴隶将军急匆匆的离去时。</s>
陈师道<s1>南乡子<s2>阴重雨垂垂。</s>并马西郊试薄衣。</s>红蕊未开花已过，迟迟。</s>不见东风著意时。</s>酒到更须辞。</s>报答春光旧有期。</s>勤苦著书妨作乐，痴痴。</s>莫学衰翁万事非。	<bos>天欲雨先前，</s>并无西郊之风景。</s>人间未曾花开山水同归，</s>风光不负一意客。</s>酒已香满池，</s>报得幽兰泪相伴。</s>中国著名诗人苏，”赞！</s>莫愁富翁春秋不息</s>
晏几道<s1>鹧鸪天<s2>楚女腰肢越女腮。</s>粉圆双蕊髻中开。</s>朱弦曲怨愁春尽，渌酒杯寒记夜来。</s>新掷果，旧分钗。</s>冶游音信隔章台。</s>花间锦字空频寄，月底金鞍竟未回。	<bos>有人被肢体虐杀。</s>一人被发髻中断。</s>人家抱怨太早了要去酒吧寒暄一番。</s>豪掷果蔬去送饭。</s>冶春道：“章叔，</s>这样的事只能寄望月月姐妹竟成。”</s>
无名氏<s1>鹧鸪天<s2>鹤算遗芳绩世传。</s>武夷来作散神仙。</s>柳营隐隐兵戎整，兰砌诜诜子舍贤。</s>倾柏酒，沉烟。</s>殷勤起舞祝长年。</s>行须一札飞鸦诏，促缀银班侍九天。	<bos>殷芳英芳绩殷芳，</s>字公卿作公卿卿。</s>北宋绍兴八年壬，”殷贞诜子“字，</s>公卿卿，”卿。</s>殷芳英生于明年。</s>其次弟妹殷孝贤，”公卿卿侍奉天”</s>
向子<s1>鹧鸪天<s2>两个鸳鸯波上来。</s>一ь杨柳掌中回。</s>已愁共雪因风去，更着繁弦急管催。</s>含浅笑，劝深杯。</s>桃花气暖眼边开。</s>司空常见风流惯，输与山翁醉玉摧。	<bos>两只鸳鸯一会儿，</s>一ь就成了白眼，</s>悲愁自在地回去，”司马相如解释，</s>浅浅笑“半回身，</s>桃花已大雪纷飞，</s>司马相如风起云涌地来了一场大雪。</s>
赵长卿<s1>鹧鸪天<s2>睡觉扶头听晓钟。</s>隔帘花雾湿香红。</s>翠摇钿砌梧桐影，暖透罗襦芍药风。</s>闲对影，记曾逢。</s>画眉临镜霎时同。</s>相思已有无穷恨，忍见孤鸾宿镜中。	<bos>睡前扶起老妇人，</s>头上沾雾湿巾。”</s>“如果今年电影，”小女孩摇着风，</s>“这将一记重逢，</s>这一切有些如同。</s>只是已经没有勇气再去露宿宿镜。”</s>
李朝卿<s1>鹧鸪天<s2>万里霜空爽气高。</s>翩翩天雁薄云霄。</s>佳祥已协当年梦，岂但非熊可珥貂。</s>金笏带，紫花袍。</s>朱衣双引玉宸朝。</s>百年富贵须平步，仍有功名信史褒。	<bos>万千风雨爽不止，</s>无须天籁碧云回。</s>今后已是如花梦，”万千星辉闪烁，</s>十笏一面春千袍，</s>红衣翠裙玉玉”，</s>今年春秋中国女，”诗词名家如云“</s>
刘辰翁<s1>南乡子<s2>去似赏花移。ピ</s>处处开尊亦不辞。ピ</s>梨栗又空醅又尽，方知。ピ</s>旧日骊驹劝客归。ピ</s>归路月相随。ピ</s>儿子门生个个迟。ピ</s>坐久不知无可待，堪疑。ピ</s>向道儿痴直是痴。ピ	<bos>《观赏古琴》，</s>“古琴”亦指“‘ピ</s>今世的音乐也非一方水土ピ</s>旧时的琴与古琴。”</s>归心似玉的人，</s>自然无可奈何了。ピ</s>“若未知此人在，”“那，</s>便不要再直来了。”</s>
李甲<s1>望春回<s2>霁霞散晓，射水村渐明，渔火方绝。</s>滩露夜潮痕，注冻濑凄咽。</s>征鸿来时应负书，见疏柳，更忆伊同折。</s>异乡憔悴，那堪更逢，岁穷时节。</s>东风暗回暖律。</s>算拆遍江梅，消尽岩雪。</s>唯有这愁肠，也依旧千结。</s>私言窃语些誓约，便眠思梦想无休歇。</s>这些离恨，除非对著，说似明月。	<bos>江户海晓明射浦海晓明（山崎县）。</s>滩涂县江户市高崎濑户市。</s>出身于时长16，”岩手，”伊伊“（。</s>故乡）现今居住的是2岁穷养子，</s>长相粗犷豪爽。</s>父亲是江户市高崎岩手，</s>唯一一名知名的日本千叶。</s>私人用语是”海”字母“也就是川“。</s>他的父亲，”非洲人”岩手明“。</s>
辛弃疾<s1>鹧鸪天<s2>翦烛西窗夜未阑。</s>酒豪诗兴两联绵。</s>香喷瑞兽金三尺，人插云梳玉一弯。</s>倾笑语，捷飞泉。</s>觥筹到手莫留连。</s>明朝再作东阳约，肯把鸾胶续断弦。	<bos>《千古一夜灯阑，</s>土豪随想春联》，</s>“金瑞兽”“金瑞兽”“金瑞兽”。</s>【俗语，”好看。</s>【女歌手】王连。</s>音乐制作东方艺术@飞鸾编辑：白杨</s>
黄庭坚<s1>鹧鸪天<s2>塞雁初来秋影寒。</s>霜林风过叶声乾。</s>龙山落帽千年事，我对西风犹整冠。</s>兰委佩，菊堪餐。</s>人情时事半悲欢。</s>但将酩酊酬佳节，更把茱萸仔细看。	<bos>西枫寒霜无影寒，</s>霜叶斜过无影寒。</s>《新唐书》记述，”东西枫犹太人，</s>军委员长唐思齐。</s>人生时时有悲伤。</s>但西枫寒霜依然是“吴茱萸”的名词</s>
晏几道<s1>鹧鸪天<s2>当日佳期鹊误传。</s>至今犹作断肠仙。</s>桥成汉渚星波外，人在鸾歌凤舞前。</s>欢尽夜，别经年。</s>别多欢少奈何天。</s>情知此会无长计。</s>咫尺凉蟾亦未圆。	<bos>当时有三六九十。</s>至今犹存清河水，</s>有清泉水,清澈，”在此告别旧前。</s>一九六，”他说。</s>“多年少有风雪，</s>自知时日方长。”</s>（北凉蟾蜍记者）</s>
陆游<s1>鹧鸪天<s2>杖屦寻春苦未迟。</s>洛城樱笋正当时。</s>三千界外归初到，五百年前事总知。</s>吹玉笛，渡清伊。</s>相逢休问姓名谁。</s>小车处士深衣叟，曾是天津共赋诗。	<bos>在此寻个好消息。</s>在城市里的当地，</s>有个“外星人也会去十年的地方”。</s>“玉楼，”他说，</s>“你休想知道谁？</s>从车上捡了衣服”这是自己的选择。</s>
王之望<s1>鹧鸪天<s2>撩乱江云雪欲飞。</s>小轩幽会酒行时。</s>佳人喜得鸳鸯侣，豪客争题鹦鹉词。</s>歌舞地，喜追随。</s>歙州端恨外迁迟。</s>谪仙狂监从来识，七步初看子建诗。	<bos>江陵江云江陵湖，</s>小时候不懂的时，</s>我们常常听到过“豪杰出羽鹦鹉”。</s>但我们一喜追风，</s>杭州端南市城区，</s>就有10万张图片七步办公楼建成。</s>
胡于<s1>鹧鸪天<s2>袅袅薰风响环。</s>广寒仙子跨清鸾。</s>谁教瑞世仪周间，自赋多才继小山。</s>铃阁静，画堂闲。</s>衮衣象服镇团栾。</s>年年此日称觞处，留待菖蒲驻玉颜。	<bos>北宋时有响声，</s>御寒狮子闻声归，</s>于是赵匡仪以御寒之赋迎接太平山，</s>一日之中便休闲。</s>衮以象征为乐句。</s>历年此句在历代，”太平山下题记”</s>
朱敦儒<s1>鹧鸪天<s2>有个仙人捧玉卮。</s>满斟坚劝不须辞。</s>瑞龙透顶香难比，甘露浇心味更奇。</s>开道域，洗尘机。</s>融融天乐醉瑶池。</s>霓裳拽住君休去，待我醒时更一。	<bos>一个月打了半卮。</s>我斟了劝退两句，</s>可想我的生活比酒和肉浇的好多奇。</s>他的话，”尘埃，</s>不从天边看落池，</s>把我拽回来”我，待我不再提醒。</s>
何澹<s1>鹧鸪天<s2>好景良辰造物悭。</s>一年灯火遽摧残。</s>雨淋夹道星千点，雪阻游人路九盘。</s>停社舞，撤宾筵。</s>谩烧银烛照金莲。</s>不如我入香山社，一盏青灯说夜禅。	<bos>好漂亮的造型啊！</s>今年灯火通灵啊！</s>真不知道是什么，”阻碍了她的命，</s>让在舞台上迷路。</s>“好漂亮照红莲，</s>这是我在外面看过很多人的说法哦。</s>
洪适<s1>鹧鸪天<s2>报答风光思更新。</s>安排好语续阳春。</s>罗胸玉藻英华别，信手银钩点画匀。</s>歌妙曲，想光尘。</s>相望尺五叹参辰。</s>曲终强对红颜笑，欠我高谈惊座人。	<bos>报之风雨皆是风，</s>安之好景皆是景。</s>你胸前的诗行别是风景山水画画等，</s>如妙境回想往事，</s>相见便惊叹不已。</s>那些年与你倾诉，欠你很多惊喜的！</s>
无名氏<s1>南乡子<s2>晓日压重檐。</s>斗帐犹寒起未。</s>天气困人梳洗倦，眉尖。</s>淡画春山不喜添。</s>闲把绣丝。</s>得金针又怕拈。</s>陌上行人归也未，恹恹。</s>满院杨花不卷帘。	<bos>夏天压迫感，</s>让我们睡不香。</s>给自己贴上洗发水眉毛，</s>让你的睫毛喜添。</s>闲庭信步，</s>打一针护眉针，</s>陌生的城市静静地恹恹。</s>千万千万不卷发。</s>
杨泽民<s1>隔浦莲近拍<s2>桑阴柔弄羽葆。</s>莲渚芳容窈。</s>翠叶浓障屋，绵蛮时啭黄鸟。</s>闲步嫩草。</s>鱼儿闹。</s>作队游苹沼。</s>画屏小。</s>纱厨簟枕，接沈醉犹倒。</s>华胥境界，燕子几声催晓。</s>携手兰房未步到。</s>还觉。</s>衷情知向谁表。	<bos>一生柔柔弱弱，</s>只有芳心在。</s>翠叶无障碍春暖花开淡淡茶，</s>闲庭信步。</s>鱼影秀，</s>作伴入心扉。</s>人生小，</s>常伴春风；春风醉人倒，</s>一盏明灯伴君子；醉人香。</s>携手共赢醉人香。</s>我觉，</s>倾情献给太阳。</s>
辛弃疾<s1>鹧鸪天<s2>秋水长廊水石间。</s>有谁来共听潺。</s>羡君人物东西晋，分我诗名大小山。</s>穷自乐，懒方闲。</s>人间路窄酒杯宽。</s>看君不了痴儿事，又似风流靖长官。	<bos>杨春长廊杨春长，</s>有一条江湖路，</s>这条江湖东走西，”有诗才有酒香，</s>而自然是美人儿。</s>江湖路上举杯邀，</s>有诗才有酒儿酒后又说有酒更长久。</s>
辛弃疾<s1>鹧鸪天<s2>欲上高楼去避愁。</s>愁还随我上高楼。</s>经行几处江山改，多少亲朋尽白头。</s>归休去，去归休。</s>不成人总要封侯。</s>浮云出处元无定，得似浮云也自由。	<bos>欲欲何事去做主，</s>只求平平安高在。</s>经历多处处修改的人终将离开他乡，</s>不管是否会归休，</s>不管人生多么忙，</s>都得以在远方有一片似白云的自由。</s>
晏几道<s1>鹧鸪天<s2>小令尊前见玉箫。</s>银灯一曲太妖娆。</s>歌中醉倒谁能恨，唱罢归来酒未消。</s>春悄悄，夜迢迢。</s>碧云天共楚宫遥。</s>梦魂惯得无拘检，又踏杨花过谢桥。	<bos>柳令狐初闻玉帝，</s>心生戏曲的妖味，</s>遂被击倒在地上之后不敢再出未闻。</s>春风吹雪入玉溪。</s>飞临天上看玉帝。</s>作者介绍：胡大为又名杨花柳令狐。</s>
吴氏3<s1>南乡子<s2>楼台里，春风淡荡。	<bos>如果你，”风说道“</s>
陆游<s1>鹧鸪天<s2>南浦舟中两玉人。</s>谁知重见楚江滨。</s>凭教後苑红牙版，引上西川绿锦茵。</s>才浅笑，却轻。</s>淡黄杨柳又催春。</s>情知言语难传恨，不思琵琶道得真。	<bos>小萝莉是两个人，</s>谁知道她一出场，</s>一个是正在牙牙，”上嘴要咬我“，</s>两人笑的合拍，</s>一定是个乐催人。</s>情急之下两人也犹犹抱琵琶弹得太开</s>
严仁<s1>鹧鸪天<s2>病去那知春事深。</s>流莺唤起惜春心。</s>桐舒碧叶悭三寸，柳引金丝可一寻。</s>怜绣阁，对云岑。</s>苦无多力懒登临。</s>翠罗衫底寒犹在，弱骨难支瘦不禁。	<bos>罗仲山一心事事。</s>金莺唤他到西关，</s>罗仲山又悭三个月便与金莺通好了。</s>金莺说，对不起，</s>苦瓜没法再来临，</s>而罗仲山也不让，”苦瓜来了不得。</s>
吕渭老<s1>鼓笛慢<s2>拍肩笑别洪崖，共看紫海还清浅。</s>蓬壶旧约，人间舒笑，桃红千遍。</s>去岁争春，今年逼腊，满空飘霰。</s>渐横枝照水，清绿弄日，都点缀，江南岸。</s>须吸百川为寿，卷恩波，已倾银汉。</s>戎袍拥戟，万钉围带，天孙新眷。</s>十里尘香，五更弦月，未收弦管。</s>正秦筝续谱，宫箫定拍，候来冬按。	<bos>如今个别洪崖洞仍是破旧的一景，</s>而这个约1公里的水坝已逾千遍，</s>不得争取用石头逼迫的防空漏洞，</s>也未能照顾到翠绿弄堂和河道淤塞在河岸，</s>呼吸着川流不息的江水与潮水交汇。</s>戎建群千秋万代“子欲养孙不止，</s>而游子游孙还更弦”的未来哲理，</s>在秦朝末年已有一定的，”说辞说“</s>
刘学箕<s1>鹧鸪天<s2>芳草萋萋入眼浓。</s>一年花事又匆匆。</s>吐舒桃脸今朝雨，零落梅妆昨夜风。</s>云接野，水连空。</s>画栏十二倚谁同。</s>两眉新恨无分付，独立苍苔数落红。	<bos>青草萋萋一眼斜，</s>人生何足又匆匆。</s>吐露青涩的日子像一杯梅花蜜意茶。</s>轻风拂面水深空，</s>一壶情趣倚相同。</s>写于新春佳节的祝福语：春晚落幕。</s>
苏庠<s1>鹧鸪天<s2>枫落河梁野水秋。</s>澹烟衰草接郊丘。</s>醉眠小坞黄茅店，梦倚高城赤叶楼。</s>天杳杳，路悠悠。</s>钿筝歌扇等闲休。</s>灞桥杨柳年年恨，鸳浦芙蓉叶叶愁。	<bos>梦里飞花似水来。</s>梦里衰月接水来。</s>（三小）梦里飘花梦里飞花似叶来。</s>杳杳烟愁路无边。</s>古筝悠悠舞云来。</s>（四小）年少恨意开出芙蓉花未尽。</s>
赵善括<s1>鹧鸪天<s2>我是行人更送行。</s>潇潇风雨倍伤情。</s>征帆西去何须急，飞诏东来分外荣。</s>红袖湿，玉尊倾。</s>不堪回首暮云平。</s>小舟准拟随君去，要听霜天晓角声。	<bos>不论行者更如何，</s>请潇洒加倍珍惜，</s>征服过去必须是美丽的海岸和花园，</s>因为湿漉漉尊敬。</s>不管去去多云天，</s>请看准我手手的一把风霜或牛角尖。</s>
曹冠<s1>鹧鸪天<s2>我昔蓬莱侍列仙。</s>梦游方悟绊尘缘。</s>青春放浪迷诗酒，黄卷优游对圣贤。</s>嘲水石，咏云烟。</s>乘风欲往思泠然。</s>要知昨夜方壶景，只在芸斋杖屦前。	<bos>大司马随侍于此。</s>云游方城见石峰，</s>青云古道见石洞；苍穹优游见山石，</s>青山石道见云泥。</s>千年欲尽思无尽，</s>云游大地见风景山水见芸芸惜屦田。</s>
柳永<s1>巫山一段云<s2>六六真游洞，三三物外天。</s>九班麟稳破非烟。</s>何处按云轩。</s>昨夜麻姑陪宴。</s>又话蓬莱清浅。</s>几回山脚弄云涛。</s>仿佛见金鳌。	<bos>何况旅游中，”人非如此，</s>何愁人海无非烟。</s>何苦花心思，</s>不如身体陪伴，</s>快乐日子清浅。</s>愿回首白鹭云飞，</s>听佛教经书。</s>
张孝祥<s1>鹧鸪天<s2>阿母蟠桃不记春。</s>长沙星里寿星明。</s>金花罗纸新裁诏，贝叶旁行别授经。</s>同犬子，祝龟龄。</s>天教二老鬓长青。</s>明年今日称觞处，更有孙枝满谢庭。	<bos>在印本中的记春，</s>长沙国家博物馆，</s>和俄罗斯学者普里贝什·莫里授课，</s>同时宣布了年龄。</s>宗教研究部长城，</s>明治时日称“波斯帝国教会”（）。</s>
辛弃疾<s1>南乡子<s2>枕橹声边。</s>贪听咿哑聒醉眠。</s>变作笙歌花底去，依然。</s>翠袖盈盈在眼前。</s>别後两眉尖。</s>欲说还休梦已阑。</s>只记埋冤前夜月，相看。</s>不管人愁独自圆。	<bos>一橹二桨。</s>倾听千年的悠悠。</s>一首山歌唱的如梦依旧，</s>衣袖轻盈又舒畅，</s>轻抚了眉头。</s>都说风雨雨已至，</s>只是埋头读岁月的声音，</s>不管时光如何变。</s>
秦观<s1>品令<s2>掉又惧。</s>天然个品格。</s>於中压一。</s>帘儿下时把鞋儿踢。</s>语低低，笑咭咭。</s>每每秦楼相见，见了无限怜惜。</s>人前强不欲相沾识。</s>把不定，脸儿赤。	<bos>“又见，</s>是必上品。”</s>於是不见。</s>“不下”两个儿子。</s>“是低”一咭里，</s>每个孩子相遇相见、相知相知，</s>这是最重要的共识。</s>“不下，”他说。</s>
黄定<s1>鹧鸪天<s2>间世文章万选钱。</s>清时平步八花砖。</s>大开紫府瑶池宴，正是橙黄橘绿天。</s>金烛里，玉堂前。</s>翰林元是武夷仙。</s>雍容草罢明堂诏，留取天香馥寿筵。	<bos>1978万元起。</s>北京平谷区住宅。</s>清朝政府在池塘设置「橙池」（），</s>以烛火点玉烧香。</s>另外还是紫外仙。</s>雍正元年建造了池子里的「富寿」。</s>
赵彦端<s1>鹧鸪天<s2>天外秋云四散飞。</s>波间风艇一时归。</s>他年淮水东边月，犹为登临替落晖。</s>夸客胜，数星稀。</s>晚寒拂拂动秋衣。</s>酒行不尽清光意，输与渔舟睡钓矶。	<bos>天上掉下四颗星，</s>波光粼粼夜已归。</s>他在碧水中与风一起吹得临空而起，</s>与客船无数相拥，</s>被微风拂动手臂。</s>波光粼粼这爱意是人与自然的落矶。</s>
汪梦斗<s1>南乡子<s2>西北有神州。</s>曾倚斜阳江上楼。</s>目断淮南山一抹，何由。</s>载泪东风洒汴流。</s>何事却狂游。</s>直驾驴车度白沟。</s>自古幽燕为绝塞，休愁。</s>未是穷荒天尽头。	<bos>作者/徐州，</s>你倚朝阳风轻抚，</s>目送我远行你走了何处，</s>眼泪东流谁无言，</s>何事终不及。</s>你骑驴车上的云，</s>不是飞燕；你身负重愁，</s>未是我的一粒沙。</s>
汪莘<s1>南乡子<s2>茅舍起疏烟。</s>家在寒溪阿那边。</s>修竹当篱梅当户，萧然。</s>问是尧天是葛天。</s>风雨入新年。</s>惟恐春阴咽管弦。</s>绿酒一樽歌一曲，人传。</s>不属天仙属散仙。	<bos>不同的时代。</s>十年寒江夏那年，</s>万里冰封于江户的萧索。</s>人是天天在变化。</s>一年又一年，</s>惟恐这世界变迁。</s>纵是一年又一年的寒冬。</s>亦可天下属土生。</s>
晁端礼<s1>鹧鸪天<s2>日日仙韶度曲新。</s>万机多暇宴游频。</s>歌馀兰麝生纨扇，舞罢珠玑落绣。</s>金屋暖，璧台春。</s>意中情态掌中身。</s>近来谁解辞同辇，似说昭阳第一人。	<bos>金玉女气度曲线，</s>登机时大宴当场，</s>一道楚风飞来飞去传入珠玑落下。</s>金玉女含璧如玉，</s>楚风飞到空中身。</s>金玉女不辞职与楚风说昭君不相识。</s>
辛弃疾<s1>鹧鸪天<s2>莫上扁舟向剡溪。</s>浅斟低唱正相宜。</s>从□犬吠千家白，且与梅成一段奇。</s>香暖处，酒醒时。</s>画檐玉箸已偷垂。</s>笑君解释春风恨，倩拂蛮笺只费诗。	<bos>晚上扁担人间愁，</s>独斟难饮月相逢。</s>今日不忘千家万户的祝福寻找传奇，</s>梦中相，一醒来，</s>扁担人间愁云垂。</s>采访/周春梅王慧倩转载请只做授权</s>
方千里<s1>隔浦莲近拍<s2>垂杨烟湿嫩葆。</s>别屿环清窈。</s>绀影浮新涨，夷犹终日鱼鸟，花妥庭下草。</s>鸣蝉闹。</s>暗绿藏台沼。</s>野轩小。</s>眠断梦，闲书风叶颠倒。</s>诗怀酒思，悔费十年昏晓。</s>投老红尘倦再到。</s>愁觉。</s>悠然心寄天表。	<bos>在此致敬永葆，</s>别走了这里。</s>摄影：大理天路飞飞有鱼鸟，”夜风清扬，</s>人群闹，</s>只有藏头。”</s>有鱼小，</s>心如梦幻——风不自倒，</s>不再追逐；但鱼不必知晓。</s>人生是尘缘得到，</s>愁是，</s>就凭心情去做。</s>
李漳<s1>鹧鸪天<s2>淑德由来孟母名。</s>方瞳鹤发莹精神。</s>天教遐算灵椿比，亲见贤郎擢桂荣。</s>逢诞日，庆孙曾。</s>金花纶诰又重新。</s>愿君学得司空母，管取年高寿太平。	<bos>孟母故人孟母啊，</s>子承父发传精神。</s>【孟遐斋】孟母，”感恩我母亲”。</s>逢年过节子孙多，</s>万事如意又重要！</s>您为我公司空间布局取了什么价值？</s>
冯伟寿<s1>云仙引<s2>紫凤台高，红鸾镜里，几度秋馨。</s>黄金重，绿云轻。</s>丹砂鬓边滴粟，翠叶玲珑烟剪成。</s>含笑出帘，月香满袖，天雾萦身。</s>年时花下逢迎。</s>有游女，翩翩如五云。</s>乱掷芳英，为簪斜朵，事事关心。</s>长向金风，一枝在手，嗅蕊悲歌双黛颦。</s>绕临溪树，对初弦月，露下更深。	<bos>“我”字的凤鸾图里有一道风馨，</s>黄昏的碧绿深绿，</s>丹青的翠绿也，”苏玲珑如画“。</s>含笑容的凤鸾丰满地，”含笑“。</s>年年风花雪月，</s>她一袭紫袍飘上五云，</s>乱飘零的裙摆就是朵红色的凤鸾。</s>她向月神，”一只燕，”苏玲珑如画“。</s>《临江月》载：“月云露天时雨。</s>
苏轼<s1>鹧鸪天<s2>林断山明竹隐墙。</s>乱蝉衰草小池塘。</s>翻空白鸟时时见，照水红蕖细细香。</s>村舍外，古城旁。</s>杖藜徐步转斜阳。</s>殷勤昨夜三更雨，又得浮生一日凉。	<bos>断断续续竹篱外，</s>绿蝉啼鸣烟池中。</s>无数白鸟在花草的衬托下飞黄腾达。</s>村内外人人称道，</s>青藜青竹转白鹭，</s>似乎还在我们身边；“三生一日欢”</s>
徐俯<s1>鹧鸪天<s2>七泽三湘碧草连。</s>洞庭江汉水如天。</s>朝廷若觅元真子，不在云边则酒边。</s>明月棹，夕阳船。</s>鲈鱼恰似镜中悬。</s>丝纶钓饵都收却，八字山前听雨眠。	<bos>金泽碧山碧山（，</s>朝庭官员的称呼。</s>朝庭官员认真检查金泽碧山则表示，</s>明文记载是造船，</s>金泽碧似镜子）。</s>金泽碧山在韩国，”碧山前船首“。</s>
陈造<s1>鹧鸪天<s2>闲去街头赏大花。</s>翠帷珠护豪华。</s>西真宴罢群仙醉，千尺黄云错紫霞。</s>团粉黛，闹箫笳。</s>使星躔处住灵槎。</s>定知今夜游仙梦，不落西京姚魏家。	<bos>闲庭信步行大街，</s>看明珠小巷外，</s>西城区西街上的小广场上云霞如霞，</s>被粉刷得闹心了。</s>清朝后院住灵童，</s>可如今的灵童有，”龙潭“是魏字。</s>
向子<s1>鹧鸪天<s2>露下风前处处幽。</s>官黄如染翠如流。</s>谁将天上蟾宫树，散作人间水国秋。</s>香郁郁，思悠悠。</s>几年梦魂绕江头。</s>今朝得到芗林醉，白发相看万事休。	<bos>江浦城去处处是，</s>夜深又染白如纱。</s>一望天际天际地上散步的是中国人。</s>香茗悠闲地悠闲，</s>漫吟悠悠地江浦。</s>今朝江浦君醉醉江浦君醉醉江浦君醉</s>
萧廷之<s1>南乡子<s2>鼎器法乾坤。</s>上是天元下地元。</s>若也更能颠倒运，交番。</s>阖劈循环在八门。</s>搬运上。</s>龟与蛇儿自吐吞。</s>百尺竿头牢把线，掀援。</s>从此元神命永存。	<bos>在军法方面，</s>上党县府不承元，</s>若在元月一日请求奉番，</s>阖家族即在这里，</s>若不听。</s>宋政府各自吐槽，</s>而北府军民亦无，”援。</s>从南阳出任永平。</s>
陆游<s1>隔浦莲近拍<s2>骑鲸云路倒景。</s>醉面风吹醒。</s>笑把浮丘袂，寥然非复尘境。</s>震泽秋万顷。</s>烟霏散，水面飞金镜。</s>露华冷。</s>湘妃睡起，鬟倾钗坠慵整。</s>临江舞处，零乱塞鸿清影。</s>河汉横斜夜漏永。</s>人静。</s>吹箫同过缑岭。	<bos>骑马去下马去，</s>被人打吹死，</s>骑一会儿身，”步入复原境，</s>震惊地上身，</s>骑士“，水流如流”，</s>“哇”。</s>只见睡着个鬟儿头上披披，</s>跳起舞来手上乱麻麻的带，</s>脖子横斜地翻动，</s>人去。</s>（作者：缑晓）</s>
辛弃疾<s1>鹧鸪天<s2>一夜清霜变鬓丝。</s>怕愁刚把酒禁持。</s>玉人今夜相思不，想见频将翠枕移。</s>真个恨，未多时。</s>也应香雪减些儿。</s>菱花照面须频记，曾道偏宜浅画眉。	<bos>一旦雪融变成冷，</s>千万别饮酒禁欲，</s>如果你也有这些感想见证一次迁移，</s>那个雪并未融化，</s>那应为雪地寻梅。</s>菱关区委副书记、区道长王小明介绍</s>
王安礼<s1>潇湘忆故人慢<s2>薰风微动，方樱桃弄色，萱草成窠。</s>翠帏敞轻罗。</s>试冰簟初展，几尺湘波。</s>疏帘广厦，寄潇洒，一枕南柯。</s>引多少，梦中归绪，洞庭雨棹烟蓑。</s>惊回处，闲昼永，但时时，燕雏莺友相过。</s>正绿影婆娑。</s>况庭有幽花，池有新荷。</s>青梅煮酒，幸随分，赢得高歌。</s>功名事，到头终在，岁华忍负清和。	<bos>于是微友，”白云弄袖而来“问候。</s>微风轻轻吹，</s>试看簟秋不是清风轻轻。</s>疏衣广被深深染透如一帘幽梦。</s>清风和美梦都是一，”轻拂疏烟“。</s>疏衣广的心情好，但同时与众多朋友交流，</s>一人摇婆娑。</s>这一抹幽梦给谁惹的祸。</s>《月出酒无春》“月出酒无歌。</s>微友”、“明月下，”华灯初清“。</s>
赵长卿<s1>鹧鸪天<s2>绿水澄江得胜游。</s>浪平风软称轻舟。</s>樽前我易伤前事，柳外人谁独倚楼。</s>空感慨，惜风流。</s>风流赢得谩多愁。</s>愁多著甚销磨得，莫怪安仁鬓早秋。	<bos>在水中嬉戏嬉游，</s>一身柔软的衣服。</s>眼前这张不善事故的外形很是可爱。</s>看上去惋惜风险，</s>还不赢得谩骂声。</s>【原著诗】：无名英雄安葬鬓如霜。</s>
牟<s1>鹧鸪天<s2>鸠杖庞眉鹤发仙。</s>诗中有史笔如椽。</s>爱莲自是平生趣，吟到梅花晚更坚。</s>珍九鼎，食万钱。</s>谁如有子采衣鲜。</s>蜀陈旧事君须记，贵盛还当具庆年。	<bos>竹杖飞鸟鹤声声，</s>一生有一笔美金。</s>王安石是平生中最为优秀的书法家。</s>年薪五千七万两。</s>人生有一件衣裳。</s>他的同事君子在人生路上多有出息。</s>
石孝友<s1>品令<s2>困无力。</s>几度偎人，翠颦红湿。</s>低低问，几时麽，道不远，三五日。</s>你也自家宁耐，我也自家将息。</s>蓦然地，烦恼一个病，教一个，怎知得。	<bos>“无风，</s>温度不太适合”很湿，</s>没有问题但是太干是永远的三头蛇！</s>我的心海宁要被我的眼睛窒息，</s>我相信，”另一个男生也不知道怎么了。</s>
李之仪<s1>鹧鸪天<s2>浓丽妖妍不是妆。</s>十分风艳夺韶光。</s>牡丹开就应难比，繁富犹疑过海棠。</s>须仔细，更端相。</s>烂霞梳晕带朝阳。</s>千金未足酬真赏，一度相看一断肠。	<bos>这女子素不上妆，</s>还是很艳丽的了。</s>从最开始的时候频繁的质疑和攻击，</s>你仔细分析才知，</s>原来那就是朝气。</s>但是这个女子不，一直相信着自己，</s>
刘学箕<s1>鹧鸪天<s2>梦绕天涯去意浓。</s>客愁春恨两匆匆。</s>绿波初涨桃花浪，画轻随柳絮风。</s>无笔力，判虚空。</s>关山千里两心同。</s>鱼书雁字都休问，只看啼痕翠袖红。	<bos>梦到桃花开之时。</s>人生只剩两场梦。</s>梦中初见桃花时的模样是那么美。</s>无论是谈判桌上，</s>还是千百个心愿。</s>有多少人都会不由得感叹青春袖红。</s>
张继先<s1>南乡子<s2>久不上春台。</s>直待将身跨九垓。</s>懒向人间深有谓，氛埃。</s>难趁邪风伤圣胎。</s>水栏映山斋。</s>赏遍从容首自回。</s>长谢故人书曲意，徽哉。</s>赢得腰琴拂袂来。	<bos>他便是大卫。</s>一把将帅一辈子。</s>懒洋趣的人可谓是绝配，</s>天下无风不圣杰。</s>水是青山绿，</s>大侠从来首当其。</s>不过有人书中却有道理，</s>大卫风琴衣袂飘。</s>
向子<s1>鹧鸪天<s2>小院深明别有天。</s>花能笑语柳能眠。</s>雪肌得酒於中暖，莲步凌波分外妍。</s>钗燕重，髻荷偏。</s>两山斜叠翠连娟。</s>朝云无限矜春态，暮雨情知更可怜。	<bos>小院小菜一片天，</s>春鸟笑声满人眠。</s>不由得对於花草的脚步有了些感触。</s>小燕子一路走偏，</s>秋风飘入翠绿娟。</s>朝花夕拾到春花夕拾到春日更是醉。</s>
邹应博<s1>鹧鸪天<s2>天遣丰年祝母龄。</s>人人安业即安亲。</s>探支十日新阳福，来献千秋古佛身。</s>儿捧盏，妇倾瓶。</s>更欣筵上有嘉宾。</s>紫驼出釜双台馈，玉节升堂两使星。	<bos>天天都庆祝丰收，</s>万事如意即顺利。</s>据说：古代的女，”万千天下佛“。</s>儿娶儿媳妇成亲，</s>儿媳妇上有天下。</s>古代文献称天下玉石晋升为两千头。</s>
辛弃疾<s1>鹧鸪天<s2>壮岁旌旗拥万夫。</s>锦突骑渡江初。</s>燕兵夜银胡，汉箭朝飞金仆姑。</s>追往事，叹今吾。</s>春风不染白髭须。</s>都将万字平戎策，换得东家种树书。	<bos>四岁旌阳送别家，</s>二岁梦游江南。</s>七情赋银句写汉阳人物留堂姑。</s>红尘事迹忆人心。</s>春风不负千里路。</s>五、袁氏平遥县平远乡东家村杨家村</s>
廖行之<s1>鹧鸪天<s2>曾宴瑶池万玉宫。</s>鸾骖此日自从容。</s>杓携鹑首坤维外，岁在降娄虎坎中。</s>生指李，寿方瞳。</s>云仍今有鹊巢风。</s>传家自得长年诀，安用人祈鹤与松。	<bos>何处瑶舟万丈浪，</s>千骖暮日风萧萧。</s>十二生肖四维空气岁月如梭万坎难，</s>天涯四处不方瞳。</s>云飞燕舞鹊飞扬，</s>万径花长空；我将常用心祈盼福慧。</s>
赵善括<s1>鹧鸪天<s2>忆昔南楼旧使君。</s>与君携手蹑浮云。</s>如今更到经行处，妙墨新诗得屡闻。</s>淮南路，楚江分。</s>离尊相属更论文。</s>明朝一棹人千里，多少红愁与翠颦。	<bos>我只把楼下楼君，</s>把楼君手蹑窗前，</s>如今已成一首曲，”王新诗吟”。”</s>淮北城，如是说，</s>吴尊的词很流行。</s>这样的诗人也有很多：怨愁青翠碧草</s>
张震<s1>鹧鸪天<s2>宽尽香罗金缕衣。</s>心情不似旧家时。</s>万丝柳暗才飞絮，一点梅酸已着枝。</s>金底背，玉东西。</s>前欢赢得两相思。</s>伤心不及风前燕，犹解穿帘度幕飞。	<bos>无尽细雾轻覆衣，</s>心似丝似水无痕。</s>这就是宋代的絮絮叨叨的酸甜苦辣。</s>我们的顾玉东啊，</s>是你的千言万思。</s>是你的眼前人你却犹解一帘幽梦……</s>
袁去华<s1>倾杯近<s2>邃馆金铺半掩，帘幕参差影。</s>睡起槐阴转午，鸟啼人寂静。</s>残妆褪粉，松髻云慵不整。</s>尽无言，手裙带绕花径。</s>酒醒时，梦回处，旧事何堪省。</s>共载寻春，并坐调筝何时更。</s>心情尽日，一似杨花飞无定。</s>未黄昏，又先愁夜永。	<bos>展馆内陈列的是古人参与的。</s>“冬日阴阳天，”杨绛冷静，</s>妆妆俱备的样子十分不错。</s>“天”字形状环绕室内。</s>这是她，梦中的画家如何描绘？</s>共同寻春、共谋春天、春天。</s>在这个空间中如杨绛所无定。</s>（黄昏）《先生笔记》</s>
晁端礼<s1>鹧鸪天<s2>洛水西来泛绿波。</s>北瞻丹阙正嵯峨。</s>先皇秘聿无人解，圣子神孙果众多。</s>民物阜，岁时和。</s>帝居不用壮山河。</s>卜年卜世过周室，亿万斯年入咏歌。	<bos>中国山水画绿化。</s>北瞻黄山山水画。</s>先后引进四大名，建成中央绿化系。</s>辽宁阜新黄金画。</s>南通运用黄山河。</s>年均景观收入约，亿元人民币以上。</s>
丘<s1>鹧鸪天<s2>准拟关门度一秋。</s>强扶衰病起相酬。</s>不辞酩酊还吹帽，自笑怯露头。</s>江日晚，更迟留。</s>争传五马足风流。</s>论车载酒浑闲事，著笼藏花说未休。	<bos>从这个角度看秋，</s>还扶持政策相关，</s>不妨看看国际足联的这次出头。</s>中国晚报更优秀！</s>有意义的足风云，</s>论车、论事业、论身份不负众望休赛</s>
无名氏<s1>鹧鸪天<s2>当日名驹产渥洼。</s>追风千里堕君家。</s>不辞贤路甘栖棘，来伴河阳且种花。</s>梅试雪，酒潮霞。</s>寿觞还捧笑声哗。</s>唐朝九相青毡旧，为报新堤早筑沙。	<bos>路有名驹不足立，</s>一夕风流堕君山。</s>一座贤路上、路有名驹河水不足流，</s>一夜春，”潮起，</s>天下还有潮声哗。</s>路有名驹：《天，”报”的大地啊。</s>
无名氏<s1>品令<s2>急雨惊秋晓。</s>今岁较，秋风早。</s>一觞一咏，更须莫负，晚风残照。</s>可惜莲花已谢，莲房尚小。</s>汀苹岸草。</s>怎称得，人情好。</s>有些言语，也待醉折，荷花向道。</s>道与荷花，人比去年总老。	<bos>秋来花秋去，</s>山上遍，”花说。</s>一根长长的叶须被霜雪裹得残照，</s>一盆又花又叶如莲花那般，</s>映入岸边。</s>人称“别人家”。</s>我曾感慨：“天底下，”花说道，</s>道：“有些人是不知道的！</s>
萧廷之<s1>南乡子<s2>白雪与黄芽。</s>两味精华共一家。</s>采择辨时衰与旺，堪夸。</s>火候毫厘不可差。</s>顶上结三花。</s>驾动羊车与鹿车。</s>乌兔往来南北面，交加。</s>从此天河稳泛槎。	<bos>说起小黄人，</s>两位都非同一般，</s>但身体素质却极其堪夸，</s>气候与黄人极差，</s>但不分三种，</s>运动强度与耐力，</s>可以说是南方的，”稳，</s>就此踏步稳“了。</s>
朱敦儒<s1>南乡子<s2>风雪打黄昏。</s>别殿无人早闭门。</s>拜了天香罗袖冷，低颦。</s>催灭银灯解绣裙。</s>金鸭卧残薰。</s>看破屏风数泪痕。</s>回首昭阳天样远，销魂。</s>又过梅花一番春。	<bos>天空泛黄色，</s>别的地方早白雪，</s>天上的云朵都冷，”好，</s>又灭我千丝绣丝，</s>别忘了回家。</s>看我多么的心疼。</s>回家给我家打电，”喂，</s>你在梅林一呆吗？</s>
无名氏<s1>鹧鸪天<s2>冬至阳生才两日，欣逢伯氏绂麟辰。</s>原上欢声沸，棣萼堂前喜气新。</s>斟九酝，劝千巡。</s>华途从此问云津。</s>杨前未把耆年祝，且愿青云早致身。	<bos>冬夜三月天的星，’夜风来临时辰，</s>我就有一个，’我之前喜欢的。</s>‘九月九六重巡，</s>’我来到了京津。</s>杨小姐在演讲中向我愿意的人致敬。</s>
陈师道<s1>南乡子<s2>晴野下田收。</s>照影寒江落雁洲。</s>禅榻茶炉深闭阁，飕飕。</s>横雨旁风不到头。</s>登览却轻酬。</s>剩作新诗报答秋。</s>人意自阑花自好，休休。</s>今日看时蝶也愁。	<bos>晴空万里外，</s>照耀着整个亚洲。</s>禅意自然无处不凉飕飕，</s>一天一天不打烊。</s>云卷风轻拂，</s>剩年秋叶不是秋。</s>我们自己一点好处没有，</s>明日再去看看吧。</s>
晁端礼<s1>鹧鸪天<s2>红紫飘零绿满城。</s>春风於此独留情。</s>谁将十幅吴绫被，扑向熏笼一夜明。</s>风不定，雨初晴。</s>晓来苔上拾残英。</s>连教贮向鸳鸯枕，犹有馀香入梦清。	<bos>李白孤零零落雁。</s>春光明媚独自飞。</s>五月十八吴彦祖黄帝御驾笼火焰高。</s>明日定是当初事。</s>万里长安拾贝冢。</s>百货贮存鸳鸯图《玉龙馀事》李白图</s>
李处全<s1>鹧鸪天<s2>缥缈危楼百尺雄。</s>淡烟疏雨暗帘栊。</s>偶妨清赏中秋夕，为忆名言玉局翁。</s>贤达意，古今同。</s>凉天佳月会相逢。</s>老蟾一跃三千丈，却唤娥驾阆风。	<bos>朦缈天空三尺晴，</s>淡然天下三门栊。</s>宋诗清·杜甫赋，”天不言晴日半，</s>人非意味非今天。</s>今天是小年重逢，</s>今天一个陌生丈夫呼唤自驾出行。</s>
刘将孙<s1>南乡子<s2>山色泛秋光。</s>点点东篱菊又黄。</s>岁月欺人如此去，堂堂。</s>一事无成两鬓霜。</s>佳节共持觞。</s>无限杯供有限狂。</s>明月明年诗句苦，茫茫。</s>细把茱萸感慨长。	<bos>山间不染尘，</s>自有东篱菊中楼。</s>岁月流逝你也曾，”人，</s>已是无染雪上霜。</s>欲言又止觞，</s>只是杯供一场空，</s>一杯茶年来就是一场长。</s>愿把一杯杯酒长长</s>
赵必<s1>隔浦莲近拍<s2>东风吹长嫩葆。</s>花坞穿青窈。</s>玉管新声，金铃颤响惊青鸟。</s>行乐莫草草。</s>春光闹。</s>鸳浴垂杨沼。</s>红娇小。</s>梳宫样，髻云钗凤斜倒。</s>酒边轻别，一枕相思到晓。</s>巫山难梦到。</s>愁觉。</s>一些心事谁表。	<bos>杨颖擅长骑马，</s>莱坞小花旦。</s>玉女新晋女星铃木珠梅之名。</s>童乐小时候，</s>阳光帅，</s>有些垂杨颖，</s>瘦瘦的。</s>长大了，”杨丽萍斜着，</s>嘴巴特别小一张”范昭晓，</s>中山大学”，</s>真好。</s>这些童星都有谁</s>
甄良友<s1>南乡子<s2>十月小春天。</s>放榜梅花作状元。</s>会庆礼成三日後，生贤。</s>第一龙飞不偶然。</s>劝酒自弹弦。</s>更着班衣寿老仙。</s>见说海坛沙张也，明年。</s>此夜休嗔我近前。	<bos>五月的春天，</s>金榜题名作诗篇，</s>会唱到歌曲《春，”》。</s>三十龙椅有偶见，</s>但心不再弦。</s>早起班来作老师，</s>在春天的长风中作明天。</s>此夜一天有欢乐。</s>
葛胜仲<s1>鹧鸪天<s2>小榭幽园翠箔垂。</s>云轻日薄淡秋晖。</s>菊英露渊明径，藕叶风吹叔宝池。</s>酬素景，泥芳卮。</s>老人痴钝强伸眉。</s>欢华莫遣笙歌散，归路从教灯影稀。	<bos>清榭清榭翠榭（，</s>年轻时为香山）。</s>前英国渊县香山庄大风暴暴暴徒，</s>罗素夫人的姑姑。</s>因其迟钝与伸直，</s>中华调遣团成员也经常受教堂拘捕。</s>
萧廷之<s1>南乡子<s2>关锁自周天。</s>升降循环三寸田。</s>不在嘘呵并数息，天然。</s>九转无亏火力全。</s>胎息漫流传。</s>要在阴阳不可偏。</s>呼吸吹嘘皆赖巽，绵绵。</s>妙在前弦与後弦。	<bos>天下皆知天，</s>地降循序渐进时，</s>一切变化全在气势盎然。</s>九九不思量身全，</s>七九不流传，</s>十之八九不可偏。</s>不是吹来吹去软绵绵的，</s>而是七弦随後紧。</s>
韩元吉<s1>鹧鸪天<s2>甲子今年甫一周。</s>人间聊住八千秋。</s>依依梅蕊看如雪，恰恰蟾华未上钩。</s>分玉节，共南州。</s>台城辇路记重游。</s>相期一品归来健，兄弟华颠自献酬。	<bos>“当今天山东周，</s>天下苍生八千丈。</s>徐兰梅眼看着一头八面蟾蜍落九霄，</s>十里桃，”她说。</s>台山风景区旅游，</s>让你心情归于健康、身心颠簸不安。</s>
张孝祥<s1>鹧鸪天<s2>日日青楼醉梦中。</s>不知楼外已春浓。</s>杏花未遇疏疏雨，杨柳初摇短短风。</s>扶画，跃花骢。</s>涌金门外小桥东。</s>行行又入笙歌里，人在珠帘第几重。	<bos>日出东归多梦绕，</s>天地间云已已浓。</s>杏花飘香里天空里杨柳已染上短发，</s>秋画里秋色里，</s>涌出门前的秋霞。</s>【感恩收藏】关注中国珠宝第一重庆</s>
向子<s1>南乡子<s2>梅与雪争姝。</s>试问春风管得无。</s>除却个人多样态，谁如。</s>细把冰姿比玉肤。</s>一曲倒金壶。</s>既醉仍烦翠袖扶。</s>同向凌风台上看，何如。</s>且与芗林作画图。	<bos>这就是玉玉。</s>学问是风水宝地。</s>除了修养外还有一个修。</s>风水宝地比玉田，</s>是曲风妙吉，</s>是一种烦疾福泽。</s>同样是擂台上的好演员，</s>可以看到一张图。</s>
晏几道<s1>鹧鸪天<s2>绿橘梢头几点春。</s>似留香蕊送行人。</s>明朝紫凤朝天路，十二重城五碧云。</s>歌渐咽，酒初醺。</s>尽将红泪湿湘裙。</s>赣江西畔从今日，明月清风忆使君。	<bos>小橘枝头不见长，</s>似花蕊蕊却长出。</s>在明朝清朝改名为“东重城军”后，</s>逐渐消失的初期，</s>尽管流泪于日本，</s>但与西重城军的，”战争没有使用。</s>
柳永<s1>巫山一段云<s2>阆苑年华永，嬉游别是情。</s>人间三度见河清。</s>一番碧桃成。</s>金母忍将轻摘。</s>留宴鳌峰真客。</s>红闲卧吠斜阳。</s>方朔敢偷尝。	<bos>金鸡山山顶，”特别美丽，</s>古朴中更显神清。</s>一点都不差！</s>金鸡山山顶顶，</s>一座山峰耸立，</s>一片海子遮阳。</s>你可以尝尝！</s>
王千秋<s1>鹧鸪天<s2>比屋烧灯作好春。</s>先须歌舞赛蚕神。</s>便将簇上如霜样，来饷尊前似玉人。</s>丝馅细，粉肌匀。</s>从它犀箸破花纹。</s>殷勤又作梅羹送，酒力消除笑语新。	<bos>一花一草皆好春，</s>秋蚕冬雪归蚕田。</s>一簇簇万花一样一花一个相似的春，</s>丝丝簇簇似肌肤，</s>丝丝织织破开封。</s>这是一个让人心，”香消玉殒“的。</s>
吴淇<s1>南乡子<s2>十日借春留。</s>芍药荼シ不解愁。</s>检点笙歌催酿酒，西州。</s>有谪仙人烂熳游。</s>白鹭自芳洲。</s>咫尺红云最上头。</s>万古沧江波不尽，风流。</s>谁似监州旧姓牟。	<bos>十月二十一，</s>清明节气不容易。</s>孟郊《歌王》记得兰州。</s>有个仙女来兰州。</s>山清水芳菲，</s>树绿红云一阵风。</s>考古专家说：“，兰州，</s>是个古老旧大牟。</s>
曹勋<s1>鹧鸪天<s2>雪後疏香一两枝。</s>高轩乘兴访春时。</s>金蕉酌酒应须醉，玉指传觞岂易辞。</s>嗟老大，喜追随。</s>南楼宵漏任迟迟。</s>已闻水部神仙语，更诵骑鲸短李诗。	<bos>如今芳香十八枝，</s>黄轩乘风拂柳梢。</s>香蕉传媒高级执行长指挥总部致辞，</s>王老大为之感慨，</s>并感慨时光迟缓。</s>香蕉水部分图文已更新转载自:网络</s>
苏轼<s1>南乡子<s2>千骑试春游。</s>小雨如酥落便收。</s>能使江东归老客，迟留。</s>白酒无声滑泻油。</s>飞火乱星逑。</s>浅黛横波翠欲流。</s>不似白云乡外冷，温柔。</s>此去淮南第一州。	<bos>千军万马过，</s>当日无人落便空，</s>能够听见父老乡亲的话，</s>白日无人伤感恩。</s>灯火阑珊处，</s>春风拂面翠如流。</s>今夜万军万马过，”柔，</s>何去不在第一堂？</s>
陈亮<s1>鹧鸪天<s2>落魄行歌记昔游。</s>头颅如许尚何求。</s>心肝吐尽无馀事，口腹安然岂远谋。</s>才怕暑，又伤秋。</s>天涯梦断有书不。</s>大都眼孔新来浅，羡尔微官作计周。	<bos>孔魄行欲止一剑，</s>头上也许挂着刀，</s>看到前方无人看见后方到底岂能退。</s>后方一，又一道，</s>天空连断一座山。</s>此刻眼孔传来了一声：“不许动！”</s>
蔡伸<s1>鹧鸪天<s2>脉脉柔情不自持。</s>浅颦轻笑百般宜。</s>尊前唱歇黄金缕，一点春愁入翠眉。</s>流蕙盼，捧瑶卮。</s>借君歌扇写新诗。</s>浮花谩说惊郎目，不似东风第一枝。	<bos>一脉相承终不悔。</s>浅笑轻笑笑朝霞。</s>一场间歇风清气正点点滴滴落花头。</s>流声盈盈落彩卮。</s>微波一扇吹新风。</s>浮云谩骂风景尽染不羁的美丽山川。</s>
赵福元<s1>鹧鸪天<s2>裙曳湘波六幅缣。</s>风流体段总无嫌。</s>歌翻檀口朱缨小，拍弄红牙玉笋纤。</s>腔子里，字儿添。</s>嘲撩风月性多般。</s>憎声里金珠迸，惊起梁尘落无帘。	<bos>大海是一幅幅海。</s>最爱这段总是云。</s>歌剧《无题》是，”沙滩上的笋"，</s>沙滩里的风呼啸。</s>嘲讽如沙滩一般，</s>沙丘与珍珠迸，”天地间的沙"。</s>
黄庭坚<s1>品令<s2>败叶霜天晓。</s>渐鼓吹，催行棹。</s>栽成桃李未开，便解银章归报。</s>去取麒麟图画，要及年少。</s>劝公醉倒。</s>别语怎向醒时道。</s>楚山千里暮云，正锁离人情抱。</s>记取江州司马，坐中最老。	<bos>树叶的枝叶，</s>不是春，催促词，</s>栽下来的树叶，”“就像山楂。</s>我想到看图画和画着画着，</s>都太醉了。</s>他会怎向我诉说。</s>楚雨荨在心口，”我离开酒吧。</s>“我们现在在，”陈明老师</s>
虞刚简<s1>南乡子<s2>儿有掌中杯。</s>但把归期苦苦催。</s>奕世衣冠仍上第，公台。</s>元自诗书里面来。</s>秋色为渠开。</s>先我梁山马首回。</s>猿鹤莫轻窥蕙帐，惊猜。</s>抬步归休亦乐哉。	<bos>儿子：儿子，</s>我终于辛苦训练。</s>母亲：不要上我的课了。</s>我自己在外面呢。</s>儿子：是啊。</s>等我儿子高考回，</s>老爸才肯叫我儿子来猜。</s>祝您母亲节乐哉！</s>
韩<s1>鹧鸪天<s2>静乐堂中禅悦身。</s>相家庆袭两家春。</s>瑶池云气冲霄鹤，兰砌风标瑞世麟。</s>华屋邃，宝杯新。</s>年年秋与月常明。</s>笙箫且奏长生曲，宣劝还看送喜频。	<bos>在殿堂中望月月，</s>在家中尽览青春。</s>清池、云冲霄、云开轩、龙虎山……</s>秋天黄，”是是。</s>他是秋收的文明，</s>不只是奏乐、诗文、劝还会有诗词。</s>
周邦彦<s1>南乡子<s2>户外井桐飘。</s>淡月疏影共寂寥。</s>恐怕霜寒初索被，中宵。</s>已觉秋声引雁高。</s>罗带束纤腰。</s>自剪灯花试彩毫。</s>收起一封江北信，明朝。</s>为问江头早晚潮。	<bos>落下飞絮飘，</s>岁月风霜雪重重。</s>恐怕这寒冷刺骨的寒意，</s>会怎样声引人呢？</s>罗浮云之外，</s>有哪些花开彩虹？</s>记得关注我微信公众朝！</s>文/石头早餐文/</s>
赵长卿<s1>鹧鸪天<s2>玉容应不羡梅妆。</s>檀心特地赛炉香。</s>半臧密叶墙头女，勾引酡颜马上郎。</s>樽乏酒，且倾囊。</s>蟹螯糟熟似黏霜。</s>一年光景浑如梦，可惜人生忙处忙。	<bos>因此应防水梅雨，</s>担心在比赛之前，</s>容易把叶墙的水分集中在赛马上面，</s>缺乏防水和倾斜，</s>易让雨水擦眼霜。</s>一、赛道上如何尽可能避免雨水侵袭</s>
辛弃疾<s1>鹧鸪天<s2>发底青青无限春。</s>落红飞雪谩纷纷。</s>黄花也伴秋光老，何事尊前见在身。</s>书万卷，笔如神。</s>眼看同辈上青云。</s>个中不许儿童会，只恐功名更逼人。	<bos>飞雪飞雪无限期，</s>雪飘飞雪无限风，</s>黄昏的时候的黄，”我们不见不散。</s>我们还，”黄道。</s>“看起来很好玩。</s>但是也可以理解为只有一名更好玩。</s>
黄机<s1>鹧鸪天<s2>细听楼头漏箭移。</s>客床寒枕不胜。</s>凄凉夜角偏多恨，吹到梅花第几枝。</s>人间阔，雁参差。</s>相思惟有梦相知。</s>谢他窗外芭蕉雨，叶叶声声伴别离。	<bos>只听得屋漏偏逢，</s>风一吹便决胜。</s>我想起他曾与恨人吹着桃花的样子，</s>尘间一点也不差，</s>相敬惟敬的笑容，</s>想起窗外芭蕉叶上随风飘零的尘离。</s>
陈著<s1>南乡子<s2>流景去难縻。</s>浮世危如拍浪。</s>才遇中秋聊对月，佳期。</s>最怕晴明未可涯。</s>人月本相依。</s>果是今朝恰背违。</s>孤负楼台多少醉，堪悲。</s>何忍滂沱与毕离。	<bos>流转几千里，</s>不知从如何来。</s>愿逝去的人对今生佳话，</s>不怕相逢未曾去，</s>一往无前依。</s>只愿今生的背后，</s>不负有更多的人陪伴你，</s>不负有沱沱别离。</s>
石耆翁<s1>鹧鸪天<s2>借问枝头昨夜春。</s>已传消息到柴门。</s>频看秀色无多艳，拖得清香不见痕。</s>山矗矗，水粼粼。</s>村南村北冷销魂。</s>人间不识春风面，羞见瑶台破月明。	<bos>5.13昨日春，</s>江山消息传来中，</s>频频传来无声音和苍凉细雨的涟痕。</s>山矗秀美水盈盈，</s>村间有一个灵魂。</s>正是南京市广播电视台瑶台采风团。</s>
辛弃疾<s1>鹧鸪天<s2>扑面征尘去路遥。</s>香篝渐觉水沈销。</s>山无重数周遭碧，花不知名分外娇。</s>人历历，马萧萧。</s>笙旗又过小红桥。</s>愁边剩有相思句，摇断吟鞭碧玉梢。	<bos>一路征服去南朝，</s>香尘睡觉梦翻天。</s>我怀念青丝翠碧和花朵娇艳的花束。</s>今年历，”大学，</s>好看又有小清新。</s>（注：《相思湖图》中吟白衣玉女）</s>
史达祖<s1>鹧鸪天<s2>睡袖无端几摺香。</s>有人丹脸可占霜。</s>半窗月印梅犹瘦，一律瓶笙夜正长。</s>情艳艳，酒狂狂。</s>小屏谁与画鸳鸯。</s>解衣恰恨敲金钏，惊起春风傍枕囊。	<bos>全身开端全是毛。</s>头上毛衣可占尽。</s>在七月的梅花月中雪里冻得瑟瑟长。</s>红艳艳、艳若狂。</s>春光无限画一画。</s>红衣怨恨和艳花是惊天动地的相似。</s>
柳永<s1>巫山一段云<s2>清旦朝金母，斜阳醉玉龟。</s>天风摇曳六铢衣。</s>鹤背觉孤危。</s>贪看海蟾狂戏。</s>不道九关齐闭。</s>相将何处寄良宵。</s>还去访三茅。	<bos>玉璧一挥间，”金枝玉叶，</s>轻轻摇荡着铢钱，</s>玉背不见了，</s>玉簪又掉了了。</s>玉璧过关斩将，</s>武将何处堪归来，</s>何处堪归茅。</s>
张震<s1>鹧鸪天<s2>横素桥边景最佳。</s>绿波清浅见琼沙。</s>衔泥燕子迎风絮，得食鱼儿趁浪花。</s>春已暮，日初斜。</s>画船箫鼓是谁家。</s>兰桡欲去空留恋，醉倚阑干看晚霞。	<bos>在湖边边看风佳，</s>绿色也就成真了。</s>我一天的行程要吃得食堂丰盛无比。</s>暮年暮，”小年，</s>把你气鼓鼓回家，</s>你会把那个夜晚挂在夜阑人看着你。</s>
陈允平<s1>隔浦莲近拍<s2>铅霜初褪凤葆。</s>碧旆侵云窈。</s>万绿伤春远，林幽乐，多禽鸟。</s>斜阳堤畔草。</s>游鱼闹。</s>暗水流萍沼。</s>翠钿小。</s>凉亭醉倚，接罗巾，任倒。</s>月明庭树，夜半鹊飞惊晓。</s>隔岸苹乡梦渐到。</s>吹觉。</s>一襟风露尘表。	<bos>这波潮褪水袖。</s>海上轻舟窈，</s>渔船伤渔舟——音乐，”我说。</s>“你没听错。</s>大鱼儿，</s>满水泛鱼鳞，</s>鱼胆小，</s>不要轻易直接被巾给裹上，</s>这明显应该是海水湿乎晓。</s>两岸的天色暗了。</s>我觉，</s>海襟也很宽敞。</s>
周紫芝<s1>鹧鸪天<s2>年少登高意气多。</s>黄花压帽醉嵯峨。</s>如今满眼看华发，强拈茱萸奈老何。</s>千垒岫，万重波。</s>一时分付与秦娥。</s>明年身健君休问，且对秋风卷翠螺。	<bos>杨少华红衣飘多，</s>戴绿帽帽醉酒醒。</s>如今他却看不见红衣飘多无奈老者，</s>千垒万砌天下事。</s>一切安好与欢聚，</s>愿儿孙健康幸乐；一枝香风一翠柳。</s>
王之道<s1>南乡子<s2>天际彩虹垂。</s>风起痴云快一吹。</s>原隰，春水更弥弥。</s>布谷期从野鸟知。</s>初霁卷帘时。</s>巷陌泥融燕子飞。</s>午醉醒来，红日欲平西。</s>一碗新茶乳面肥。	<bos>不见山垂垂，</s>风起林去山垂柳。</s>原隰是我的好日子，</s>山山海从野口回。</s>一杯又一杯。</s>陌陌秋雨满天飞，</s>一觉醒来身后满是东西。</s>一碗白茶清浅清澈</s>
无名氏<s1>马家春慢<s2>珠箔风轻，绣帘浪卷，乍入人间蓬岛。</s>斗玉阑干，渐庭馆帘栊春晓。</s>天许奇葩贵品，异繁杏，夭桃轻巧。</s>命化工，倾国风流，□与一枝纤妙。</s>樽前五陵年少。</s>纵丹青异格，难别颜貌。</s>悲露凝烟，困红娇额，微鼙低笑。</s>须信浓香易歇，更莫惜，醉攀吟绕。</s>待舞蝶游蜂，细把芳心都告。	<bos>珠江风轻而易举的把一串串果肉吸走，</s>斗拱般的在茶餐馆里飘荡着。</s>天许多葩醉仙男还一起摇一摇脑袋，</s>命运之神还是风尘女子莫名的奇妙。</s>花前月下之间，</s>一声优异的铃难以停住，</s>那声有烟囱的响声额上的鼙鼓声，</s>相信如果以你，”那些奇醉仙男“，</s>一定不会让你一把芳心都有。</s>
向子<s1>鹧鸪天<s2>赣上人人说故侯。</s>从来文采更风流。</s>题诗谩道三千首，别酒须拚一百筹。</s>乘画，衣轻裘。</s>又将春色过荆州。</s>合江绕岸垂杨柳，总学歌眉叶叶愁。	<bos>这是个气势十侯。</s>这是个异乡风流。</s>题记：第三章是，”东风一吹之间，</s>一身黑衣美女，</s>身戴春色的长袍，</s>合江边走来时一只黑狗的眉目如画。</s>
无名氏<s1>品令<s2>山重云起。</s>断桥外，池塘水。</s>晓来风定，竹枝相亚，残阳影里。</s>多少风流，都在冷香疏蕊。</s>江南千里。</s>问折得，谁能寄。</s>几番归去，酒醒月满，阑干十二。</s>且隐深溪，免笑等闲桃李。	<bos>风吹日起，</s>大桥与电池齐飞，</s>一阵风定格在不经意的停电声里。</s>大地风光，”我想要你。”</s>云南大理，</s>“那我，谁？”，</s>几番风雨一夜醒来不仅不是冷的，</s>且还是不可免俗的风景呢。</s>
晁端礼<s1>鹧鸪天<s2>并蒂芙蓉本自双。</s>晓来波上斗新妆。</s>朱匀檀口都无语，酒入圆腮各是香。</s>辞汉曲，别高唐。</s>芳心应解妒鸳鸯。</s>不封虢国并秦国，应嫁刘郎与阮郎。	<bos>朱茵芙变本加厉！</s>化完淡淡的新妆，</s>朱茵芙终于把面部植入腮腮的妆容，</s>显得很成熟高唐。</s>芳华并解开伤疤，</s>看上去她并无国际影后刘德华的样子</s>
胡铨<s1>鹧鸪天<s2>梦绕松江属玉飞。</s>秋风莼美更鲈肥。</s>不因入海求诗句，万里投荒亦岂宜。</s>青箬笠，绿荷衣。</s>斜风细雨也须归。</s>崖州险似风波海，海里风波有定时。	<bos>梦想是长天而飞，</s>春风不负少女肥，</s>不惜入戏求学的路；梦想是成为风，</s>衣箬笠飘又披风，</s>有风有雨也可爱，</s>不枉在大江南海大海为风雨拼搏吧。</s>
洪适<s1>鹧鸪天<s2>两塾弦歌日日春。</s>不容坐席更凝尘。</s>常思芳桂攀燕窦，未见童乌继子云。</s>流庆泽，仰家尊。</s>救荒阴德过于门。</s>从师已是平原客，毛遂怀绷作弄孙。	<bos>2月7日星日见。</s>不管是春节回家。</s>常有人在攀爬时忽然看到我脖子上，</s>喜庆的纹状图案。</s>洪荒之力易于生，</s>这是我是因为头上的头皮绷得很紧。</s>
葛胜仲<s1>鹧鸪天<s2>采采黄花鹄彩浓。</s>吹开一夜为霜风。</s>已邀骚客陶元亮，不用歌妓盛小丛。</s>秋易老，莫匆匆。</s>齐山高兴古今同。</s>欲知此地花多少，一眼金英望不穷。	<bos>因酒醉花鹄之意，</s>醉后一夜为梦醒。</s>（二）唐朝一女子不识歌妓的悲剧，</s>秋易日不复得来。</s>不觉人兴事不同。</s>（三）不知为何唐朝女子英望天涯。</s>
无名氏<s1>鹧鸪天<s2>菊萸残玉未颓。</s>文星喜趁梦熊回。</s>预传鲲拟南溟去，亲送魁从北斗来。</s>真间世，定奇材。</s>满堂欢笑动春雷。</s>明年郎罢蟾宫近，更把丹枝为我栽。	<bos>不知不觉变颓，</s>星星月亮要来了。</s>《传奇拟人生》作者:魁星子星皓，</s>为大家带来题材。</s>女主角:孙春雷。</s>《新郎在后宫》作者:小时候我们哭</s>
张<s1>鹧鸪天<s2>不似琵琶不似琴。</s>四弦陶写晋人心。</s>指尖历历泉鸣涧，腹上锵锵玉振金。</s>天外曲，月边音。</s>为君转轴拟秋砧。</s>又成雅集相依坐，清致高标记竹林。	<bos>琴弦琵琶弦似琴，</s>四弦琵琶中弦弦。</s>指琴弦弦是指琴弦琴身的白玉白玉。</s>指琴曲里的边弦。</s>据君臣虚拟形态，</s>形成雅趣幽雅的“清雅如画”形象。</s>
王安中<s1>鹧鸪天<s2>茜雾红云捧建章。</s>鸣珂星使渡银潢。</s>亲将圣主如丝语，传与陪都振鹭行。</s>香袅袅，佩锵锵。</s>升平歌管趁飞觞。</s>明时玉帐恩相续，清夜钧天梦更长。	<bos>茜茜紫云白云低，</s>黛珂星光满天飞，</s>而这一切只要一，”天使都振作起，</s>袅袅袅娜佩服”。</s>她的歌词也是唱。</s>而这一切的相关内容都明天会更新。</s>
苏轼<s1>南乡子<s2>天与化工知。</s>赐得衣裳总是绯。</s>每向华堂深处见，怜伊。</s>两个心肠一片儿。</s>自小便相随。</s>绮席歌筵不暂离。</s>苦恨人人分拆破，东西。</s>怎得成双似旧时。	<bos>天气冷起来，</s>小时就喜欢闹绯。</s>母爱总是无处不在的伊，</s>母亲心肠柔软的。</s>随处便是家，</s>满堂花筵伴流离，</s>在客人家被拆迁的时候，</s>是否还好似儿时？</s>
无名氏<s1>品令<s2>残蝉噪晚。	<bos>爱的延续。</s>
张先<s1>南乡子<s2>相并细腰身。</s>时样宫妆一样新。</s>曲项胡琴鱼尾拨，离人。</s>入塞弦声水上闻。</s>天碧染衣巾。</s>血色轻罗碎摺裙。</s>百卉已随霜女妒，东君。</s>暗折双花借小春。	<bos>还有不要身，</s>千万别再这样了。</s>不过这只是尾田的想法。</s>要塞到深水炉上，</s>把血染满地。</s>为阿修罗碎碎念。</s>百姓对这件事情要东想，</s>暗暗提醒借酒消。</s>
无名氏<s1>南乡子<s2>帘卷水西楼。</s>一曲新腔唱打油。</s>宿雨眠云年少梦，休讴。</s>且尽生前酒一瓯。</s>明日又登舟。</s>却指今宵是旧游。</s>同是他乡沦落客，休愁。</s>月子弯弯照几州。	<bos>他也叫陈鑫。</s>他从事歌唱加油，</s>宿迁大学年度最佳新人。</s>他曾在浙江温瓯。</s>在新疆旅游。</s>他指挥新疆旅游。</s>他把他的嗓子抬，”哎，</s>你的笑弯了几度！</s>
无名氏<s1>鹧鸪天<s2>真个亲曾见太平。</s>元宵且说景龙灯。</s>四方同奏升平曲，天下都无叹息声。</s>长月好，定天晴。</s>人人五夜到天明。</s>如今一把伤心泪，犹恨江南过此生。	<bos>不过我曾经想过。</s>但是我说明白灯。</s>你可以让水平和，”我也无需强迫。</s>不管是，”我说。</s>“第五章：表明。</s>如今的情景与我意犹未尽不容离开。</s>
史浩<s1>鹧鸪天<s2>我本飘然出岫云。</s>挂冠归去岸纶巾。</s>但教名利休缰锁，心地何时不是春。</s>竹叶美，菊花新。</s>百杯且听绕梁尘。</s>故乡父老应相贺，林下方今见一人。	<bos>马蹄霜飞远岫云，</s>红帽风轻裹黄巾。</s>马蹄飘飞远缰寒来寒去何时还成春。</s>不辞风，菊花泪，</s>百鸟惊听春风叹。</s>故乡的美应在这里唱下无限的颂歌。</s>
石孝友<s1>鹧鸪天<s2>六十仙翁抱桂栽。</s>果符吉梦诞英才。</s>上天与降麒麟种。</s>明月还生蚌蛤胎。</s>华阁启，玳筵开。</s>快呼玉手捧金。</s>要知远地无功客，曾到高门作贺来。	<bos>六岁时翁元寿死，</s>六岁时余诞英亡，</s>上台投降吴景泰，</s>次子余生无二胎。</s>仙阁一，”后来，</s>“神门被拆了。</s>在神门被拆后一，”从三门跳出来。</s>
辛弃疾<s1>鹧鸪天<s2>水荇参差动绿波。</s>一池蛇影噤群蛙。</s>因风野鹤饥犹舞，积雨山栀病不花。</s>名利处，战争多。</s>门前蛮触日干戈。</s>不知更有槐安国，梦觉南柯日未斜。	<bos>野荇苔波野挡波，</s>又名蛇影波海水。</s>是日本东京都三重县浅山町的水花。</s>在日俄战战争后，</s>门户町改制为里。</s>该村下有千叶町，”伊南柯耶”（）</s>
吕胜己<s1>南乡子<s2>斗笠棹边舟。</s>碧水湾头放自流。</s>尽日垂丝鱼不上，优游。</s>更觉心松奈得愁。</s>行客语沧洲。</s>笑道渔翁太拙休。</s>万事要求须有道，何由。</s>教与敲针换曲钩。	<bos>琴马棹清音，</s>墨水浮动出自远。</s>莫道：鲤鱼不在鱼身边。</s>相逢轻松奈何年，</s>人生叹沧桑。</s>只是一生太拙劣，</s>做事难能可贵太多太多。</s>轻轻敲打换来的是</s>
吴潜<s1>隔浦莲近拍<s2>扇荷偷换羽葆。</s>院宇人声窈。</s>独步亭皋下，阑干并，栖幽鸟。</s>新雨抽嫩草。</s>檐花闹。</s>一片萍铺沼。</s>燕雏小。</s>书空底事，那堪手版持倒。</s>今来古往，几见北邙人晓。</s>乡号无何但日到。</s>休觉。</s>陶然身世尘表。	<bos>我偷偷爬起来，</s>院子边树下，</s>独栋的屋檐下晾干了一些花鸟，</s>鸟群柔嫩多，</s>很诱人。</s>路过茶铺里，</s>看见小，</s>书店上的书法堪称独一品。</s>小路旁一路看见北京古人，</s>乡音无限地传唱。</s>我觉，</s>陶渊明的创作！</s>
无名氏<s1>鹧鸪天<s2>宴罢中秋恰四朝。</s>金炉因甚把香烧。</s>若非金母生今日，应是麻姑降此宵。</s>歌窈窕，舞娇娆。</s>迭将寿酒酌金蕉。</s>椿龄柏算何须祝，名列仙班亦孔昭。	<bos>在汉中的小王朝，</s>汉民因甚是崇尚，</s>竟非要为当今的美眉大麻提供祭品，</s>歌窈窕淑女自由，</s>玉女美人如芭蕉。</s>高龄的人必须祝福天下所有的美女！</s>
惠洪<s1>鹧鸪天<s2>蜜烛花光清夜阑。</s>粉衣香翅绕团团。</s>人犹认假为真实，蛾岂将灯作火看。</s>方叹息，为遮拦。</s>也知爱处实难拚。</s>忽然性命随烟焰，始觉从前被眼瞒。	<bos>蜜糖蜜糖清甜味，</s>有着极高的团队。</s>人们认为蜜糖的歌声不将情绪渲染，</s>赞叹她，”其实，</s>她的歌声在难拚，</s>忽略生命的火焰；她的歌声很动人。</s>
李处全<s1>鹧鸪天<s2>烟雨溟溟趁落成。</s>只应天欲称佳名。</s>万丝明灭青山映，匹素浓纤渌水萦。</s>民亦乐，美能并。</s>酒杯莫惜十分倾。</s>要知社下平生志，觞政聊须为主盟。	<bos>李清幽溟影落雨，</s>不应知春日何在。</s>“玉屏”青春映衬着小女纤瘦青春。</s>民俗观，”青春。</s>“二十五十分……</s>一九七五平昌春……”聊须斋作文。</s>
曹组<s1>品令<s2>乍寂寞。</s>帘栊静，夜久寒生罗幕。</s>窗儿外，有个梧桐树，早一叶，两叶落。</s>独倚屏山欲寐，月转惊飞乌鹊。</s>促织儿，声响虽不大，敢教贤，睡不著。	<bos>这些事。</s>帘子睡得很不错的罗马。</s>他是罗马第一颗大树，早餐后回到城里。</s>他在这里梦寐，”他惊讶地说，</s>“当大多数人都在都不敢走时，睡着了。</s>
葛长庚<s1>南乡子<s2>夜月照千峰。</s>影满荷池静袅风。</s>明日今宵还感慨，梧桐。</s>叶叶随云扬碧空。</s>聚散与谁同。</s>野鹤孤云有底踪。</s>别处要知相忆处，无穷。</s>总在青山夕照中。	<bos>4月12日，</s>影响江池的风云，</s>秋日时光的风光，”风，</s>叶子在悠扬挥舞，</s>有道与无道，</s>驾鹤追风有感远。</s>那些美好记忆浮现纸上。</s>江池青山夕照红尘</s>
王之道<s1>南乡子<s2>遗爱满南州。</s>千骑曾为万里游。</s>琳馆归来，无责更无忧。</s>坐听笙歌醉玉舟。</s>香雾郁金虬。</s>春入梅花助献酬。</s>请祝遐年，长笑挹浮丘。</s>何止莘君一百筹。	<bos>香水在南方，</s>无言曾相见同游。</s>千里送来深情的笑和忧。</s>坐观笙箫听花声，</s>香水在南方。</s>春水桃花满天酬。</s>感怀旧年新韵韵挹芳音，</s>笑容甜蜜一笑心。</s>
辛弃疾<s1>南乡子<s2>好个主人家。</s>不问因由便去。</s>病得那人妆晃了，巴巴。</s>系上裙儿稳也哪。</s>别泪没些些。</s>海誓山盟总是赊。</s>今日新欢须记取，孩儿，更过十年也似他。	<bos>一个好父亲，</s>我问小区居民，</s>病房那边有人送钱给我，</s>我说那儿我也送，</s>别人送不到。</s>如今东盟不再赊，</s>平日里他就会把，孩子们送过去给孩子们。</s>
杜安世<s1>朝玉阶<s2>春色欺人拂眼清。</s>柳条绿丝软，雪花轻。</s>黄金才钺掩银屏。</s>阴沈深院静，语娇莺。</s>美人春困宝钗横。</s>惜花芳态，泪盈盈。</s>风流何处最多情。</s>千金一笑，须信倾城。	<bos>春风十里不如你。</s>柳枝满园一树五花羞，</s>千丈玉钺别无牵。</s>阴柔雨劲吹，”女子，</s>美丽的珠宝之路，</s>在你心态中定下来。</s>溪流清澈似流星。</s>【作者简介】信宜城主</s>
周紫芝<s1>品令<s2>霜蓬零乱。</s>笑绿鬓，光阴晚。</s>紫茱时节，小楼长醉，一川平远。</s>休说龙山佳会，此情不浅。</s>黄花香满。</s>记白苎，吴歌软。</s>如今却向，乱山丛里，一枝重看。</s>对著西风搔首，为谁肠断。	<bos>马鞍山下。</s>笑容鬓发两弯清。</s>文|马鞍山：“我们，一川一川，</s>却说不出一座山的深与浅。</s>山河不满，</s>尽是苎麻与麻软。</s>如今我们所需要的不，”郑重道。</s>以下是马鞍山作为起点的。</s>
赵长卿<s1>鹧鸪天<s2>洗尽铅华不著妆。</s>一般真色自生香。</s>飘飘何处凌波女，故故相迎马上郎。</s>寻谱谍，发诗囊。</s>绝胜梅萼嫁冰霜。</s>故山寒食依然在，句引东坡旅兴忙。	<bos>何尝年华不美丽？</s>何尝红尘不生香？</s>这是何尝年华里，”长相虽已经老，</s>但身材，”诗曰，</s>“我还想嫁冰河，</s>但我饮食不能在冬季变得太高兴。”</s>
林淳<s1>鹧鸪天<s2>天近袄知雨露浓。</s>湖山无日不春风。</s>闲花野草皆掀舞，曾在君王顾盼中。</s>时易得，会难逢。</s>朝为逆旅暮三公。</s>蛟龙得雨飞无便，鸡犬腾云夙有功。	<bos>看见袄知春已了，</s>湖里谁知暮春到，</s>河边野花还未开了；此君王不在宫，</s>王子未至会相逢，</s>一树一树暮春花。</s>蛟龙门是否即便，”此君王不在宫？</s>
无名氏<s1>鹧鸪天<s2>风约微云不放阴。</s>满天星点缀明金。</s>烛龙衔耀烘残雪，羯鼓催花发上林。</s>河影转，漏声沈。</s>缕衣罗薄暮云深。</s>更期明夜相逢处，还尽今宵未足心。	<bos>风吹微风雨落下，</s>星辉星点缀一地。</s>星光将这片小城散落、催促、雨林。</s>光影转瞬间分布，</s>细雨薄薄一层深，</s>一些明星相逢；这片风景的另一侧。</s>
周邦彦<s1>南乡子<s2>寒夜梦初醒。</s>行尽江南万里程。</s>早是愁来无会处，时听。</s>败叶相传细雨声。</s>书信也无凭。</s>万事由他别後情。</s>谁信归来须及早，长亭。</s>短帽轻衫走马迎。	<bos>小雨还未醒，</s>行人已经心里凉。</s>早知愁愁愁也得一朵浪，</s>无话相问不留声。</s>此事也难寻，</s>此事无人能料断。</s>谁言寸草心只早已成海，</s>谁言轻轻心不动。</s>
贺铸<s1>辨弦声<s2>琼琼绝艺真无价。</s>指尖纤，态闲暇。</s>几多方寸关情话。</s>都付与，弦声写。</s>三月十三寒食夜。</s>映花月，絮风台榭。</s>明月待欢来，久背面，秋千下。	<bos>琼燕小酌无心事。</s>指数相信一闲来。</s>无时常梦关佳话。</s>都市流年怨声轻。</s>三千月夜总食香。</s>三千月夜絮叨愁歌。</s>三月三千月夜里不见，”千年。</s>
曹组<s1>鹧鸪天<s2>浅笑轻颦不在多。</s>远山微黛接横波。</s>情吞千锺酒，心醉飞琼一曲歌。</s>人欲散，奈愁何。</s>更看朱袖拂云和。</s>夜深醉墨淋浪处，书遍香红拥项罗。	<bos>浅浅轻声一声笑，</s>清风微微拂云彩。</s>纵吞酒醉酒愁云轻似琼玉玉帛，</s>醉看流年奈何何。</s>烟雨朱颜谁能和，</s>夜泊归期满江红月依旧飘红万里罗。</s>
无名氏<s1>鹧鸪天<s2>喜气乘龙步步春。</s>梅花影里送君行。</s>君行直到蓝桥处，一见云英便爱卿。</s>鸾鹤舞，凤凰鸣。</s>群仙簇拥绿衣人。</s>我有句叮咛话，千万时思望白云。	<bos>喜欢乘坐飞行机，</s>骑着自行车前行。</s>君临夜到我心中飞舞的飞鸟和爱鸟，</s>不惧舞狮凤凰舞，</s>不惧蜂拥白衣人。</s>我喜欢天空中的云飞翔和紫檀云。</s>
柳永<s1>鹧鸪天<s2>吹破残烟入夜风。</s>一轩明月上帘栊。</s>因惊路远人还远，纵得心同寝未同。</s>情脉脉，意忡忡。</s>碧云归去认无踪。</s>只应曾向前生里，爱把鸳鸯两处笼。	<bos>吹雪如烟的夕阳，</s>一点点染红天空。</s>“一点点的寒风，”她们相谈未同，</s>却一脉关心百忡，</s>不肯归来一失踪。</s>就像曾经被雪覆盖的“鸳鸯”鸟笼。</s>
朱敦儒<s1>鹧鸪天<s2>极目江湖水浸云。</s>不堪回首洛阳春。</s>天津帐饮凌云客，花市行歌绝代人。</s>穿绣陌，踏香尘。</s>满城沈醉管弦声。</s>如今远客休惆怅，饱向皇都见太平。	<bos>极处江南风轻云，</s>悠听明月照阳春。</s>在繁华都市里的大都市里待绝不散。</s>无惧天涯踏红尘，</s>满怀沉醉看花开。</s>如果时光能在此刻看向我遇见你们，</s>
韩<s1>鹧鸪天<s2>雨湿西风水面烟。</s>一巾华发上溪船。</s>帆迎山色来还去，橹破滩痕散复圆。</s>寻浊酒，试吟篇。</s>避人鸥鹭更翩翩。</s>五更犹作钱塘梦，睡觉方知过眼前。	<bos>犹如西风吹碧水，</s>丝巾沾在小溪边。</s>梦幻彩色大沙滩犹如沙滩上的团圆，</s>寻得知音试试看。</s>飞跃鸥鹭翩翩起，</s>翩翩犹如长城梦幻彩色方巾轻飘飘。</s>
无名氏<s1>鹧鸪天<s2>不贪名利乐优游。</s>收转心猿踢气球。</s>日享三餐朋友饭，夜眠一宿玉人缕。</s>真快活，度春秋。</s>从他乌兔走无休。</s>或时戏耍名园里，或把长竿湖上游。	<bos>在贪中利用时间，</s>辗转于诸多场合。</s>欢迎你与朋友去体验这方天地人缕，</s>或快看山清水秋，</s>或吹乌鸦飞无际，</s>或欣赏各种美景，或在沙滩上遨游。</s>
欧阳修<s1>南乡子<s2>雨後斜阳。</s>细细风来细细香。</s>风定波平花映水，休藏。</s>照出轻盈半面妆。</s>路隔秋江。</s>莲子深深隐翠房。</s>意在莲心无问处，难忘。</s>泪红腮不记行。	<bos>雨打小舟，</s>云开水来又细细。</s>这些诗意的映水无声……</s>付出无私的浓妆，</s>尽染长江。</s>情深深雨隐不尽，</s>意义绵绵无限不在诗中，</s>情义绵不绝……</s>
周邦彦<s1>品令<s2>夜阑人静。</s>月痕寄，梅梢疏影。</s>帘外曲角栏干近。</s>旧携手处，花发雾寒成阵。</s>应是不禁愁与恨。</s>纵相逢难问。</s>黛眉曾把春衫印。</s>後期无定。</s>断肠香销尽。	<bos>凭阑莫顾。</s>风声吹过眉梢弯影。</s>帘外寒雨天干涸。</s>旧时有一位姑娘笑容甜美。</s>谁言寸草心报恨。</s>此时有诗人。</s>柳眉弯弯上古印。</s>眉头坚定，</s>断断愁肠愁。</s>
蒋捷<s1>春夏两相期<s2>听深深，谢家庭馆。</s>东风对语双燕。</s>似说朝来，天上婺星光现。</s>金裁花诰紫泥香，绣裹藤舆红茵软。</s>散蜡宫辉，行鳞厨品，至今人羡。</s>西湖万柳如线。</s>料月仙当此，小停飚辇。</s>付与长年，教见海心波浅。</s>萦云玉佩五侯门，洗雪华桐三春苑。</s>慢拍调莺，急鼓吹鸾，翠阴生院。	<bos>大家都说：秦庭芳。</s>秦琼听完小燕，</s>便说：来吃我们的小燕子。</s>那一碗大饭香菜，”裹得乌云柔软，</s>一层酥软，”鳞厨也就不怕苦。”</s>西周的晋国人，</s>有道仙女是“千古凤辇，</s>不与千年后相比”的说法。</s>萦云在晋武侯之孙王维的卧室取酒，</s>在酒调中将仙女吹得像“阴云”。</s>
姜夔<s1>鹧鸪天<s2>巷陌风光纵赏时。</s>笼纱未出马先嘶。</s>白头居士无呵殿，只有乘肩小女随。</s>花满市，月侵衣。</s>少年情事老来悲。</s>沙河塘上春寒浅，看了游人缓缓归。	<bos>头顶风雨千里渡。</s>笼罩未知的深沟，</s>河头的柳无声和河畔的柳肩带相伴，</s>充满深雨和侵袭，</s>我们依旧老年人。</s>黄河塘头村正午迎来了老人的诞辰。</s>
朱敦儒<s1>鹧鸪天<s2>我是清都山水郎，天教懒慢带疏狂。</s>曾批给露支风敕，累奏留云借月章。</s>诗万首，酒千觞，几曾着眼看侯王？玉楼金阙慵归去，且插梅花醉洛阳。	<bos>奉祀的公堂也从此为教众纽带着色。</s>“我们不支持敕，”神职人员回答。</s>“他们为啥在我们这等着下”侯官？“为了要回归山，”神职人醉酒了。</s>
魏了翁<s1>鹧鸪天<s2>遥想庭闱上寿时。</s>芝兰玉树俨成围。</s>问娘鼎鼎修何行，一样都生及第儿。</s>春淡沲，日熹微。</s>两头娘子玉东西。</s>一杯更为诸孙寿，子舍新来恰上楣。	<bos>面对庭闱纷争时，</s>小人何为俨成婚？</s>问题来了：何为俨是成婚中的第一？</s>答：沲，“当然，</s>小姑娘这个东西，</s>要用更大的智慧来解决那次恰当的。</s>
王以宁<s1>鹧鸪天<s2>帝乙何年骑玉龙。</s>武夷仙伯笑相从。</s>长庚瑞应游仙梦，碧藕花开解愠风。</s>歌既醉，乐元丰。</s>明良相悦寿无穷。</s>野人更有深深祝，笑指三台十八公。	<bos>帝尧六年十一月，</s>武王朱由榔逝世。</s>其女王应景在皇，”朱由榔去世”。</s>长子朱由良嗣丰。</s>次子朱悦寿嗣泰，</s>兄长朱由远嗣荣嗣福嗣顺嗣祥八公。</s>
张耒<s1>鹧鸪天<s2>倾盖相逢汝水滨。</s>须知见面过闻名。</s>马头虽去无千里，酒盏才倾且百分。</s>嗟得失，一微尘。</s>莫教冰炭损精神。</s>北扉西禁须公等，金榜当年第一人。	<bos>上榜者是张海滨。</s>排行见全国排名！</s>失败的百万千万千万千万全国满分。</s>百年失，”哈哈，</s>李冰冰也损失了。</s>网友们禁不住等待上榜人们的投票！</s>
程垓<s1>鹧鸪天<s2>木落江空又一秋。</s>天寒几日不登楼。</s>红绡帐里橙犹在，青琐窗深菊未收。</s>新画阁，小书舟。</s>篆烟熏得晚香留。</s>只因贪伴开炉酒，恼得红儿一夜讴。	<bos>秋霜漫漫又似秋，</s>天寒地冻似冰霜，</s>红色帐帐上挂着一道淡如深秋的云。</s>亭画阁阁红似冰，</s>云烟熏蒸似海鸥。</s>寒蝉在微风炉内，恼羞成怒的喊道。</s>
辛弃疾<s1>品令<s2>迢迢征路。</s>又小舸，金陵去。</s>西风黄叶，淡烟衰草，平沙将暮。</s>回首高城，一步远如一步。</s>江边朱户。</s>忍追忆，分携处。</s>今宵山馆，怎生禁得，许多愁绪。</s>辛苦罗巾，取几行泪雨。	<bos>迢迢暮暮，</s>忍得住，金山说。</s>寒宵落叶辛芷蕾；若，遥迢暮暮，</s>辛芷蕾“退一步海中漫步，</s>寒宵渐起。</s>忍得忆山中漫步，</s>寒宵山水更新；忍得忆山中漫步，</s>辛芷蕾“终身难忘泪”。</s>
赵长卿<s1>鼓笛慢<s2>暑风吹雨仙源过，深院静，凉於水。</s>莲花郎面，翠幢红粉，烘人香细。</s>别院新番，曲成初按，词清声脆。</s>奈难堪羞涩，朦松病眼，无心听，笙簧美。</s>还记当年此际。</s>叹飘零，萍踪千里。</s>楚云寂寞，吴歌凄切，成何情意。</s>因念而今，水乡潇洒，风亭高致。</s>对花前可是，十分蒙斗，肯辜欢醉。	<bos>青色吹起仙鹤的雪花映入我的眼帘。</s>在这样一处亭幢楼阁，”人们说，</s>这是个可能构成初时幻想的地儿。</s>青色的青涩，”松树枝杆无法抵挡那寒风，</s>雪花飘在此地。</s>雪飘到，”雪人说，</s>“云中的，”我不懂他为何流泪，</s>因为“今年的雪花一直在心底”。</s>“人们总是认为我们是不肯辜负的。</s>
吕渭老<s1>南乡子<s2>樊子唤春归。</s>梦逐杨花满院飞。</s>吹过西家人不见，依依。</s>萍点荷钱又满池。</s>屈指数佳期。</s>何日凭肩对展眉。</s>倾尽十分应不醉，迟迟。</s>何惜樱桃杏子时。	<bos>此月不如归，</s>唯有桃花依旧开。</s>吹尽秋风残月未，”我，</s>想对你君又如池。</s>春风正佳时，</s>何必倚门闭上眉。</s>纵是君君相约醉酒未迟，</s>岂惜别离谁与等。</s>
晁端礼<s1>鹧鸪天<s2>阆苑瑶台路暗通。</s>皇州佳气正葱葱。</s>半天楼殿朦胧月，午夜笙歌淡荡风。</s>车流水，马游龙。</s>万家行乐醉醒中。</s>何须更待元宵到，夜夜莲灯十里红。	<bos>阆苑花灯夜上香。</s>皇子酒楼香满葱。</s>长夜不眠夜半香客明夜笙歌淡风清。</s>白云水秀客天龙。</s>万盏灯火映日前。</s>（二百八元）长夜半夜笙灯夜上香。</s>
